name,chr,start,end,length,cpgNum,gcNum,perCpg,perGc,obsExp
CpG: 47,chr1,84934572,84935054,482,47,329,19.5,68.3,0.84
CpG: 78,chr1,63176547,63177427,880,78,543,17.7,61.7,0.93
CpG: 67,chr1,125435174,125435976,802,67,464,16.7,57.9,1.01
CpG: 93,chr1,183368926,183369826,900,93,631,20.7,70.1,0.84
CpG: 27,chr1,3531624,3531843,219,27,167,24.7,76.3,0.86
CpG: 34,chr1,3670619,3671074,455,34,293,14.9,64.4,0.72
CpG: 45,chr1,3671654,3672156,502,45,348,17.9,69.3,0.75
CpG: 165,chr1,4491701,4493673,1972,165,1286,16.7,65.2,0.79
CpG: 47,chr1,4496947,4497608,661,47,393,14.2,59.5,0.81
CpG: 44,chr1,4571641,4572075,434,44,265,20.3,61.1,1.09
CpG: 24,chr1,4689184,4689397,213,24,149,22.5,70,0.96
CpG: 49,chr1,4785376,4785814,438,49,289,22.4,66,1.04
CpG: 73,chr1,4807559,4808103,544,73,367,26.8,67.5,1.18
CpG: 83,chr1,4857465,4858372,907,83,545,18.3,60.1,1.01
CpG: 77,chr1,5018557,5019711,1154,77,714,13.3,61.9,0.71
CpG: 49,chr1,5083039,5083536,497,49,329,19.7,66.2,0.9
CpG: 85,chr1,5916428,5917474,1046,85,649,16.3,62,0.85
CpG: 107,chr1,6214430,6215332,902,107,645,23.7,71.5,0.93
CpG: 29,chr1,6359082,6359442,360,29,245,16.1,68.1,0.72
CpG: 42,chr1,6382891,6383203,312,42,229,26.9,73.4,1
CpG: 36,chr1,6441200,6441612,412,36,209,17.5,50.7,1.36
CpG: 85,chr1,7088491,7089271,780,85,540,21.8,69.2,0.91
CpG: 64,chr1,7397746,7398594,848,64,543,15.1,64,0.74
CpG: 61,chr1,9299215,9300020,805,61,512,15.2,63.6,0.76
CpG: 97,chr1,9545269,9546268,999,97,666,19.4,66.7,0.87
CpG: 87,chr1,9699785,9700881,1096,87,624,15.9,56.9,0.98
CpG: 89,chr1,9747560,9748645,1085,89,631,16.4,58.2,0.98
CpG: 95,chr1,9797821,9798652,831,95,493,22.9,59.3,1.3
CpG: 40,chr1,9848165,9848530,365,40,265,21.9,72.6,0.88
CpG: 46,chr1,9943785,9944196,411,46,277,22.4,67.4,1
CpG: 128,chr1,9967118,9968330,1212,128,811,21.1,66.9,0.94
CpG: 31,chr1,10037950,10038215,265,31,167,23.4,63,1.21
CpG: 60,chr1,10039745,10040279,534,60,387,22.5,72.5,0.89
CpG: 136,chr1,10232143,10233428,1285,136,780,21.2,60.7,1.15
CpG: 45,chr1,10805299,10805885,586,45,371,15.4,63.3,0.77
CpG: 56,chr1,10993486,10994005,519,56,324,21.6,62.4,1.11
CpG: 44,chr1,11414060,11414465,405,44,283,21.7,69.9,0.89
CpG: 34,chr1,12990718,12991200,482,34,307,14.1,63.7,0.7
CpG: 98,chr1,12991485,12992784,1299,98,734,15.1,56.5,0.95
CpG: 16,chr1,12996222,12996435,213,16,129,15,60.6,0.82
CpG: 30,chr1,13126298,13126669,371,30,238,16.2,64.2,0.79
CpG: 188,chr1,13372746,13374794,2048,188,1298,18.4,63.4,0.92
CpG: 101,chr1,13589162,13590177,1015,101,623,19.9,61.4,1.06
CpG: 49,chr1,13660231,13660732,501,49,344,19.6,68.7,0.83
CpG: 35,chr1,14309747,14310036,289,35,209,24.2,72.3,0.93
CpG: 48,chr1,14506541,14507148,607,48,394,15.8,64.9,0.75
CpG: 68,chr1,14755151,14755803,652,68,455,20.9,69.8,0.86
CpG: 87,chr1,15286418,15287178,760,87,561,22.9,73.8,0.84
CpG: 60,chr1,15805591,15806108,517,60,355,23.2,68.7,0.99
CpG: 52,chr1,15892420,15893052,632,52,447,16.5,70.7,0.67
CpG: 41,chr1,16092956,16093371,415,41,277,19.8,66.7,0.89
CpG: 169,chr1,16104765,16106291,1526,169,1006,22.1,65.9,1.02
CpG: 45,chr1,16519743,16520093,350,45,261,25.7,74.6,0.93
CpG: 107,chr1,16618558,16619401,843,107,605,25.4,71.8,0.99
CpG: 25,chr1,16656764,16657043,279,25,176,17.9,63.1,0.94
CpG: 56,chr1,16665146,16665626,480,56,337,23.3,70.2,0.97
CpG: 35,chr1,17091517,17091971,454,35,267,15.4,58.8,0.89
CpG: 116,chr1,17096764,17098139,1375,116,864,16.9,62.8,0.86
CpG: 23,chr1,17145467,17145795,328,23,205,14,62.5,0.72
CpG: 91,chr1,18058035,18058896,861,91,570,21.1,66.2,0.97
CpG: 25,chr1,19104571,19104923,352,25,225,14.2,63.9,0.72
CpG: 30,chr1,19209755,19210067,312,30,195,19.2,62.5,0.98
CpG: 35,chr1,19213940,19214404,464,35,307,15.1,66.2,0.74
CpG: 19,chr1,19236612,19236850,238,19,153,16,64.3,0.78
CpG: 45,chr1,20819888,20820297,409,45,289,22,70.7,0.95
CpG: 33,chr1,20890434,20890811,377,33,267,17.5,70.8,0.72
CpG: 15,chr1,20935285,20935502,217,15,133,13.8,61.3,0.78
CpG: 20,chr1,20951662,20951890,228,20,151,17.5,66.2,0.81
CpG: 72,chr1,21078869,21079694,825,72,515,17.5,62.4,0.91
CpG: 99,chr1,21961003,21962124,1121,99,687,17.7,61.3,0.94
CpG: 104,chr1,22533177,22534185,1008,104,642,20.6,63.7,1.02
CpG: 62,chr1,22805682,22806364,682,62,432,18.2,63.3,0.91
CpG: 27,chr1,23101887,23102262,375,27,229,14.4,61.1,0.77
CpG: 114,chr1,23256018,23257054,1036,114,643,22,62.1,1.17
CpG: 83,chr1,23382681,23383400,719,83,479,23.1,66.6,1.04
CpG: 131,chr1,23761822,23763204,1382,131,930,19,67.3,0.85
CpG: 76,chr1,23921719,23922554,835,76,469,18.2,56.2,1.15
CpG: 38,chr1,24005371,24005714,343,38,222,22.2,64.7,1.06
CpG: 108,chr1,24099641,24100556,915,108,613,23.6,67,1.05
CpG: 71,chr1,24586521,24587177,656,71,432,21.6,65.9,1.01
CpG: 54,chr1,24678516,24679083,567,54,371,19,65.4,0.89
CpG: 75,chr1,25829845,25830680,835,75,485,18,58.1,1.08
CpG: 137,chr1,30873108,30874026,918,137,669,29.8,72.9,1.13
CpG: 145,chr1,30948826,30950216,1390,145,828,20.9,59.6,1.18
CpG: 50,chr1,32172540,32173046,506,50,346,19.8,68.4,0.85
CpG: 73,chr1,33669553,33670569,1016,73,548,14.4,53.9,0.99
CpG: 91,chr1,33719825,33720450,625,91,455,29.1,72.8,1.12
CpG: 44,chr1,33757611,33757949,338,44,257,26,76,0.9
CpG: 62,chr1,33814130,33814690,560,62,374,22.1,66.8,1
CpG: 20,chr1,33906988,33907242,254,20,147,15.7,57.9,0.94
CpG: 20,chr1,33907457,33907693,236,20,165,16.9,69.9,0.71
CpG: 31,chr1,33907902,33908106,204,31,160,30.4,78.4,0.99
CpG: 16,chr1,33908265,33908468,203,16,117,15.8,57.6,0.97
CpG: 18,chr1,34006046,34006248,202,18,116,17.8,57.4,1.1
CpG: 52,chr1,34011484,34011861,377,52,300,27.6,79.6,0.87
CpG: 25,chr1,34177942,34178193,251,25,161,19.9,64.1,1.04
CpG: 64,chr1,34439241,34440138,897,64,525,14.3,58.5,0.83
CpG: 43,chr1,34459407,34459964,557,43,352,15.4,63.2,0.77
CpG: 19,chr1,34472754,34472966,212,19,132,17.9,62.3,0.93
CpG: 42,chr1,34579529,34579840,311,42,235,27,75.6,0.95
CpG: 37,chr1,34678070,34678419,349,37,239,21.2,68.5,0.93
CpG: 81,chr1,34750258,34751085,827,81,521,19.6,63,0.99
CpG: 40,chr1,34801701,34802059,358,40,258,22.3,72.1,0.86
CpG: 71,chr1,34842534,34843165,631,71,354,22.5,56.1,1.44
CpG: 33,chr1,34849895,34850178,283,33,203,23.3,71.7,0.92
CpG: 47,chr1,34930034,34930639,605,47,374,15.5,61.8,0.82
CpG: 81,chr1,36068460,36069216,756,81,462,21.4,61.1,1.15
CpG: 46,chr1,36103537,36104186,649,46,397,14.2,61.2,0.76
CpG: 53,chr1,36243891,36244412,521,53,349,20.3,67,0.92
CpG: 48,chr1,36269231,36269697,466,48,313,20.6,67.2,0.92
CpG: 61,chr1,36307616,36308213,597,61,400,20.4,67,0.91
CpG: 74,chr1,36368684,36369330,646,74,395,22.9,61.1,1.25
CpG: 44,chr1,36444875,36445308,433,44,304,20.3,70.2,0.85
CpG: 72,chr1,36471266,36472155,889,72,475,16.2,53.4,1.14
CpG: 128,chr1,36511763,36513006,1243,128,766,20.6,61.6,1.09
CpG: 38,chr1,36546910,36547290,380,38,255,20,67.1,0.91
CpG: 139,chr1,36556807,36558424,1617,139,1087,17.2,67.2,0.76
CpG: 32,chr1,36683084,36683438,354,32,222,18.1,62.7,0.92
CpG: 58,chr1,36691322,36691869,547,58,364,21.2,66.5,0.96
CpG: 50,chr1,36709621,36710148,527,50,363,19,68.9,0.8
CpG: 44,chr1,36770808,36771193,385,44,260,22.9,67.5,1.01
CpG: 18,chr1,36779084,36779320,236,18,136,15.3,57.6,0.92
CpG: 154,chr1,36938841,36940122,1281,154,889,24,69.4,1
CpG: 17,chr1,37029247,37029486,239,17,158,14.2,66.1,0.65
CpG: 62,chr1,37299840,37300507,667,62,381,18.6,57.1,1.17
CpG: 67,chr1,37429777,37430415,638,67,437,21,68.5,0.9
CpG: 56,chr1,37540315,37540920,605,56,361,18.5,59.7,1.05
CpG: 88,chr1,37719313,37720128,815,88,536,21.6,65.8,1
CpG: 78,chr1,37864612,37865324,712,78,446,21.9,62.6,1.15
CpG: 32,chr1,37875331,37875824,493,32,261,13,52.9,0.93
CpG: 38,chr1,37890362,37890782,420,38,237,18.1,56.4,1.14
CpG: 41,chr1,37996946,37997459,513,41,311,16,60.6,0.87
CpG: 101,chr1,37997823,37998675,852,101,612,23.7,71.8,0.94
CpG: 167,chr1,38129048,38130208,1160,167,802,28.8,69.1,1.21
CpG: 26,chr1,38210065,38210345,280,26,202,18.6,72.1,0.72
CpG: 94,chr1,38626793,38628084,1291,94,666,14.6,51.6,1.1
CpG: 131,chr1,38835801,38836776,975,131,701,26.9,71.9,1.04
CpG: 46,chr1,38897864,38898202,338,46,256,27.2,75.7,0.95
CpG: 47,chr1,38987499,38988052,553,47,370,17,66.9,0.76
CpG: 103,chr1,39193418,39194435,1017,103,629,20.3,61.8,1.07
CpG: 100,chr1,39367434,39368617,1183,100,705,16.9,59.6,0.95
CpG: 81,chr1,39478123,39478997,874,81,563,18.5,64.4,0.9
CpG: 98,chr1,39535587,39536365,778,98,548,25.2,70.4,1.02
CpG: 100,chr1,39576525,39577527,1002,100,614,20,61.3,1.07
CpG: 76,chr1,39650441,39651282,841,76,568,18.1,67.5,0.79
CpG: 127,chr1,39900472,39901459,987,127,642,25.7,65,1.22
CpG: 30,chr1,40266556,40266876,320,30,227,18.8,70.9,0.75
CpG: 17,chr1,40325809,40326019,210,17,138,16.2,65.7,0.76
CpG: 111,chr1,40681006,40682084,1078,111,748,20.6,69.4,0.86
CpG: 28,chr1,40790518,40790811,293,28,198,19.1,67.6,0.84
CpG: 26,chr1,42491684,42491938,254,26,166,20.5,65.4,0.97
CpG: 40,chr1,42684497,42685011,514,40,344,15.6,66.9,0.7
CpG: 31,chr1,42686605,42686928,323,31,209,19.2,64.7,0.93
CpG: 28,chr1,42694074,42694484,410,28,236,13.7,57.6,0.84
CpG: 44,chr1,42694733,42695261,528,44,291,16.7,55.1,1.1
CpG: 158,chr1,42696574,42698657,2083,158,1114,15.2,53.5,1.06
CpG: 36,chr1,42851139,42851682,543,36,353,13.3,65,0.63
CpG: 53,chr1,42952792,42953543,751,53,413,14.1,55,0.96
CpG: 57,chr1,43092247,43092816,569,57,306,20,53.8,1.39
CpG: 46,chr1,43098480,43098954,474,46,328,19.4,69.2,0.81
CpG: 42,chr1,43163728,43164080,352,42,256,23.9,72.7,0.91
CpG: 67,chr1,43445846,43446568,722,67,471,18.6,65.2,0.88
CpG: 22,chr1,43553864,43554185,321,22,192,13.7,59.8,0.77
CpG: 95,chr1,43827314,43828135,821,95,573,23.1,69.8,0.96
CpG: 86,chr1,43933652,43934550,898,86,594,19.2,66.1,0.88
CpG: 99,chr1,44101935,44102758,823,99,529,24.1,64.3,1.18
CpG: 58,chr1,44147610,44148213,603,58,386,19.2,64,0.95
CpG: 63,chr1,44551578,44552491,913,63,596,13.8,65.3,0.65
CpG: 47,chr1,45795375,45795757,382,47,271,24.6,70.9,1
CpG: 20,chr1,46425460,46425706,246,20,160,16.3,65,0.77
CpG: 168,chr1,46852696,46854053,1357,168,959,24.8,70.7,1
CpG: 77,chr1,50927047,50928062,1015,77,668,15.2,65.8,0.71
CpG: 48,chr1,51478159,51478621,462,48,312,20.8,67.5,0.97
CpG: 110,chr1,51915183,51916194,1011,110,720,21.8,71.2,0.86
CpG: 31,chr1,52113708,52113995,287,31,199,21.6,69.3,0.9
CpG: 39,chr1,52119293,52119737,444,39,297,17.6,66.9,0.79
CpG: 120,chr1,52232207,52233503,1296,120,785,18.5,60.6,1.01
CpG: 25,chr1,52500031,52500252,221,25,118,22.6,53.4,1.63
CpG: 36,chr1,52500508,52500827,319,36,208,22.6,65.2,1.07
CpG: 44,chr1,52630541,52630942,401,44,291,21.9,72.6,0.83
CpG: 76,chr1,52726791,52727529,738,76,470,20.6,63.7,1.02
CpG: 59,chr1,52817206,52817862,656,59,450,18,68.6,0.78
CpG: 28,chr1,52952626,52952957,331,28,235,16.9,71,0.67
CpG: 63,chr1,53296788,53297379,591,63,408,21.3,69,0.89
CpG: 33,chr1,53352464,53352777,313,33,205,21.1,65.5,0.99
CpG: 29,chr1,53706523,53706879,356,29,216,16.3,60.7,0.89
CpG: 75,chr1,53784769,53785369,600,75,411,25,68.5,1.07
CpG: 120,chr1,54194342,54195242,900,120,632,26.7,70.2,1.08
CpG: 19,chr1,54250569,54250800,231,19,150,16.5,64.9,0.78
CpG: 28,chr1,54438757,54439059,302,28,190,18.5,62.9,0.94
CpG: 49,chr1,54557255,54557805,550,49,362,17.8,65.8,0.83
CpG: 106,chr1,54925725,54926617,892,106,627,23.8,70.3,0.99
CpG: 17,chr1,54957230,54957497,267,17,151,12.7,56.6,0.8
CpG: 87,chr1,55026873,55027605,732,87,490,23.8,66.9,1.06
CpG: 90,chr1,55052507,55053297,790,90,542,22.8,68.6,0.98
CpG: 125,chr1,55087410,55088640,1230,125,814,20.3,66.2,0.93
CpG: 74,chr1,55131057,55131773,716,74,488,20.7,68.2,0.89
CpG: 93,chr1,55236985,55237816,831,93,552,22.4,66.4,1.02
CpG: 115,chr1,55362481,55363657,1176,115,691,19.6,58.8,1.13
CpG: 109,chr1,55405582,55406648,1066,109,710,20.5,66.6,0.93
CpG: 28,chr1,56969619,56969873,254,28,178,22,70.1,0.91
CpG: 24,chr1,56970858,56971119,261,24,167,18.4,64,0.91
CpG: 176,chr1,56971509,56973501,1992,176,1227,17.7,61.6,0.93
CpG: 25,chr1,56977104,56977392,288,25,183,17.4,63.5,0.86
CpG: 67,chr1,57377474,57378019,545,67,378,24.6,69.4,1.04
CpG: 74,chr1,57406137,57407067,930,74,595,15.9,64,0.78
CpG: 108,chr1,57774698,57775632,934,108,624,23.1,66.8,1.04
CpG: 56,chr1,57969733,57970245,512,56,353,21.9,68.9,0.93
CpG: 46,chr1,57995863,57996253,390,46,266,23.6,68.2,1.02
CpG: 95,chr1,58392748,58393897,1149,95,637,16.5,55.4,1.09
CpG: 80,chr1,58423343,58424130,787,80,488,20.3,62,1.06
CpG: 31,chr1,58445081,58445545,464,31,285,13.4,61.4,0.72
CpG: 65,chr1,58504543,58505162,619,65,430,21,69.5,0.87
CpG: 40,chr1,58585919,58586427,508,40,328,15.7,64.6,0.88
CpG: 40,chr1,58711442,58711764,322,40,223,24.8,69.3,1.04
CpG: 21,chr1,58713384,58713657,273,21,165,15.4,60.4,0.84
CpG: 28,chr1,58795582,58795852,270,28,183,20.7,67.8,0.91
CpG: 83,chr1,58973210,58974117,907,83,627,18.3,69.1,0.77
CpG: 68,chr1,59119822,59120480,658,68,460,20.7,69.9,0.85
CpG: 61,chr1,59236919,59237493,574,61,391,21.3,68.1,0.92
CpG: 185,chr1,59481951,59483937,1986,185,1293,18.6,65.1,0.88
CpG: 20,chr1,59670696,59670900,204,20,125,19.6,61.3,1.05
CpG: 35,chr1,59684856,59685215,359,35,208,19.5,57.9,1.17
CpG: 142,chr1,59762785,59764213,1428,142,887,19.9,62.1,1.03
CpG: 118,chr1,59912548,59913890,1342,118,772,17.6,57.5,1.08
CpG: 81,chr1,60042646,60043499,853,81,491,19,57.6,1.15
CpG: 62,chr1,60098156,60098777,621,62,419,20,67.5,0.88
CpG: 30,chr1,60180214,60180489,275,30,196,21.8,71.3,0.86
CpG: 51,chr1,60343255,60343657,402,51,291,25.4,72.4,0.97
CpG: 103,chr1,60409278,60410251,973,103,604,21.2,62.1,1.1
CpG: 139,chr1,60566182,60567260,1078,139,814,25.8,75.5,0.92
CpG: 78,chr1,61638736,61639406,670,78,485,23.3,72.4,0.89
CpG: 86,chr1,62702838,62703748,910,86,589,18.9,64.7,0.9
CpG: 88,chr1,62705850,62707032,1182,88,720,14.9,60.9,0.8
CpG: 77,chr1,63113485,63114349,864,77,479,17.8,55.4,1.16
CpG: 44,chr1,63248289,63248615,326,44,230,27,70.6,1.12
CpG: 90,chr1,63273063,63273913,850,90,481,21.2,56.6,1.35
CpG: 17,chr1,63365284,63365489,205,17,133,16.6,64.9,0.79
CpG: 95,chr1,63445715,63446529,814,95,569,23.3,69.9,0.96
CpG: 56,chr1,64121613,64122142,529,56,363,21.2,68.6,0.92
CpG: 131,chr1,64532367,64533738,1371,131,831,19.1,60.6,1.04
CpG: 83,chr1,64616945,64617792,847,83,564,19.6,66.6,0.88
CpG: 108,chr1,64690534,64691585,1051,108,645,20.6,61.4,1.1
CpG: 241,chr1,64734847,64737979,3132,241,1970,15.4,62.9,0.78
CpG: 41,chr1,64956498,64956870,372,41,264,22,71,0.89
CpG: 21,chr1,64994405,64994627,222,21,139,18.9,62.6,0.97
CpG: 38,chr1,65178904,65179373,469,38,307,16.2,65.5,0.76
CpG: 59,chr1,65186379,65187053,674,59,399,17.5,59.2,1.03
CpG: 29,chr1,66175311,66175645,334,29,222,17.4,66.5,0.79
CpG: 68,chr1,66468022,66468623,601,68,435,22.6,72.4,0.87
CpG: 17,chr1,66677401,66677639,238,17,141,14.3,59.2,0.83
CpG: 60,chr1,66700752,66701351,599,60,407,20,67.9,0.87
CpG: 132,chr1,66816436,66817867,1431,132,894,18.4,62.5,0.97
CpG: 31,chr1,66862839,66863146,307,31,214,20.2,69.7,0.83
CpG: 42,chr1,67038520,67038937,417,42,276,20.1,66.2,0.92
CpG: 91,chr1,69107034,69108055,1021,91,682,17.8,66.8,0.8
CpG: 16,chr1,69376995,69377218,223,16,146,14.3,65.5,0.67
CpG: 20,chr1,69377803,69378045,242,20,158,16.5,65.3,0.78
CpG: 35,chr1,69826863,69827202,339,35,238,20.6,70.2,0.87
CpG: 72,chr1,71102404,71103220,816,72,532,17.6,65.2,0.84
CpG: 40,chr1,71556948,71557367,419,40,299,19.1,71.4,0.76
CpG: 58,chr1,71652697,71653358,661,58,441,17.5,66.7,0.79
CpG: 65,chr1,72211749,72212422,673,65,401,19.3,59.6,1.1
CpG: 31,chr1,72225934,72226218,284,31,187,21.8,65.8,1.12
CpG: 48,chr1,72236403,72236924,521,48,329,18.4,63.1,0.93
CpG: 39,chr1,72243822,72244197,375,39,241,20.8,64.3,1.09
CpG: 25,chr1,72254745,72254986,241,25,156,20.7,64.7,1.08
CpG: 22,chr1,72536152,72536389,237,22,165,18.6,69.6,0.77
CpG: 22,chr1,72536961,72537217,256,22,177,17.2,69.1,0.72
CpG: 46,chr1,72640793,72641380,587,46,321,15.7,54.7,1.05
CpG: 72,chr1,72710861,72711718,857,72,486,16.8,56.7,1.05
CpG: 32,chr1,72824693,72824937,244,32,177,26.2,72.5,1
CpG: 20,chr1,72825362,72825653,291,20,176,13.7,60.5,0.78
CpG: 27,chr1,72873698,72873966,268,27,181,20.1,67.5,0.91
CpG: 27,chr1,73907271,73907503,232,27,144,23.3,62.1,1.29
CpG: 29,chr1,74036952,74037248,296,29,215,19.6,72.6,0.74
CpG: 35,chr1,74068492,74068975,483,35,325,14.5,67.3,0.64
CpG: 48,chr1,74098213,74098786,573,48,391,16.8,68.2,0.72
CpG: 65,chr1,74124244,74124923,679,65,436,19.1,64.2,0.94
CpG: 52,chr1,74236580,74237193,613,52,379,17,61.8,0.9
CpG: 61,chr1,74284463,74285135,672,61,434,18.2,64.6,0.87
CpG: 50,chr1,74303866,74304355,489,50,324,20.4,66.3,0.94
CpG: 38,chr1,74332449,74332824,375,38,264,20.3,70.4,0.82
CpG: 93,chr1,74391332,74392430,1098,93,635,16.9,57.8,1.02
CpG: 112,chr1,74505461,74506819,1358,112,841,16.5,61.9,0.86
CpG: 62,chr1,74587633,74588472,839,62,535,14.8,63.8,0.73
CpG: 27,chr1,74601094,74601459,365,27,219,14.8,60,0.84
CpG: 56,chr1,74661672,74662164,492,56,347,22.8,70.5,0.92
CpG: 20,chr1,74713618,74713831,213,20,150,18.8,70.4,0.76
CpG: 25,chr1,74748732,74749045,313,25,209,16,66.8,0.72
CpG: 55,chr1,74771686,74772209,523,55,342,21,65.4,1.06
CpG: 24,chr1,74782669,74783024,355,24,216,13.5,60.8,0.78
CpG: 67,chr1,74784035,74784616,581,67,401,23.1,69,0.98
CpG: 44,chr1,74791733,74792242,509,44,376,17.3,73.9,0.65
CpG: 22,chr1,74800537,74800744,207,22,134,21.3,64.7,1.02
CpG: 43,chr1,74803204,74803609,405,43,279,21.2,68.9,0.9
CpG: 25,chr1,74816944,74817187,243,25,167,20.6,68.7,0.89
CpG: 149,chr1,74854859,74856469,1610,149,985,18.5,61.2,0.99
CpG: 16,chr1,74858468,74858684,216,16,134,14.8,62,0.85
CpG: 60,chr1,74881947,74882612,665,60,394,18,59.2,1.04
CpG: 95,chr1,74884301,74885613,1312,95,848,14.5,64.6,0.69
CpG: 33,chr1,74892725,74893136,411,33,262,16.1,63.7,0.79
CpG: 48,chr1,74900555,74900984,429,48,303,22.4,70.6,0.9
CpG: 126,chr1,74950631,74952093,1462,126,918,17.2,62.8,0.88
CpG: 38,chr1,75124739,75125149,410,38,256,18.5,62.4,0.98
CpG: 132,chr1,75141432,75143190,1758,132,1027,15,58.4,0.88
CpG: 42,chr1,75168558,75168942,384,42,274,21.9,71.4,0.88
CpG: 27,chr1,75210804,75211065,261,27,178,20.7,68.2,0.9
CpG: 66,chr1,75219212,75219982,770,66,488,17.1,63.4,0.85
CpG: 47,chr1,75236419,75236960,541,47,362,17.4,66.9,0.78
CpG: 17,chr1,75251753,75251964,211,17,136,16.1,64.5,0.78
CpG: 98,chr1,75317105,75318069,964,98,663,20.3,68.8,0.93
CpG: 71,chr1,75360355,75360970,615,71,422,23.1,68.6,0.98
CpG: 17,chr1,75369572,75369788,216,17,119,15.7,55.1,1.05
CpG: 47,chr1,75375225,75375786,561,47,394,16.8,70.2,0.68
CpG: 36,chr1,75381924,75382387,463,36,286,15.6,61.8,0.82
CpG: 21,chr1,75384918,75385180,262,21,177,16,67.6,0.71
CpG: 107,chr1,75387985,75389104,1119,107,775,19.1,69.3,0.8
CpG: 120,chr1,75421988,75423440,1452,120,998,16.5,68.7,0.7
CpG: 22,chr1,75450376,75450680,304,22,181,14.5,59.5,0.87
CpG: 20,chr1,75458558,75458772,214,20,150,18.7,70.1,0.82
CpG: 16,chr1,75475043,75475252,209,16,135,15.3,64.6,0.74
CpG: 20,chr1,75475918,75476150,232,20,147,17.2,63.4,0.86
CpG: 117,chr1,75478669,75479786,1117,117,824,20.9,73.8,0.77
CpG: 27,chr1,75482645,75483019,374,27,253,14.4,67.6,0.63
CpG: 20,chr1,75486710,75486948,238,20,151,16.8,63.4,0.84
CpG: 50,chr1,75487636,75488078,442,50,299,22.6,67.6,0.99
CpG: 21,chr1,75503722,75503961,239,21,147,17.6,61.5,0.94
CpG: 138,chr1,75505201,75506384,1183,138,835,23.3,70.6,0.94
CpG: 43,chr1,75521431,75521985,554,43,326,15.5,58.8,0.9
CpG: 54,chr1,75546264,75546756,492,54,369,22,75,0.79
CpG: 77,chr1,77514349,77515453,1104,77,672,13.9,60.9,0.76
CpG: 26,chr1,78189565,78189829,264,26,166,19.7,62.9,1.03
CpG: 49,chr1,78196631,78197287,656,49,414,14.9,63.1,0.75
CpG: 25,chr1,78203836,78204189,353,25,200,14.2,56.7,0.96
CpG: 23,chr1,78215957,78216242,285,23,164,16.1,57.5,0.98
CpG: 113,chr1,78216544,78217797,1253,113,744,18,59.4,1.02
CpG: 68,chr1,78310063,78310738,675,68,467,20.1,69.2,0.85
CpG: 43,chr1,78488483,78488916,433,43,284,19.9,65.6,0.92
CpG: 20,chr1,78511827,78512070,243,20,158,16.5,65,0.8
CpG: 117,chr1,78657622,78658549,927,117,681,25.2,73.5,0.95
CpG: 33,chr1,79671574,79671937,363,33,244,18.2,67.2,0.81
CpG: 61,chr1,79761251,79761833,582,61,399,21,68.6,0.89
CpG: 37,chr1,79775983,79776386,403,37,266,18.4,66,0.84
CpG: 90,chr1,79858193,79859006,813,90,533,22.1,65.6,1.03
CpG: 78,chr1,80758071,80758785,714,78,502,21.8,70.3,0.89
CpG: 30,chr1,82283183,82283558,375,30,254,16,67.7,0.7
CpG: 127,chr1,82290195,82291822,1627,127,957,15.6,58.8,0.91
CpG: 56,chr1,82316445,82316916,471,56,319,23.8,67.7,1.06
CpG: 43,chr1,82724792,82725181,389,43,269,22.1,69.2,0.94
CpG: 109,chr1,82839328,82840320,992,109,705,22,71.1,0.88
CpG: 31,chr1,84284316,84284612,296,31,208,20.9,70.3,0.86
CpG: 27,chr1,84695498,84695745,247,27,160,21.9,64.8,1.06
CpG: 159,chr1,84838454,84840300,1846,159,1198,17.2,64.9,0.88
CpG: 135,chr1,85793327,85794491,1164,135,786,23.2,67.5,1.02
CpG: 43,chr1,85894474,85894906,432,43,295,19.9,68.3,0.88
CpG: 53,chr1,86018289,86018836,547,53,364,19.4,66.5,0.88
CpG: 105,chr1,86045856,86046583,727,105,556,28.9,76.5,1.01
CpG: 56,chr1,86064458,86065168,710,56,462,15.8,65.1,0.75
CpG: 38,chr1,86154608,86155041,433,38,288,17.6,66.5,0.8
CpG: 73,chr1,86303140,86303984,844,73,569,17.3,67.4,0.76
CpG: 155,chr1,86358611,86360007,1396,155,944,22.2,67.6,0.98
CpG: 49,chr1,86434301,86434867,566,49,397,17.3,70.1,0.71
CpG: 96,chr1,86441992,86443154,1162,96,725,16.5,62.4,0.85
CpG: 87,chr1,86487213,86488016,803,87,504,21.7,62.8,1.1
CpG: 60,chr1,86503849,86504493,644,60,439,18.6,68.2,0.8
CpG: 361,chr1,86524827,86528579,3752,361,2420,19.2,64.5,0.93
CpG: 42,chr1,86582144,86582638,494,42,335,17,67.8,0.77
CpG: 33,chr1,86587037,86587467,430,33,275,15.3,64,0.76
CpG: 93,chr1,86669612,86670874,1262,93,782,14.7,62,0.77
CpG: 67,chr1,86703618,86704161,543,67,385,24.7,70.9,1
CpG: 25,chr1,87098682,87098940,258,25,176,19.4,68.2,0.85
CpG: 126,chr1,87153912,87155085,1173,126,802,21.5,68.4,0.92
CpG: 32,chr1,87155838,87156120,282,32,200,22.7,70.9,0.93
CpG: 54,chr1,87186574,87187227,653,54,388,16.5,59.4,0.95
CpG: 64,chr1,87213816,87214382,566,64,362,22.6,64,1.11
CpG: 69,chr1,87264206,87264956,750,69,495,18.4,66,0.85
CpG: 75,chr1,87326822,87327563,741,75,516,20.2,69.6,0.84
CpG: 33,chr1,87475331,87475685,354,33,230,18.6,65,0.89
CpG: 101,chr1,87509540,87510557,1017,101,679,19.9,66.8,0.89
CpG: 90,chr1,87755866,87756662,796,90,508,22.6,63.8,1.11
CpG: 67,chr1,87853349,87853897,548,67,386,24.5,70.4,0.99
CpG: 45,chr1,88008207,88008601,394,45,283,22.8,71.8,0.94
CpG: 58,chr1,88205329,88205799,470,58,324,24.7,68.9,1.04
CpG: 49,chr1,88277213,88277704,491,49,316,20,64.4,0.97
CpG: 167,chr1,88700953,88702514,1561,167,1043,21.4,66.8,0.96
CpG: 66,chr1,89070436,89071245,809,66,506,16.3,62.5,0.85
CpG: 155,chr1,89454368,89455875,1507,155,857,20.6,56.9,1.28
CpG: 183,chr1,89580254,89581800,1546,183,1039,23.7,67.2,1.05
CpG: 22,chr1,89922851,89923131,280,22,181,15.7,64.6,0.78
CpG: 26,chr1,89928656,89928995,339,26,206,15.3,60.8,0.84
CpG: 140,chr1,89930082,89931398,1316,140,841,21.3,63.9,1.04
CpG: 48,chr1,89941589,89942209,620,48,383,15.5,61.8,0.83
CpG: 92,chr1,89968235,89968791,556,92,419,33.1,75.4,1.17
CpG: 27,chr1,89992163,89992477,314,27,171,17.2,54.5,1.16
CpG: 24,chr1,89992933,89993202,269,24,179,17.8,66.5,0.83
CpG: 58,chr1,90603176,90603710,534,58,343,21.7,64.2,1.06
CpG: 79,chr1,90998517,90999142,625,79,461,25.3,73.8,0.94
CpG: 46,chr1,91052628,91053202,574,46,380,16,66.2,0.76
CpG: 82,chr1,91250291,91250853,562,82,434,29.2,77.2,0.98
CpG: 68,chr1,91297895,91298794,899,68,574,15.1,63.8,0.75
CpG: 109,chr1,91344457,91345817,1360,109,933,16,68.6,0.68
CpG: 59,chr1,91366303,91366752,449,59,332,26.3,73.9,0.97
CpG: 90,chr1,91398097,91399067,970,90,608,18.6,62.7,0.95
CpG: 94,chr1,91412380,91413380,1000,94,682,18.8,68.2,0.81
CpG: 26,chr1,91414213,91414442,229,26,139,22.7,60.7,1.23
CpG: 73,chr1,91458999,91459734,735,73,424,19.9,57.7,1.2
CpG: 61,chr1,91494464,91494909,445,61,327,27.4,73.5,1.05
CpG: 70,chr1,91540317,91541072,755,70,501,18.5,66.4,0.84
CpG: 135,chr1,91800886,91802681,1795,135,1081,15,60.2,0.83
CpG: 106,chr1,92179620,92181074,1454,106,755,14.6,51.9,1.09
CpG: 61,chr1,92473460,92473964,504,61,340,24.2,67.5,1.07
CpG: 33,chr1,92641726,92642045,319,33,216,20.7,67.7,0.96
CpG: 23,chr1,92831246,92831553,307,23,193,15,62.9,0.76
CpG: 112,chr1,92831686,92832865,1179,112,802,19,68,0.82
CpG: 29,chr1,92848434,92848783,349,29,238,16.6,68.2,0.82
CpG: 70,chr1,92906972,92907592,620,70,409,22.6,66,1.04
CpG: 101,chr1,92910510,92911527,1017,101,608,19.9,59.8,1.13
CpG: 63,chr1,92934261,92934948,687,63,422,18.3,61.4,0.97
CpG: 33,chr1,93100328,93100711,383,33,252,17.2,65.8,0.8
CpG: 44,chr1,93101580,93102109,529,44,355,16.6,67.1,0.75
CpG: 34,chr1,93176597,93176931,334,34,231,20.4,69.2,0.86
CpG: 96,chr1,93235701,93236507,806,96,573,23.8,71.1,0.95
CpG: 23,chr1,93305704,93305961,257,23,166,17.9,64.6,0.87
CpG: 117,chr1,93342560,93344092,1532,117,944,15.3,61.6,0.8
CpG: 21,chr1,93401446,93401652,206,21,130,20.4,63.1,1.03
CpG: 84,chr1,93444931,93445766,835,84,548,20.1,65.6,0.93
CpG: 102,chr1,93478226,93479457,1231,102,789,16.6,64.1,0.81
CpG: 23,chr1,93511776,93512054,278,23,179,16.5,64.4,0.81
CpG: 95,chr1,93635101,93635978,877,95,613,21.7,69.9,0.89
CpG: 111,chr1,93685454,93686634,1180,111,752,18.8,63.7,0.93
CpG: 174,chr1,93753866,93755348,1482,174,1005,23.5,67.8,1.02
CpG: 48,chr1,93801690,93802178,488,48,298,19.7,61.1,1.06
CpG: 71,chr1,93803477,93804391,914,71,539,15.5,59,0.89
CpG: 21,chr1,93874525,93874841,316,21,193,13.3,61.1,0.72
CpG: 21,chr1,93940675,93940991,316,21,193,13.3,61.1,0.71
CpG: 81,chr1,95313518,95314246,728,81,516,22.3,70.9,0.89
CpG: 35,chr1,95667365,95667768,403,35,257,17.4,63.8,0.86
CpG: 23,chr1,96872144,96872429,285,23,186,16.1,65.3,0.77
CpG: 183,chr1,97660683,97662278,1595,183,1101,22.9,69,0.97
CpG: 95,chr1,97769532,97770690,1158,95,687,16.4,59.3,0.93
CpG: 42,chr1,97976934,97977255,321,42,240,26.2,74.8,0.94
CpG: 82,chr1,98095047,98095891,844,82,541,19.4,64.1,0.95
CpG: 32,chr1,104768481,104768920,439,32,271,14.6,61.7,0.78
CpG: 51,chr1,104993908,104994456,548,51,351,18.6,64.1,0.91
CpG: 77,chr1,105355962,105356898,936,77,625,16.5,66.8,0.75
CpG: 76,chr1,105663826,105664647,821,76,551,18.5,67.1,0.84
CpG: 182,chr1,105989879,105991754,1875,182,1151,19.4,61.4,1.03
CpG: 33,chr1,105993773,105994038,265,33,196,24.9,74,0.91
CpG: 184,chr1,106171429,106173330,1901,184,1120,19.4,58.9,1.12
CpG: 32,chr1,106712493,106712947,454,32,289,14.1,63.7,0.7
CpG: 51,chr1,106713656,106714232,576,51,368,17.7,63.9,0.87
CpG: 51,chr1,106759347,106759902,555,51,378,18.4,68.1,0.8
CpG: 55,chr1,106796242,106796781,539,55,371,20.4,68.8,0.88
CpG: 58,chr1,109982432,109983228,796,58,477,14.6,59.9,0.81
CpG: 51,chr1,111864486,111864996,510,51,360,20,70.6,0.81
CpG: 31,chr1,112416534,112416951,417,31,264,14.9,63.3,0.75
CpG: 57,chr1,118310997,118311533,536,57,363,21.3,67.7,0.93
CpG: 29,chr1,118321756,118322057,301,29,189,19.3,62.8,0.98
CpG: 24,chr1,118388759,118389005,246,24,142,19.5,57.7,1.17
CpG: 34,chr1,118389219,118389718,499,34,296,13.6,59.3,0.8
CpG: 37,chr1,118459277,118459794,517,37,303,14.3,58.6,0.83
CpG: 41,chr1,118627821,118628282,461,41,306,17.8,66.4,0.81
CpG: 46,chr1,118837394,118838033,639,46,416,14.4,65.1,0.7
CpG: 34,chr1,119053398,119053783,385,34,218,17.7,56.6,1.11
CpG: 20,chr1,119189576,119189828,252,20,152,15.9,60.3,0.87
CpG: 244,chr1,119420294,119422877,2583,244,1687,18.9,65.3,0.89
CpG: 52,chr1,119504422,119504997,575,52,383,18.1,66.6,0.83
CpG: 67,chr1,119525825,119526478,653,67,405,20.5,62,1.08
CpG: 83,chr1,119648353,119649055,702,83,492,23.6,70.1,0.97
CpG: 106,chr1,119836759,119837754,995,106,630,21.3,63.3,1.06
CpG: 23,chr1,119913153,119913411,258,23,165,17.8,64,0.9
CpG: 28,chr1,120073679,120073931,252,28,182,22.2,72.2,0.86
CpG: 35,chr1,120120917,120121280,363,35,223,19.3,61.4,1.03
CpG: 128,chr1,120340460,120341881,1421,128,958,18,67.4,0.79
CpG: 30,chr1,120342367,120342639,272,30,176,22.1,64.7,1.05
CpG: 90,chr1,120602843,120603990,1147,90,669,15.7,58.3,0.93
CpG: 32,chr1,120606906,120607285,379,32,240,16.9,63.3,0.85
CpG: 27,chr1,121177908,121178195,287,27,186,18.8,64.8,0.9
CpG: 44,chr1,121327653,121328143,490,44,337,18,68.8,0.76
CpG: 17,chr1,121430990,121431205,215,17,138,15.8,64.2,0.77
CpG: 49,chr1,121527415,121527955,540,49,340,18.1,63,0.92
CpG: 46,chr1,121567592,121568081,489,46,315,18.8,64.4,0.91
CpG: 63,chr1,124045451,124046133,682,63,439,18.5,64.4,0.9
CpG: 71,chr1,125560389,125561346,957,71,625,14.8,65.3,0.72
CpG: 69,chr1,125911448,125912249,801,69,529,17.2,66,0.79
CpG: 22,chr1,126492697,126492940,243,22,166,18.1,68.3,0.79
CpG: 61,chr1,127204918,127205651,733,61,474,16.6,64.7,0.81
CpG: 82,chr1,127677228,127678137,909,82,579,18,63.7,0.89
CpG: 91,chr1,127773918,127774860,942,91,603,19.3,64,0.97
CpG: 34,chr1,127868687,127869081,394,34,262,17.3,66.5,0.79
CpG: 24,chr1,128038533,128038780,247,24,145,19.4,58.7,1.13
CpG: 71,chr1,128103279,128103980,701,71,489,20.3,69.8,0.83
CpG: 84,chr1,128244099,128244972,873,84,567,19.2,64.9,0.92
CpG: 59,chr1,128359337,128359856,519,59,349,22.7,67.2,1.02
CpG: 62,chr1,128416824,128417442,618,62,419,20.1,67.8,0.89
CpG: 67,chr1,128590909,128591764,855,67,513,15.7,60,0.88
CpG: 23,chr1,129273481,129273770,289,23,191,15.9,66.1,0.73
CpG: 27,chr1,130715566,130715870,304,27,204,17.8,67.1,0.8
CpG: 93,chr1,130716676,130717833,1157,93,732,16.1,63.3,0.81
CpG: 37,chr1,130878193,130878535,342,37,242,21.6,70.8,0.87
CpG: 110,chr1,131096809,131097847,1038,110,682,21.2,65.7,0.98
CpG: 16,chr1,131129673,131129877,204,16,117,15.7,57.4,0.97
CpG: 75,chr1,131137776,131138378,602,75,448,24.9,74.4,0.9
CpG: 22,chr1,131153025,131153329,304,22,187,14.5,61.5,0.77
CpG: 103,chr1,131244662,131245555,893,103,627,23.1,70.2,0.94
CpG: 197,chr1,131525716,131528397,2681,197,1684,14.7,62.8,0.75
CpG: 55,chr1,131827610,131828289,679,55,438,16.2,64.5,0.78
CpG: 23,chr1,131867226,131867488,262,23,164,17.6,62.6,0.91
CpG: 98,chr1,131910244,131911218,974,98,630,20.1,64.7,0.97
CpG: 69,chr1,131962972,131963459,487,69,367,28.3,75.4,1.01
CpG: 123,chr1,132007342,132008412,1070,123,753,23,70.4,0.94
CpG: 68,chr1,132067625,132068248,623,68,440,21.8,70.6,0.88
CpG: 33,chr1,132139305,132139560,255,33,187,25.9,73.3,0.98
CpG: 105,chr1,132190087,132191155,1068,105,643,19.7,60.2,1.1
CpG: 28,chr1,132229003,132229380,377,28,212,14.9,56.2,0.94
CpG: 88,chr1,132298558,132299269,711,88,535,24.8,75.2,0.88
CpG: 66,chr1,132315898,132316555,657,66,435,20.1,66.2,0.92
CpG: 30,chr1,132360629,132361042,413,30,248,14.5,60,0.81
CpG: 56,chr1,132391390,132391882,492,56,325,22.8,66.1,1.04
CpG: 73,chr1,132417369,132417990,621,73,449,23.5,72.3,0.91
CpG: 21,chr1,132542784,132543007,223,21,161,18.8,72.2,0.74
CpG: 67,chr1,132880310,132880946,636,67,431,21.1,67.8,0.96
CpG: 30,chr1,133025085,133025419,334,30,236,18,70.7,0.76
CpG: 92,chr1,133045978,133046709,731,92,519,25.2,71,1
CpG: 94,chr1,133131080,133131904,824,94,561,22.8,68.1,0.99
CpG: 84,chr1,133163776,133164521,745,84,533,22.6,71.5,0.88
CpG: 21,chr1,133274094,133274355,261,21,173,16.1,66.3,0.76
CpG: 71,chr1,133363428,133364312,884,71,595,16.1,67.3,0.71
CpG: 153,chr1,133423057,133424444,1387,153,915,22.1,66,1.01
CpG: 75,chr1,133609752,133610435,683,75,458,22,67.1,1.02
CpG: 44,chr1,133660887,133661444,557,44,359,15.8,64.5,0.77
CpG: 62,chr1,134078807,134079438,631,62,422,19.7,66.9,0.88
CpG: 34,chr1,134092985,134093242,257,34,187,26.5,72.8,1
CpG: 35,chr1,134234704,134235089,385,35,264,18.2,68.6,0.78
CpG: 24,chr1,134235377,134235655,278,24,156,17.3,56.1,1.11
CpG: 55,chr1,134298895,134299450,555,55,397,19.8,71.5,0.78
CpG: 29,chr1,134344568,134344874,306,29,218,19,71.2,0.76
CpG: 45,chr1,134361776,134362168,392,45,277,23,70.7,0.92
CpG: 21,chr1,134405951,134406174,223,21,157,18.8,70.4,0.76
CpG: 84,chr1,134415248,134415959,711,84,503,23.6,70.7,0.95
CpG: 53,chr1,134455275,134455836,561,53,392,18.9,69.9,0.78
CpG: 46,chr1,134494514,134494948,434,46,291,21.2,67.1,0.95
CpG: 27,chr1,134513328,134513584,256,27,172,21.1,67.2,0.93
CpG: 33,chr1,134556259,134556601,342,33,233,19.3,68.1,0.84
CpG: 24,chr1,134556778,134557124,346,24,218,13.9,63,0.7
CpG: 136,chr1,134560080,134561744,1664,136,1055,16.3,63.4,0.84
CpG: 56,chr1,134646666,134647253,587,56,404,19.1,68.8,0.81
CpG: 50,chr1,134708873,134709423,550,50,375,18.2,68.2,0.79
CpG: 47,chr1,134955511,134955991,480,47,322,19.6,67.1,0.91
CpG: 40,chr1,134962406,134962752,346,40,234,23.1,67.6,1.03
CpG: 47,chr1,134987516,134988073,557,47,384,16.9,68.9,0.71
CpG: 19,chr1,135085371,135085593,222,19,153,17.1,68.9,0.74
CpG: 55,chr1,135104868,135105311,443,55,327,24.8,73.8,0.92
CpG: 115,chr1,135146495,135147566,1071,115,703,21.5,65.6,1
CpG: 76,chr1,135283531,135284122,591,76,432,25.7,73.1,0.96
CpG: 36,chr1,135313596,135313916,320,36,212,22.5,66.2,1.03
CpG: 22,chr1,135374915,135375165,250,22,162,17.6,64.8,0.84
CpG: 71,chr1,135429953,135430720,767,71,493,18.5,64.3,0.96
CpG: 19,chr1,135532492,135532693,201,19,135,18.9,67.2,0.85
CpG: 48,chr1,135584707,135585354,647,48,393,14.8,60.7,0.81
CpG: 80,chr1,135687731,135688484,753,80,512,21.2,68,0.93
CpG: 25,chr1,135729162,135729379,217,25,151,23,69.6,0.96
CpG: 96,chr1,135765880,135766710,830,96,602,23.1,72.5,0.9
CpG: 60,chr1,135818508,135819008,500,60,366,24,73.2,0.9
CpG: 60,chr1,135918709,135919286,577,60,392,20.8,67.9,0.9
CpG: 55,chr1,136050821,136051352,531,55,357,20.7,67.2,0.94
CpG: 69,chr1,136131275,136131926,651,69,479,21.2,73.6,0.79
CpG: 24,chr1,136140304,136140607,303,24,196,15.8,64.7,0.76
CpG: 27,chr1,136215816,136216116,300,27,201,18,67,0.8
CpG: 37,chr1,136234222,136234663,441,37,285,16.8,64.6,0.82
CpG: 133,chr1,136259769,136260914,1145,133,820,23.2,71.6,0.91
CpG: 110,chr1,136345398,136346321,923,110,606,23.8,65.7,1.11
CpG: 67,chr1,136415222,136415678,456,67,347,29.4,76.1,1.02
CpG: 45,chr1,136466216,136466630,414,45,286,21.7,69.1,0.96
CpG: 35,chr1,136624636,136625002,366,35,254,19.1,69.4,0.83
CpG: 34,chr1,136789139,136789568,429,34,265,15.9,61.8,0.86
CpG: 56,chr1,136948567,136949197,630,56,419,17.8,66.5,0.8
CpG: 23,chr1,136952915,136953134,219,23,150,21,68.5,0.91
CpG: 71,chr1,138619152,138619864,712,71,464,19.9,65.2,0.95
CpG: 48,chr1,138841498,138842069,571,48,351,16.8,61.5,0.89
CpG: 20,chr1,138843604,138843837,233,20,156,17.2,67,0.77
CpG: 20,chr1,138847193,138847449,256,20,148,15.6,57.8,0.94
CpG: 49,chr1,138856300,138856821,521,49,307,18.8,58.9,1.09
CpG: 93,chr1,138963394,138964108,714,93,494,26.1,69.2,1.09
CpG: 80,chr1,139422096,139422751,655,80,476,24.4,72.7,0.94
CpG: 58,chr1,139454634,139455233,599,58,389,19.4,64.9,0.93
CpG: 50,chr1,143702761,143703176,415,50,250,24.1,60.2,1.34
CpG: 56,chr1,143739387,143739756,369,56,277,30.4,75.1,1.14
CpG: 93,chr1,143776714,143777655,941,93,613,19.8,65.1,0.95
CpG: 44,chr1,144004129,144004509,380,44,257,23.2,67.6,1.04
CpG: 94,chr1,150392777,150393719,942,94,617,20,65.5,0.93
CpG: 32,chr1,150993278,150993599,321,32,227,19.9,70.7,0.8
CpG: 127,chr1,151344225,151345424,1199,127,763,21.2,63.6,1.07
CpG: 84,chr1,151428085,151429020,935,84,602,18,64.4,0.87
CpG: 105,chr1,151500026,151501141,1115,105,651,18.8,58.4,1.11
CpG: 38,chr1,151571313,151571755,442,38,304,17.2,68.8,0.73
CpG: 70,chr1,151755184,151755925,741,70,507,18.9,68.4,0.82
CpG: 71,chr1,152089616,152090328,712,71,490,19.9,68.8,0.84
CpG: 56,chr1,152386313,152386744,431,56,319,26,74,0.95
CpG: 60,chr1,152399918,152400364,446,60,320,26.9,71.7,1.05
CpG: 35,chr1,152624908,152625288,380,35,231,18.4,60.8,1
CpG: 151,chr1,152765927,152767261,1334,151,920,22.6,69,0.95
CpG: 170,chr1,152901953,152903964,2011,170,1193,16.9,59.3,0.98
CpG: 86,chr1,152954930,152956251,1321,86,799,13,60.5,0.74
CpG: 32,chr1,153185935,153186287,352,32,237,18.2,67.3,0.8
CpG: 101,chr1,153332003,153333079,1076,101,711,18.8,66.1,0.87
CpG: 46,chr1,153425155,153425591,436,46,306,21.1,70.2,0.86
CpG: 91,chr1,153486981,153487778,797,91,548,22.8,68.8,0.99
CpG: 26,chr1,153549548,153549837,289,26,196,18,67.8,0.78
CpG: 106,chr1,153899777,153901066,1289,106,825,16.4,64,0.8
CpG: 23,chr1,153907915,153908159,244,23,147,18.9,60.2,1.05
CpG: 58,chr1,154204837,154205538,701,58,452,16.5,64.5,0.82
CpG: 33,chr1,154799259,154799676,417,33,293,15.8,70.3,0.64
CpG: 40,chr1,155083181,155083561,380,40,230,21.1,60.5,1.15
CpG: 147,chr1,155098325,155099738,1413,147,985,20.8,69.7,0.86
CpG: 83,chr1,155158548,155159280,732,83,527,22.7,72,0.9
CpG: 98,chr1,155244091,155244947,856,98,635,22.9,74.2,0.83
CpG: 75,chr1,155416849,155417545,696,75,506,21.6,72.7,0.83
CpG: 76,chr1,155558147,155558794,647,76,459,23.5,70.9,0.94
CpG: 85,chr1,155736867,155737982,1115,85,689,15.2,61.8,0.8
CpG: 159,chr1,155741117,155743246,2129,159,1322,14.9,62.1,0.78
CpG: 70,chr1,155812433,155813157,724,70,466,19.3,64.4,0.93
CpG: 87,chr1,155972723,155973671,948,87,646,18.4,68.1,0.79
CpG: 85,chr1,156035532,156036386,854,85,519,19.9,60.8,1.08
CpG: 44,chr1,156204683,156205085,402,44,295,21.9,73.4,0.82
CpG: 83,chr1,156303117,156303790,673,83,476,24.7,70.7,0.99
CpG: 43,chr1,156420694,156421188,494,43,302,17.4,61.1,0.93
CpG: 43,chr1,156474014,156474393,379,43,274,22.7,72.3,0.87
CpG: 95,chr1,156558496,156559438,942,95,631,20.2,67,0.93
CpG: 34,chr1,156674055,156674416,361,34,250,18.8,69.3,0.79
CpG: 60,chr1,156718337,156718908,571,60,368,21,64.4,1.03
CpG: 112,chr1,156938962,156940007,1045,112,607,21.4,58.1,1.27
CpG: 129,chr1,157411786,157412829,1043,129,751,24.7,72,0.95
CpG: 25,chr1,158356039,158356243,204,25,146,24.5,71.6,0.96
CpG: 25,chr1,158362548,158362875,327,25,208,15.3,63.6,0.76
CpG: 80,chr1,159231781,159232536,755,80,474,21.2,62.8,1.09
CpG: 31,chr1,160194961,160195410,449,31,276,13.8,61.5,0.73
CpG: 102,chr1,160212438,160213405,967,102,635,21.1,65.7,0.98
CpG: 100,chr1,160792029,160793170,1141,100,666,17.5,58.4,1.04
CpG: 81,chr1,160906209,160907096,887,81,564,18.3,63.6,0.92
CpG: 70,chr1,161034404,161035181,777,70,526,18,67.7,0.81
CpG: 42,chr1,161070648,161071145,497,42,286,16.9,57.5,1.05
CpG: 15,chr1,161142783,161143001,218,15,132,13.8,60.6,0.75
CpG: 41,chr1,161170642,161170990,348,41,256,23.6,73.6,0.87
CpG: 44,chr1,161250817,161251278,461,44,288,19.1,62.5,1
CpG: 25,chr1,161727446,161727681,235,25,165,21.3,70.2,0.88
CpG: 60,chr1,161876451,161877098,647,60,362,18.5,56,1.2
CpG: 38,chr1,161969118,161969514,396,38,259,19.2,65.4,0.9
CpG: 42,chr1,162477565,162478079,514,42,345,16.3,67.1,0.75
CpG: 42,chr1,162548264,162548709,445,42,291,18.9,65.4,0.88
CpG: 108,chr1,162570353,162571602,1249,108,784,17.3,62.8,0.88
CpG: 82,chr1,162739971,162740673,702,82,489,23.4,69.7,0.97
CpG: 50,chr1,163312001,163312621,620,50,416,16.1,67.1,0.74
CpG: 74,chr1,163929784,163930411,627,74,461,23.6,73.5,0.88
CpG: 60,chr1,163994433,163995154,721,60,439,16.6,60.9,0.91
CpG: 22,chr1,164248619,164248915,296,22,189,14.9,63.9,0.74
CpG: 75,chr1,164249039,164249686,647,75,437,23.2,67.5,1.02
CpG: 20,chr1,164307457,164307684,227,20,136,17.6,59.9,1.04
CpG: 107,chr1,164457666,164458737,1071,107,680,20,63.5,0.99
CpG: 66,chr1,165193911,165194575,664,66,464,19.9,69.9,0.82
CpG: 64,chr1,165236383,165237118,735,64,446,17.4,60.7,0.95
CpG: 61,chr1,165281918,165282567,649,61,466,18.8,71.8,0.73
CpG: 149,chr1,165459579,165461564,1985,149,1191,15,60,0.84
CpG: 53,chr1,165634115,165634787,672,53,407,15.8,60.6,0.91
CpG: 40,chr1,165642347,165642678,331,40,231,24.2,69.8,1
CpG: 29,chr1,165707783,165708059,276,29,194,21,70.3,0.86
CpG: 53,chr1,165763705,165764219,514,53,347,20.6,67.5,0.91
CpG: 24,chr1,165845013,165845260,247,24,169,19.4,68.4,0.9
CpG: 203,chr1,166001465,166003585,2120,203,1319,19.2,62.2,1
CpG: 47,chr1,166238497,166238965,468,47,325,20.1,69.4,0.84
CpG: 33,chr1,166253979,166254247,268,33,182,24.6,67.9,1.07
CpG: 89,chr1,166308841,166309482,641,89,463,27.8,72.2,1.07
CpG: 18,chr1,166378930,166379154,224,18,129,16.1,57.6,1.03
CpG: 67,chr1,166379307,166379976,669,67,429,20,64.1,0.98
CpG: 85,chr1,166409386,166410061,675,85,505,25.2,74.8,0.9
CpG: 146,chr1,167000591,167001863,1272,146,887,23,69.7,0.95
CpG: 15,chr1,167226375,167226581,206,15,129,14.6,62.6,0.79
CpG: 145,chr1,167283764,167285152,1388,145,958,20.9,69,0.88
CpG: 85,chr1,167308249,167309065,816,85,538,20.8,65.9,0.96
CpG: 43,chr1,167350131,167350541,410,43,273,21,66.6,0.95
CpG: 24,chr1,167394071,167394421,350,24,211,13.7,60.3,0.75
CpG: 17,chr1,167661214,167661453,239,17,165,14.2,69,0.6
CpG: 107,chr1,167688274,167689255,981,107,691,21.8,70.4,0.88
CpG: 22,chr1,167692181,167692395,214,22,135,20.6,63.1,1.03
CpG: 37,chr1,167803055,167803272,217,37,163,34.1,75.1,1.21
CpG: 21,chr1,167929789,167929998,209,21,135,20.1,64.6,0.97
CpG: 29,chr1,169531289,169531599,310,29,182,18.7,58.7,1.09
CpG: 43,chr1,169968945,169969431,486,43,312,17.7,64.2,0.87
CpG: 72,chr1,170174609,170175289,680,72,416,21.2,61.2,1.13
CpG: 59,chr1,170215003,170215422,419,59,322,28.2,76.8,0.96
CpG: 49,chr1,170255385,170255751,366,49,276,26.8,75.4,0.94
CpG: 88,chr1,170589279,170590058,779,88,499,22.6,64.1,1.13
CpG: 42,chr1,170644195,170644660,465,42,316,18.1,68,0.8
CpG: 35,chr1,170867512,170867858,346,35,216,20.2,62.4,1.05
CpG: 46,chr1,170885006,170885507,501,46,345,18.4,68.9,0.78
CpG: 75,chr1,170907403,170908171,768,75,524,19.5,68.2,0.85
CpG: 20,chr1,170908619,170908877,258,20,154,15.5,59.7,0.87
CpG: 25,chr1,171038072,171038372,300,25,157,16.7,52.3,1.23
CpG: 181,chr1,171063939,171065960,2021,181,1198,17.9,59.3,1.02
CpG: 35,chr1,171070327,171070786,459,35,296,15.3,64.5,0.74
CpG: 16,chr1,171072098,171072332,234,16,154,13.7,65.8,0.65
CpG: 133,chr1,171072410,171073595,1185,133,800,22.4,67.5,0.99
CpG: 37,chr1,171077941,171078407,466,37,303,15.9,65,0.75
CpG: 180,chr1,171079181,171081209,2028,180,1197,17.8,59,1.02
CpG: 36,chr1,171085563,171086059,496,36,313,14.5,63.1,0.73
CpG: 19,chr1,171102494,171102718,224,19,156,17,69.6,0.79
CpG: 26,chr1,171150341,171150666,325,26,219,16,67.4,0.71
CpG: 25,chr1,171195925,171196155,230,25,170,21.7,73.9,0.81
CpG: 34,chr1,171247014,171247401,387,34,242,17.6,62.5,0.91
CpG: 40,chr1,171270155,171270714,559,40,354,14.3,63.3,0.73
CpG: 45,chr1,171287538,171288060,522,45,365,17.2,69.9,0.74
CpG: 27,chr1,171294470,171294818,348,27,199,15.5,57.2,0.97
CpG: 47,chr1,171328889,171329488,599,47,365,15.7,60.9,0.87
CpG: 40,chr1,171345438,171345901,463,40,295,17.3,63.7,0.87
CpG: 16,chr1,171360797,171361019,222,16,120,14.4,54.1,0.99
CpG: 69,chr1,171411209,171411871,662,69,463,20.8,69.9,0.86
CpG: 39,chr1,171437430,171437953,523,39,332,14.9,63.5,0.74
CpG: 69,chr1,171503388,171504200,812,69,487,17,60,0.96
CpG: 21,chr1,171679775,171679999,224,21,151,18.8,67.4,0.83
CpG: 42,chr1,172026998,172027483,485,42,299,17.3,61.6,0.93
CpG: 30,chr1,172054001,172054248,247,30,172,24.3,69.6,1.01
CpG: 48,chr1,172082539,172083159,620,48,383,15.5,61.8,0.82
CpG: 62,chr1,172147961,172148562,601,62,418,20.6,69.6,0.86
CpG: 18,chr1,172172578,172172820,242,18,143,14.9,59.1,0.85
CpG: 28,chr1,172312329,172312632,303,28,219,18.5,72.3,0.71
CpG: 101,chr1,172325700,172326579,879,101,576,23,65.5,1.08
CpG: 24,chr1,172340865,172341194,329,24,204,14.6,62,0.9
CpG: 95,chr1,172376350,172377347,997,95,616,19.1,61.8,1
CpG: 29,chr1,172481968,172482213,245,29,170,23.7,69.4,0.99
CpG: 55,chr1,172500078,172500860,782,55,492,14.1,62.9,0.71
CpG: 52,chr1,172562961,172563360,399,52,292,26.1,73.2,0.98
CpG: 46,chr1,172632538,172633129,591,46,398,15.6,67.3,0.69
CpG: 49,chr1,173367181,173367799,618,49,429,15.9,69.4,0.66
CpG: 60,chr1,174501729,174502540,811,60,532,14.8,65.6,0.7
CpG: 28,chr1,174503311,174503629,318,28,221,17.6,69.5,0.73
CpG: 19,chr1,174836847,174837093,246,19,149,15.4,60.6,0.86
CpG: 69,chr1,175492098,175492716,618,69,407,22.3,65.9,1.03
CpG: 51,chr1,175625278,175625660,382,51,271,26.7,70.9,1.06
CpG: 101,chr1,175692085,175693081,996,101,695,20.3,69.8,0.85
CpG: 60,chr1,175880606,175881239,633,60,404,19,63.8,0.94
CpG: 82,chr1,176274633,176275572,939,82,584,17.5,62.2,0.91
CpG: 95,chr1,176813368,176814723,1355,95,791,14,58.4,0.83
CpG: 146,chr1,177257299,177259121,1822,146,964,16,52.9,1.17
CpG: 37,chr1,177322715,177323108,393,37,242,18.8,61.6,1.03
CpG: 20,chr1,177338930,177339192,262,20,161,15.3,61.5,0.81
CpG: 132,chr1,177441491,177442776,1285,132,753,20.5,58.6,1.2
CpG: 20,chr1,177448273,177448537,264,20,163,15.2,61.7,0.8
CpG: 52,chr1,177795934,177796483,549,52,385,18.9,70.1,0.78
CpG: 72,chr1,177983180,177984000,820,72,551,17.6,67.2,0.78
CpG: 77,chr1,178187432,178188253,821,77,578,18.8,70.4,0.76
CpG: 73,chr1,178276097,178276585,488,73,352,29.9,72.1,1.17
CpG: 107,chr1,178318207,178319311,1104,107,722,19.4,65.4,0.92
CpG: 200,chr1,178336419,178338012,1593,200,1128,25.1,70.8,1.03
CpG: 30,chr1,178368934,178369181,247,30,175,24.3,70.9,0.97
CpG: 88,chr1,178405659,178406671,1012,88,659,17.4,65.1,0.82
CpG: 270,chr1,178527287,178530895,3608,270,2259,15,62.6,0.76
CpG: 30,chr1,179517731,179518067,336,30,218,17.9,64.9,0.87
CpG: 107,chr1,179545916,179546885,969,107,643,22.1,66.4,1.01
CpG: 91,chr1,179667884,179668692,808,91,560,22.5,69.3,0.95
CpG: 123,chr1,179802926,179804038,1112,123,697,22.1,62.7,1.13
CpG: 118,chr1,179959520,179960569,1049,118,666,22.5,63.5,1.12
CpG: 56,chr1,180195709,180196322,613,56,394,18.3,64.3,0.89
CpG: 58,chr1,180255878,180256423,545,58,400,21.3,73.4,0.8
CpG: 157,chr1,180330555,180332867,2312,157,1422,13.6,61.5,0.72
CpG: 39,chr1,180483196,180483577,381,39,262,20.5,68.8,0.87
CpG: 76,chr1,180568728,180569491,763,76,514,19.9,67.4,0.88
CpG: 116,chr1,180640767,180641881,1114,116,696,20.8,62.5,1.07
CpG: 84,chr1,180696595,180697327,732,84,518,23,70.8,0.92
CpG: 105,chr1,180725762,180726715,953,105,665,22,69.8,0.91
CpG: 54,chr1,180777732,180778382,650,54,431,16.6,66.3,0.76
CpG: 19,chr1,180794168,180794426,258,19,174,14.7,67.4,0.66
CpG: 148,chr1,180812492,180814356,1864,148,1031,15.9,55.3,1.04
CpG: 72,chr1,180850520,180851311,791,72,517,18.2,65.4,0.85
CpG: 32,chr1,180894424,180894798,374,32,254,17.1,67.9,0.76
CpG: 41,chr1,180904154,180904539,385,41,256,21.3,66.5,0.96
CpG: 21,chr1,180936981,180937192,211,21,142,19.9,67.3,0.89
CpG: 57,chr1,180942243,180942939,696,57,430,16.4,61.8,0.86
CpG: 36,chr1,181143973,181144305,332,36,220,21.7,66.3,1
CpG: 51,chr1,181150891,181151345,454,51,306,22.5,67.4,0.99
CpG: 121,chr1,181210807,181212388,1581,121,945,15.3,59.8,0.86
CpG: 66,chr1,181352377,181352907,530,66,377,24.9,71.1,0.99
CpG: 119,chr1,181841863,181842754,891,119,627,26.7,70.4,1.09
CpG: 19,chr1,181923509,181923713,204,19,138,18.6,67.6,0.91
CpG: 131,chr1,182019510,182020714,1204,131,675,21.8,56.1,1.39
CpG: 65,chr1,182124654,182125276,622,65,438,20.9,70.4,0.85
CpG: 80,chr1,182282094,182282871,777,80,524,20.6,67.4,0.91
CpG: 72,chr1,182340986,182341585,599,72,397,24,66.3,1.1
CpG: 98,chr1,182408662,182409611,949,98,620,20.7,65.3,0.97
CpG: 79,chr1,182516998,182517820,822,79,544,19.2,66.2,0.88
CpG: 42,chr1,182763892,182764150,258,42,206,32.6,79.8,1.08
CpG: 39,chr1,183087493,183088015,522,39,320,14.9,61.3,0.8
CpG: 55,chr1,183088462,183089219,757,55,428,14.5,56.5,0.91
CpG: 44,chr1,183221214,183221544,330,44,247,26.7,74.8,1
CpG: 97,chr1,183296524,183297797,1273,97,834,15.2,65.5,0.71
CpG: 48,chr1,183345070,183345515,445,48,314,21.6,70.6,0.87
CpG: 106,chr1,184033312,184034537,1225,106,811,17.3,66.2,0.79
CpG: 27,chr1,184718485,184718804,319,27,202,16.9,63.3,0.86
CpG: 23,chr1,184727715,184727970,255,23,168,18,65.9,0.85
CpG: 109,chr1,184731654,184733045,1391,109,869,15.7,62.5,0.81
CpG: 43,chr1,184810769,184811173,404,43,283,21.3,70,0.87
CpG: 53,chr1,184845500,184845995,495,53,347,21.4,70.1,0.87
CpG: 66,chr1,184882561,184883166,605,66,423,21.8,69.9,0.9
CpG: 42,chr1,184956375,184956870,495,42,340,17,68.7,0.72
CpG: 52,chr1,185203931,185204409,478,52,335,21.8,70.1,0.9
CpG: 57,chr1,185328863,185329438,575,57,385,19.8,67,0.88
CpG: 19,chr1,185341141,185341429,288,19,158,13.2,54.9,0.88
CpG: 86,chr1,185362829,185363485,656,86,462,26.2,70.4,1.07
CpG: 74,chr1,185454936,185455661,725,74,501,20.4,69.1,0.86
CpG: 32,chr1,186117069,186117376,307,32,211,20.8,68.7,0.89
CpG: 23,chr1,186704280,186704525,245,23,145,18.8,59.2,1.09
CpG: 54,chr1,186705139,186705716,577,54,363,18.7,62.9,0.95
CpG: 21,chr1,186749248,186749502,254,21,157,16.5,61.8,0.87
CpG: 77,chr1,186967389,186968306,917,77,554,16.8,60.4,0.94
CpG: 41,chr1,187215468,187215800,332,41,227,24.7,68.4,1.07
CpG: 21,chr1,187607313,187607594,281,21,187,14.9,66.5,0.69
CpG: 73,chr1,187608997,187609682,685,73,456,21.3,66.6,0.96
CpG: 69,chr1,189007232,189007958,726,69,490,19,67.5,0.85
CpG: 75,chr1,189343314,189343982,668,75,490,22.5,73.4,0.84
CpG: 51,chr1,189687914,189688439,525,51,357,19.4,68,0.84
CpG: 103,chr1,189727926,189728833,907,103,660,22.7,72.8,0.87
CpG: 68,chr1,189921890,189922398,508,68,382,26.8,75.2,0.95
CpG: 33,chr1,190169225,190169601,376,33,263,17.6,69.9,0.75
CpG: 33,chr1,190170590,190171031,441,33,272,15,61.7,0.79
CpG: 32,chr1,190172743,190173199,456,32,282,14,61.8,0.73
CpG: 58,chr1,190174914,190175594,680,58,466,17.1,68.5,0.73
CpG: 17,chr1,190682137,190682339,202,17,133,16.8,65.8,0.78
CpG: 37,chr1,190911493,190911931,438,37,288,16.9,65.8,0.78
CpG: 61,chr1,190928447,190928974,527,61,357,23.1,67.7,1.04
CpG: 112,chr1,190978248,190979451,1203,112,810,18.6,67.3,0.82
CpG: 94,chr1,191025524,191026487,963,94,648,19.5,67.3,0.86
CpG: 62,chr1,191062647,191063355,708,62,449,17.5,63.4,0.87
CpG: 68,chr1,191097856,191098676,820,68,455,16.6,55.5,1.08
CpG: 27,chr1,191125896,191126160,264,27,180,20.5,68.2,0.88
CpG: 149,chr1,191182423,191184370,1947,149,1184,15.3,60.8,0.83
CpG: 31,chr1,191184726,191185191,465,31,293,13.3,63,0.69
CpG: 17,chr1,191185317,191185550,233,17,139,14.6,59.7,0.82
CpG: 56,chr1,191224326,191224923,597,56,395,18.8,66.2,0.88
CpG: 48,chr1,191317791,191318143,352,48,277,27.3,78.7,0.88
CpG: 61,chr1,191325846,191326480,634,61,434,19.2,68.5,0.82
CpG: 177,chr1,191396078,191397801,1723,177,1098,20.5,63.7,1.02
CpG: 118,chr1,191574955,191576091,1136,118,734,20.8,64.6,1
CpG: 128,chr1,191717734,191719135,1401,128,803,18.3,57.3,1.12
CpG: 77,chr1,191821249,191821971,722,77,473,21.3,65.5,1
CpG: 126,chr1,191906596,191907697,1101,126,740,22.9,67.2,1.02
CpG: 25,chr1,191985233,191985498,265,25,179,18.9,67.5,0.83
CpG: 49,chr1,192092267,192092751,484,49,329,20.2,68,0.89
CpG: 139,chr1,192136724,192138612,1888,139,1040,14.7,55.1,0.97
CpG: 58,chr1,192190665,192191086,421,58,321,27.6,76.2,0.95
CpG: 53,chr1,192770640,192771138,498,53,331,21.3,66.5,0.97
CpG: 15,chr1,192833588,192833792,204,15,129,14.7,63.2,0.74
CpG: 42,chr1,192834625,192835051,426,42,282,19.7,66.2,0.91
CpG: 72,chr1,192854886,192855455,569,72,420,25.3,73.8,0.93
CpG: 58,chr1,193035479,193036021,542,58,380,21.4,70.1,0.89
CpG: 59,chr1,193129819,193130377,558,59,361,21.1,64.7,1.01
CpG: 41,chr1,193152869,193153412,543,41,371,15.1,68.3,0.66
CpG: 36,chr1,193173370,193173801,431,36,272,16.7,63.1,0.84
CpG: 112,chr1,194619660,194620876,1216,112,811,18.4,66.7,0.84
CpG: 70,chr1,194976273,194976831,558,70,386,25.1,69.2,1.07
CpG: 28,chr1,195241589,195241861,272,28,165,20.6,60.7,1.17
CpG: 42,chr2,69205858,69206295,437,42,289,19.2,66.1,0.9
CpG: 74,chr2,39190203,39191002,799,74,565,18.5,70.7,0.76
CpG: 77,chr2,119799325,119800040,715,77,483,21.5,67.6,0.99
CpG: 42,chr2,127008611,127009056,445,42,291,18.9,65.4,0.89
CpG: 85,chr2,135659044,135660003,959,85,486,17.7,50.7,1.38
CpG: 131,chr2,170130446,170131522,1076,131,717,24.3,66.6,1.11
CpG: 85,chr2,3118208,3118863,655,85,484,26,73.9,0.97
CpG: 143,chr2,3283705,3285096,1391,143,976,20.6,70.2,0.85
CpG: 47,chr2,3332259,3332755,496,47,318,19,64.1,0.92
CpG: 33,chr2,3418947,3419265,318,33,207,20.8,65.1,0.98
CpG: 103,chr2,3474434,3475299,865,103,601,23.8,69.5,0.99
CpG: 58,chr2,3512520,3513282,762,58,473,15.2,62.1,0.79
CpG: 48,chr2,3713363,3713799,436,48,282,22,64.7,1.06
CpG: 55,chr2,4401153,4401634,481,55,312,22.9,64.9,1.11
CpG: 53,chr2,4603471,4604164,693,53,447,15.3,64.5,0.74
CpG: 104,chr2,4717462,4718320,858,104,580,24.2,67.6,1.06
CpG: 112,chr2,4881663,4882645,982,112,632,22.8,64.4,1.11
CpG: 25,chr2,5012546,5012804,258,25,165,19.4,64,1
CpG: 49,chr2,5063758,5064198,440,49,310,22.3,70.5,0.92
CpG: 22,chr2,5083511,5083742,231,22,156,19,67.5,0.89
CpG: 60,chr2,5137609,5138093,484,60,335,24.8,69.2,1.04
CpG: 137,chr2,5713742,5715268,1526,137,1030,18,67.5,0.79
CpG: 53,chr2,5844919,5845561,642,53,379,16.5,59,0.95
CpG: 57,chr2,5895006,5895538,532,57,379,21.4,71.2,0.85
CpG: 25,chr2,5942522,5942803,281,25,173,17.8,61.6,0.94
CpG: 19,chr2,5950870,5951101,231,19,136,16.5,58.9,1.22
CpG: 60,chr2,5951291,5951958,667,60,428,18,64.2,0.9
CpG: 60,chr2,6100358,6101023,665,60,444,18,66.8,0.81
CpG: 79,chr2,6129611,6130306,695,79,475,22.7,68.3,0.98
CpG: 112,chr2,6322384,6323545,1161,112,691,19.3,59.5,1.1
CpG: 62,chr2,6872251,6872914,663,62,341,18.7,51.4,1.42
CpG: 28,chr2,9874641,9874956,315,28,217,17.8,68.9,0.83
CpG: 39,chr2,9877287,9877685,398,39,256,19.6,64.3,0.95
CpG: 29,chr2,9881092,9881434,342,29,196,17,57.3,1.04
CpG: 66,chr2,9882253,9883100,847,66,495,15.6,58.4,0.92
CpG: 75,chr2,10047908,10048762,854,75,577,17.6,67.6,0.77
CpG: 75,chr2,10080057,10080881,824,75,528,18.2,64.1,0.9
CpG: 48,chr2,10372483,10373109,626,48,379,15.3,60.5,0.84
CpG: 18,chr2,10374001,10374236,235,18,129,15.3,54.9,1.02
CpG: 39,chr2,10374789,10375267,478,39,290,16.3,60.7,0.91
CpG: 44,chr2,11172097,11172453,356,44,262,24.7,73.6,0.91
CpG: 35,chr2,11290157,11290630,473,35,266,14.8,56.2,0.94
CpG: 68,chr2,11501301,11502211,910,68,573,14.9,63,0.75
CpG: 22,chr2,11503054,11503306,252,22,143,17.5,56.7,1.09
CpG: 34,chr2,11535349,11535765,416,34,271,16.3,65.1,0.77
CpG: 58,chr2,11553593,11554108,515,58,368,22.5,71.5,0.9
CpG: 61,chr2,11602879,11603307,428,61,319,28.5,74.5,1.03
CpG: 59,chr2,11777297,11777897,600,59,411,19.7,68.5,0.84
CpG: 18,chr2,11778260,11778491,231,18,138,15.6,59.7,0.94
CpG: 21,chr2,11778607,11778877,270,21,175,15.6,64.8,0.74
CpG: 52,chr2,12301537,12302095,558,52,373,18.6,66.8,0.84
CpG: 56,chr2,12418773,12419494,721,56,465,15.5,64.5,0.78
CpG: 100,chr2,13009969,13011291,1322,100,836,15.1,63.2,0.76
CpG: 17,chr2,13011487,13011698,211,17,131,16.1,62.1,0.86
CpG: 19,chr2,13271249,13271505,256,19,155,14.8,60.5,0.82
CpG: 55,chr2,13574347,13575013,666,55,419,16.5,62.9,0.84
CpG: 66,chr2,13793075,13793793,718,66,459,18.4,63.9,0.91
CpG: 129,chr2,14055077,14056215,1138,129,708,22.7,62.2,1.18
CpG: 62,chr2,14073866,14074499,633,62,433,19.6,68.4,0.84
CpG: 99,chr2,14604008,14605030,1022,99,673,19.4,65.9,0.9
CpG: 17,chr2,14627145,14627366,221,17,112,15.4,50.7,1.2
CpG: 84,chr2,15054933,15055708,775,84,538,21.7,69.4,0.9
CpG: 41,chr2,16356320,16356831,511,41,323,16,63.2,0.81
CpG: 51,chr2,17730836,17731438,602,51,396,16.9,65.8,0.79
CpG: 22,chr2,18026552,18026829,277,22,186,15.9,67.1,0.72
CpG: 112,chr2,18027383,18029013,1630,112,1053,13.7,64.6,0.66
CpG: 46,chr2,18031615,18032183,568,46,359,16.2,63.2,0.81
CpG: 42,chr2,18039695,18040144,449,42,295,18.7,65.7,0.87
CpG: 53,chr2,18047482,18048218,736,53,370,14.4,50.3,1.15
CpG: 112,chr2,18056412,18057954,1542,112,884,14.5,57.3,0.88
CpG: 141,chr2,18064202,18065623,1421,141,865,19.8,60.9,1.07
CpG: 71,chr2,18392241,18392894,653,71,461,21.7,70.6,0.87
CpG: 43,chr2,18609224,18609768,544,43,346,15.8,63.6,0.8
CpG: 77,chr2,18672010,18672790,780,77,460,19.7,59,1.14
CpG: 26,chr2,18680936,18681217,281,26,166,18.5,59.1,1.06
CpG: 162,chr2,18688720,18690513,1793,162,1185,18.1,66.1,0.83
CpG: 64,chr2,18694155,18694805,650,64,464,19.7,71.4,0.78
CpG: 46,chr2,18698656,18699226,570,46,354,16.1,62.1,0.84
CpG: 51,chr2,18766909,18767399,490,51,325,20.8,66.3,0.95
CpG: 35,chr2,18800079,18800510,431,35,281,16.2,65.2,0.76
CpG: 122,chr2,18997444,18998634,1190,122,804,20.5,67.6,0.9
CpG: 23,chr2,19371666,19371913,247,23,166,18.6,67.2,0.84
CpG: 44,chr2,19430829,19431329,500,44,319,17.6,63.8,0.88
CpG: 37,chr2,19431907,19432378,471,37,316,15.7,67.1,0.7
CpG: 125,chr2,19445336,19446644,1308,125,879,19.1,67.2,0.85
CpG: 162,chr2,19657539,19659118,1579,162,940,20.5,59.5,1.16
CpG: 56,chr2,19909595,19910329,734,56,471,15.3,64.2,0.74
CpG: 37,chr2,20519515,20519995,480,37,315,15.4,65.6,0.72
CpG: 153,chr2,20968017,20969691,1674,153,1004,18.3,60,1.02
CpG: 38,chr2,21141867,21142247,380,38,266,20,70,0.82
CpG: 38,chr2,21205586,21206014,428,38,275,17.8,64.3,0.86
CpG: 25,chr2,21367725,21368045,320,25,197,15.6,61.6,0.85
CpG: 20,chr2,21368771,21369010,239,20,164,16.7,68.6,0.72
CpG: 110,chr2,22622177,22623876,1699,110,1036,12.9,61,0.7
CpG: 67,chr2,22895408,22896016,608,67,413,22,67.9,0.98
CpG: 59,chr2,23039494,23040179,685,59,464,17.2,67.7,0.75
CpG: 42,chr2,23068057,23068610,553,42,328,15.2,59.3,0.86
CpG: 24,chr2,23069031,23069241,210,24,151,22.9,71.9,0.95
CpG: 37,chr2,23155789,23156110,321,37,218,23.1,67.9,1
CpG: 29,chr2,23234413,23234668,255,29,139,22.7,54.5,1.53
CpG: 17,chr2,23508672,23508873,201,17,123,16.9,61.2,0.9
CpG: 41,chr2,23571664,23572152,488,41,308,16.8,63.1,0.84
CpG: 40,chr2,24367457,24367788,331,40,235,24.2,71,0.97
CpG: 36,chr2,24474100,24474420,320,36,196,22.5,61.2,1.26
CpG: 48,chr2,24678983,24679525,542,48,358,17.7,66.1,0.81
CpG: 130,chr2,24762066,24763472,1406,130,897,18.5,63.8,0.94
CpG: 102,chr2,24918777,24919758,981,102,601,20.8,61.3,1.12
CpG: 45,chr2,24934809,24935259,450,45,317,20,70.4,0.83
CpG: 104,chr2,24949416,24950409,993,104,562,20.9,56.6,1.31
CpG: 17,chr2,24962329,24962547,218,17,132,15.6,60.6,0.88
CpG: 72,chr2,24974785,24975559,774,72,500,18.6,64.6,0.89
CpG: 37,chr2,25054380,25054705,325,37,238,22.8,73.2,0.86
CpG: 25,chr2,25168000,25168201,201,25,151,24.9,75.1,0.9
CpG: 148,chr2,25180626,25181970,1344,148,898,22,66.8,0.99
CpG: 48,chr2,25185724,25186230,506,48,341,19,67.4,0.85
CpG: 43,chr2,25195267,25195834,567,43,349,15.2,61.6,0.8
CpG: 60,chr2,25210892,25211590,698,60,450,17.2,64.5,0.84
CpG: 101,chr2,25223966,25225245,1279,101,796,15.8,62.2,0.82
CpG: 20,chr2,25240768,25241033,265,20,169,15.1,63.8,0.75
CpG: 47,chr2,25242073,25242509,436,47,274,21.6,62.8,1.09
CpG: 65,chr2,25255154,25255878,724,65,478,18,66,0.82
CpG: 105,chr2,25262563,25263446,883,105,600,23.8,68,1.03
CpG: 50,chr2,25271939,25272495,556,50,341,18,61.3,0.96
CpG: 50,chr2,25290231,25290874,643,50,396,15.6,61.6,0.82
CpG: 30,chr2,25292155,25292479,324,30,204,18.5,63,0.94
CpG: 30,chr2,25305080,25305422,342,30,217,17.5,63.5,0.87
CpG: 25,chr2,25311238,25311568,330,25,185,15.2,56.1,0.97
CpG: 78,chr2,25318726,25319366,640,78,421,24.4,65.8,1.13
CpG: 82,chr2,25332185,25333096,911,82,549,18,60.3,1
CpG: 48,chr2,25365201,25365683,482,48,331,19.9,68.7,0.86
CpG: 86,chr2,25372155,25372991,836,86,557,20.6,66.6,0.93
CpG: 52,chr2,25395842,25396452,610,52,412,17,67.5,0.75
CpG: 50,chr2,25403027,25403471,444,50,323,22.5,72.7,0.87
CpG: 25,chr2,25425477,25425795,318,25,192,15.7,60.4,0.86
CpG: 66,chr2,25428494,25429077,583,66,364,22.6,62.4,1.16
CpG: 45,chr2,25460653,25461177,524,45,333,17.2,63.5,0.86
CpG: 28,chr2,25500668,25500911,243,28,168,23,69.1,1.02
CpG: 68,chr2,25546562,25547123,561,68,389,24.2,69.3,1.03
CpG: 59,chr2,25557657,25558140,483,59,332,24.4,68.7,1.04
CpG: 23,chr2,25574632,25574942,310,23,191,14.8,61.6,0.83
CpG: 265,chr2,25577021,25579908,2887,265,1897,18.4,65.7,0.86
CpG: 73,chr2,25607755,25608608,853,73,537,17.1,63,0.88
CpG: 40,chr2,25616103,25616625,522,40,333,15.3,63.8,0.76
CpG: 76,chr2,25706654,25707411,757,76,495,20.1,65.4,0.94
CpG: 67,chr2,25863731,25864418,687,67,473,19.5,68.9,0.82
CpG: 35,chr2,25877801,25878096,295,35,198,23.7,67.1,1.07
CpG: 136,chr2,25982204,25983940,1736,136,1023,15.7,58.9,0.97
CpG: 55,chr2,26021429,26021914,485,55,321,22.7,66.2,1.04
CpG: 20,chr2,26060179,26060436,257,20,152,15.6,59.1,0.89
CpG: 40,chr2,26091508,26092032,524,40,366,15.3,69.8,0.64
CpG: 86,chr2,26122249,26123011,762,86,495,22.6,65,1.07
CpG: 30,chr2,26138465,26138848,383,30,244,15.7,63.7,0.8
CpG: 131,chr2,26139654,26140801,1147,131,790,22.8,68.9,0.96
CpG: 106,chr2,26202071,26203265,1194,106,778,17.8,65.2,0.83
CpG: 47,chr2,26206330,26206900,570,47,356,16.5,62.5,0.85
CpG: 70,chr2,26236988,26237581,593,70,392,23.6,66.1,1.11
CpG: 51,chr2,26315401,26315896,495,51,327,20.6,66.1,0.94
CpG: 79,chr2,26351759,26352628,869,79,522,18.2,60.1,1.03
CpG: 32,chr2,26380324,26380720,396,32,263,16.2,66.4,0.74
CpG: 79,chr2,26388838,26389488,650,79,432,24.3,66.5,1.11
CpG: 49,chr2,26408841,26409328,487,49,342,20.1,70.2,0.83
CpG: 93,chr2,26444882,26445971,1089,93,703,17.1,64.6,0.86
CpG: 19,chr2,26465448,26465654,206,19,149,18.4,72.3,0.71
CpG: 126,chr2,26502389,26503993,1604,126,1028,15.7,64.1,0.77
CpG: 33,chr2,26586688,26587024,336,33,237,19.6,70.5,0.79
CpG: 56,chr2,26603770,26604203,433,56,307,25.9,70.9,1.03
CpG: 70,chr2,26628187,26628785,598,70,437,23.4,73.1,0.88
CpG: 34,chr2,26640020,26640358,338,34,203,20.1,60.1,1.13
CpG: 19,chr2,26661529,26661766,237,19,166,16,70,0.79
CpG: 28,chr2,26902574,26902927,353,28,224,15.9,63.5,0.79
CpG: 83,chr2,26910417,26911230,813,83,537,20.4,66.1,0.95
CpG: 46,chr2,26916249,26916882,633,46,385,14.5,60.8,0.79
CpG: 80,chr2,26932955,26933855,900,80,601,17.8,66.8,0.81
CpG: 34,chr2,26964039,26964443,404,34,249,16.8,61.6,0.9
CpG: 34,chr2,27009858,27010276,418,34,259,16.3,62,0.85
CpG: 31,chr2,27027817,27028189,372,31,242,16.7,65.1,0.79
CpG: 19,chr2,27112621,27112870,249,19,163,15.3,65.5,0.73
CpG: 46,chr2,27142067,27142596,529,46,340,17.4,64.3,0.84
CpG: 159,chr2,27425709,27427352,1643,159,1058,19.4,64.4,0.94
CpG: 26,chr2,27442419,27442649,230,26,159,22.6,69.1,0.95
CpG: 139,chr2,27474963,27476217,1254,139,816,22.2,65.1,1.05
CpG: 70,chr2,27515043,27515616,573,70,378,24.4,66,1.15
CpG: 33,chr2,27540220,27540520,300,33,185,22,61.7,1.17
CpG: 121,chr2,27676439,27677929,1490,121,824,16.2,55.3,1.06
CpG: 110,chr2,27886163,27887152,989,110,710,22.2,71.8,0.86
CpG: 54,chr2,28192939,28193410,471,54,309,22.9,65.6,1.08
CpG: 71,chr2,28205444,28206309,865,71,475,16.4,54.9,1.09
CpG: 30,chr2,28393740,28394189,449,30,292,13.4,65,0.69
CpG: 107,chr2,28446517,28447398,881,107,596,24.3,67.7,1.06
CpG: 48,chr2,28467964,28468400,436,48,312,22,71.6,0.88
CpG: 93,chr2,28512962,28513783,821,93,546,22.7,66.5,1.04
CpG: 27,chr2,28533436,28533726,290,27,166,18.6,57.2,1.14
CpG: 55,chr2,28582730,28583331,601,55,361,18.3,60.1,1.03
CpG: 84,chr2,28640880,28641803,923,84,626,18.2,67.8,0.79
CpG: 18,chr2,28699544,28699779,235,18,158,15.3,67.2,0.68
CpG: 22,chr2,28700079,28700321,242,22,148,18.2,61.2,0.97
CpG: 111,chr2,28839843,28841000,1157,111,778,19.2,67.2,0.85
CpG: 24,chr2,28908496,28908719,223,24,163,21.5,73.1,0.82
CpG: 25,chr2,28909689,28910009,320,25,194,15.6,60.6,0.85
CpG: 25,chr2,28911306,28911551,245,25,157,20.4,64.1,0.99
CpG: 21,chr2,28911901,28912165,264,21,147,15.9,55.7,1.03
CpG: 44,chr2,28915878,28916334,456,44,303,19.3,66.4,0.87
CpG: 59,chr2,28917678,28918145,467,59,343,25.3,73.4,0.94
CpG: 46,chr2,29054733,29055171,438,46,295,21,67.4,0.93
CpG: 55,chr2,29060143,29060755,612,55,378,18,61.8,0.97
CpG: 103,chr2,29124685,29125657,972,103,661,21.2,68,0.93
CpG: 47,chr2,29194638,29195063,425,47,312,22.1,73.4,0.84
CpG: 20,chr2,29227631,29227910,279,20,174,14.3,62.4,0.74
CpG: 20,chr2,29250311,29250526,215,20,156,18.6,72.6,0.71
CpG: 143,chr2,29251508,29253279,1771,143,1109,16.1,62.6,0.83
CpG: 34,chr2,29346776,29347180,404,34,245,16.8,60.6,0.92
CpG: 44,chr2,29619879,29620185,306,44,216,28.8,70.6,1.15
CpG: 46,chr2,29747249,29747646,397,46,295,23.2,74.3,0.84
CpG: 34,chr2,29751441,29751901,460,34,298,14.8,64.8,0.71
CpG: 17,chr2,29787424,29787670,246,17,141,13.8,57.3,0.84
CpG: 36,chr2,29788230,29788607,377,36,248,19.1,65.8,0.9
CpG: 61,chr2,29802585,29803122,537,61,395,22.7,73.6,0.86
CpG: 45,chr2,29827236,29827783,547,45,326,16.5,59.6,0.94
CpG: 90,chr2,29845329,29846472,1143,90,738,15.7,64.6,0.76
CpG: 33,chr2,29869112,29869551,439,33,296,15,67.4,0.66
CpG: 128,chr2,29889281,29890726,1445,128,991,17.7,68.6,0.75
CpG: 48,chr2,29935285,29935687,402,48,275,23.9,68.4,1.04
CpG: 117,chr2,29965291,29966178,887,117,636,26.4,71.7,1.03
CpG: 63,chr2,30048618,30049253,635,63,411,19.8,64.7,0.95
CpG: 32,chr2,30061863,30062273,410,32,271,15.6,66.1,0.72
CpG: 19,chr2,30062876,30063155,279,19,155,13.6,55.6,0.9
CpG: 135,chr2,30066086,30067546,1460,135,818,18.5,56,1.18
CpG: 39,chr2,30077571,30077975,404,39,272,19.3,67.3,0.85
CpG: 47,chr2,30093434,30093955,521,47,360,18,69.1,0.76
CpG: 40,chr2,30124246,30124657,411,40,267,19.5,65,0.93
CpG: 36,chr2,30133660,30134040,380,36,260,18.9,68.4,0.81
CpG: 90,chr2,30171413,30172135,722,90,503,24.9,69.7,1.03
CpG: 38,chr2,30178228,30178634,406,38,269,18.7,66.3,0.85
CpG: 28,chr2,30205846,30206123,277,28,181,20.2,65.3,0.95
CpG: 113,chr2,30237159,30238213,1054,113,708,21.4,67.2,0.95
CpG: 43,chr2,30256207,30256874,667,43,398,12.9,59.7,0.73
CpG: 88,chr2,30285788,30286877,1089,88,733,16.2,67.3,0.72
CpG: 35,chr2,30359108,30359468,360,35,212,19.4,58.9,1.18
CpG: 41,chr2,30364093,30364558,465,41,302,17.6,64.9,0.85
CpG: 74,chr2,30392087,30392887,800,74,522,18.5,65.2,0.87
CpG: 118,chr2,30415221,30416614,1393,118,894,16.9,64.2,0.83
CpG: 21,chr2,30470209,30470412,203,21,135,20.7,66.5,0.94
CpG: 223,chr2,30472352,30474704,2352,223,1465,19,62.3,0.98
CpG: 30,chr2,30545206,30545480,274,30,193,21.9,70.4,0.88
CpG: 69,chr2,30658227,30658910,683,69,443,20.2,64.9,0.97
CpG: 30,chr2,30677042,30677376,334,30,211,18,63.2,0.92
CpG: 20,chr2,30693492,30693695,203,20,138,19.7,68,0.86
CpG: 43,chr2,30707680,30708028,348,43,251,24.7,72.1,0.96
CpG: 74,chr2,30711731,30712357,626,74,453,23.6,72.4,0.9
CpG: 40,chr2,30771440,30771838,398,40,228,20.1,57.3,1.23
CpG: 22,chr2,30784691,30784906,215,22,159,20.5,74,0.75
CpG: 35,chr2,30794616,30794976,360,35,233,19.4,64.7,0.95
CpG: 68,chr2,30801096,30801723,627,68,446,21.7,71.1,0.86
CpG: 63,chr2,30807458,30808307,849,63,554,14.8,65.3,0.76
CpG: 17,chr2,30824153,30824405,252,17,158,13.5,62.7,0.71
CpG: 63,chr2,30827752,30828472,720,63,479,17.5,66.5,0.8
CpG: 67,chr2,30845208,30845739,531,67,380,25.2,71.6,1.01
CpG: 27,chr2,30864949,30865187,238,27,154,22.7,64.7,1.1
CpG: 55,chr2,30952920,30953415,495,55,341,22.2,68.9,0.94
CpG: 55,chr2,30967423,30967987,564,55,399,19.5,70.7,0.78
CpG: 89,chr2,30981656,30982648,992,89,665,17.9,67,0.81
CpG: 132,chr2,31140950,31142428,1478,132,928,17.9,62.8,0.94
CpG: 42,chr2,31152154,31152657,503,42,336,16.7,66.8,0.75
CpG: 99,chr2,31245557,31246513,956,99,626,20.7,65.5,0.97
CpG: 63,chr2,31314081,31314727,646,63,447,19.5,69.2,0.82
CpG: 44,chr2,31460010,31460389,379,44,267,23.2,70.4,0.98
CpG: 31,chr2,31469997,31470326,329,31,243,18.8,73.9,0.69
CpG: 46,chr2,31572755,31573120,365,46,275,25.2,75.3,0.91
CpG: 137,chr2,31635316,31637231,1915,137,1197,14.3,62.5,0.74
CpG: 17,chr2,31637900,31638106,206,17,133,16.5,64.6,0.83
CpG: 25,chr2,31640032,31640352,320,25,208,15.6,65,0.74
CpG: 23,chr2,31641158,31641439,281,23,171,16.4,60.9,0.9
CpG: 102,chr2,31653963,31654749,786,102,552,26,70.2,1.09
CpG: 25,chr2,31670686,31671043,357,25,218,14,61.1,0.75
CpG: 75,chr2,31688183,31689099,916,75,590,16.4,64.4,0.79
CpG: 26,chr2,31759787,31760031,244,26,189,21.3,77.5,0.76
CpG: 18,chr2,31816441,31816650,209,18,127,17.2,60.8,0.93
CpG: 117,chr2,31845689,31846926,1237,117,802,18.9,64.8,0.9
CpG: 49,chr2,31887172,31887632,460,49,317,21.3,68.9,0.91
CpG: 58,chr2,31950109,31950600,491,58,346,23.6,70.5,0.96
CpG: 57,chr2,31974180,31974744,564,57,368,20.2,65.2,0.95
CpG: 141,chr2,32083269,32084744,1475,141,959,19.1,65,0.91
CpG: 33,chr2,32088556,32088954,398,33,258,16.6,64.8,0.79
CpG: 32,chr2,32137868,32138215,347,32,212,18.4,61.1,1.01
CpG: 91,chr2,32150860,32151644,784,91,503,23.2,64.2,1.13
CpG: 30,chr2,32213733,32214145,412,30,271,14.6,65.8,0.68
CpG: 52,chr2,32236329,32236858,529,52,322,19.7,60.9,1.06
CpG: 44,chr2,32259829,32260142,313,44,224,28.1,71.6,1.1
CpG: 28,chr2,32271819,32272121,302,28,190,18.5,62.9,0.94
CpG: 78,chr2,32287549,32288490,941,78,606,16.6,64.4,0.81
CpG: 89,chr2,32311924,32312849,925,89,674,19.2,72.9,0.73
CpG: 80,chr2,32352843,32353458,615,80,435,26,70.7,1.04
CpG: 26,chr2,32361401,32361747,346,26,205,15,59.2,0.89
CpG: 69,chr2,32362687,32363391,704,69,477,19.6,67.8,0.87
CpG: 66,chr2,32381502,32382189,687,66,467,19.2,68,0.86
CpG: 97,chr2,32395474,32396707,1233,97,783,15.7,63.5,0.78
CpG: 95,chr2,32450913,32451589,676,95,491,28.1,72.6,1.07
CpG: 110,chr2,32535032,32535933,901,110,642,24.4,71.3,0.97
CpG: 38,chr2,32575308,32575864,556,38,344,13.7,61.9,0.71
CpG: 17,chr2,32583289,32583515,226,17,132,15,58.4,0.88
CpG: 37,chr2,32586939,32587317,378,37,272,19.6,72,0.79
CpG: 17,chr2,32594072,32594295,223,17,140,15.2,62.8,0.77
CpG: 43,chr2,32606859,32607308,449,43,305,19.2,67.9,0.84
CpG: 26,chr2,32612300,32612626,326,26,208,16,63.8,0.83
CpG: 22,chr2,32614882,32615176,294,22,180,15,61.2,0.81
CpG: 48,chr2,32693777,32694334,557,48,345,17.2,61.9,0.91
CpG: 16,chr2,32708011,32708226,215,16,130,14.9,60.5,0.82
CpG: 98,chr2,32712175,32713258,1083,98,686,18.1,63.3,0.91
CpG: 43,chr2,32741428,32741833,405,43,296,21.2,73.1,0.8
CpG: 43,chr2,32757063,32757506,443,43,305,19.4,68.8,0.84
CpG: 39,chr2,32775532,32775950,418,39,273,18.7,65.3,0.89
CpG: 26,chr2,32846166,32846524,358,26,245,14.5,68.4,0.62
CpG: 58,chr2,32846990,32847421,431,58,276,26.9,64,1.32
CpG: 26,chr2,32876322,32876567,245,26,167,21.2,68.2,0.92
CpG: 59,chr2,32961589,32962157,568,59,376,20.8,66.2,0.95
CpG: 33,chr2,32966748,32967115,367,33,236,18,64.3,0.88
CpG: 66,chr2,32981360,32982066,706,66,499,18.7,70.7,0.76
CpG: 42,chr2,33130203,33130597,394,42,289,21.3,73.4,0.83
CpG: 47,chr2,33371269,33371728,459,47,320,20.5,69.7,0.85
CpG: 86,chr2,33430772,33431621,849,86,574,20.3,67.6,0.9
CpG: 80,chr2,33468108,33468722,614,80,421,26.1,68.6,1.11
CpG: 63,chr2,33543963,33544610,647,63,457,19.5,70.6,0.79
CpG: 25,chr2,33580693,33580989,296,25,169,16.9,57.1,1.06
CpG: 24,chr2,33616698,33616985,287,24,176,16.7,61.3,0.9
CpG: 37,chr2,33631453,33631906,453,37,288,16.3,63.6,0.81
CpG: 172,chr2,33639199,33641314,2115,172,1299,16.3,61.4,0.87
CpG: 43,chr2,33642180,33642690,510,43,346,16.9,67.8,0.74
CpG: 69,chr2,33886987,33887689,702,69,424,19.7,60.4,1.1
CpG: 22,chr2,33966460,33966734,274,22,172,16.1,62.8,0.82
CpG: 114,chr2,34371054,34372230,1176,114,715,19.4,60.8,1.06
CpG: 51,chr2,34372602,34373324,722,51,445,14.1,61.6,0.74
CpG: 55,chr2,34406703,34407209,506,55,367,21.7,72.5,0.83
CpG: 73,chr2,34753853,34754548,695,73,393,21,56.5,1.33
CpG: 99,chr2,34771543,34772738,1195,99,755,16.6,63.2,0.85
CpG: 20,chr2,34799754,34799960,206,20,136,19.4,66,0.91
CpG: 64,chr2,34802234,34802846,612,64,400,20.9,65.4,0.99
CpG: 52,chr2,34825891,34826292,401,52,290,25.9,72.3,0.99
CpG: 54,chr2,34870778,34871358,580,54,370,18.6,63.8,0.92
CpG: 20,chr2,34913253,34913496,243,20,149,16.5,61.3,0.88
CpG: 29,chr2,34913763,34914039,276,29,192,21,69.6,0.87
CpG: 43,chr2,35109335,35109733,398,43,275,21.6,69.1,0.91
CpG: 110,chr2,35200229,35201367,1138,110,740,19.3,65,0.92
CpG: 39,chr2,35256331,35256765,434,39,293,18,67.5,0.79
CpG: 30,chr2,35282321,35282631,310,30,222,19.4,71.6,0.76
CpG: 35,chr2,35336610,35337111,501,35,317,14,63.3,0.7
CpG: 35,chr2,35462241,35462624,383,35,251,18.3,65.5,0.85
CpG: 22,chr2,35491356,35491586,230,22,151,19.1,65.7,0.89
CpG: 131,chr2,35581518,35583044,1526,131,1045,17.2,68.5,0.74
CpG: 54,chr2,35621842,35622339,497,54,373,21.7,75.1,0.77
CpG: 85,chr2,35661161,35662167,1006,85,611,16.9,60.7,0.92
CpG: 81,chr2,35979112,35979865,753,81,470,21.5,62.4,1.11
CpG: 33,chr2,36011376,36011744,368,33,201,17.9,54.6,1.21
CpG: 22,chr2,36049236,36049437,201,22,136,21.9,67.7,0.96
CpG: 69,chr2,36090914,36091737,823,69,536,16.8,65.1,0.79
CpG: 26,chr2,36094200,36094509,309,26,177,16.8,57.3,1.03
CpG: 43,chr2,36103401,36104063,662,43,410,13,61.9,0.69
CpG: 65,chr2,36104563,36105275,712,65,459,18.3,64.5,0.89
CpG: 40,chr2,36136285,36136693,408,40,262,19.6,64.2,0.96
CpG: 18,chr2,36203098,36203317,219,18,128,16.4,58.4,0.97
CpG: 29,chr2,36210836,36211072,236,29,175,24.6,74.2,0.89
CpG: 22,chr2,36230568,36230872,304,22,199,14.5,65.5,0.69
CpG: 28,chr2,37359044,37359355,311,28,186,18,59.8,1.02
CpG: 60,chr2,37422567,37423128,561,60,362,21.4,64.5,1.03
CpG: 34,chr2,37430661,37431139,478,34,278,14.2,58.2,0.84
CpG: 41,chr2,37442973,37443493,520,41,346,15.8,66.5,0.71
CpG: 51,chr2,37452056,37452530,474,51,353,21.5,74.5,0.79
CpG: 108,chr2,37702647,37703884,1237,108,677,17.5,54.7,1.2
CpG: 58,chr2,37786439,37786891,452,58,324,25.7,71.7,1
CpG: 95,chr2,37793105,37793872,767,95,553,24.8,72.1,0.96
CpG: 77,chr2,38286852,38287493,641,77,487,24,76,0.88
CpG: 46,chr2,38339362,38339891,529,46,375,17.4,70.9,0.7
CpG: 34,chr2,38348031,38348469,438,34,253,15.5,57.8,0.93
CpG: 99,chr2,38350967,38351995,1028,99,620,19.3,60.3,1.06
CpG: 35,chr2,38354449,38354890,441,35,271,15.9,61.5,0.84
CpG: 39,chr2,38356682,38357170,488,39,320,16,65.6,0.77
CpG: 57,chr2,38511698,38512118,420,57,300,27.1,71.4,1.09
CpG: 41,chr2,38643669,38644013,344,41,227,23.8,66,1.11
CpG: 25,chr2,38672086,38672393,307,25,200,16.3,65.1,0.77
CpG: 20,chr2,38688939,38689208,269,20,179,14.9,66.5,0.71
CpG: 195,chr2,38710278,38712535,2257,195,1379,17.3,61.1,0.92
CpG: 84,chr2,38925257,38926340,1083,84,709,15.5,65.5,0.74
CpG: 58,chr2,39004748,39005254,506,58,348,22.9,68.8,0.98
CpG: 66,chr2,39007853,39008381,528,66,361,25,68.4,1.07
CpG: 48,chr2,39065382,39065785,403,48,281,23.8,69.7,0.98
CpG: 76,chr2,39225719,39226492,773,76,473,19.7,61.2,1.06
CpG: 26,chr2,42652852,42653141,289,26,181,18,62.6,0.92
CpG: 27,chr2,44556887,44557126,239,27,167,22.6,69.9,0.93
CpG: 113,chr2,44926563,44927796,1233,113,750,18.3,60.8,1.01
CpG: 109,chr2,45109314,45110333,1019,109,746,21.4,73.2,0.81
CpG: 35,chr2,45117040,45117288,248,35,199,28.2,80.2,0.94
CpG: 130,chr2,48813696,48814940,1244,130,729,20.9,58.6,1.22
CpG: 34,chr2,48948963,48949341,378,34,259,18,68.5,0.84
CpG: 179,chr2,49451012,49452743,1731,179,1065,20.7,61.5,1.11
CpG: 80,chr2,49619201,49620027,826,80,574,19.4,69.5,0.81
CpG: 76,chr2,49787440,49788079,639,76,464,23.8,72.6,0.91
CpG: 72,chr2,50066300,50067004,704,72,478,20.5,67.9,0.89
CpG: 37,chr2,50296405,50296785,380,37,256,19.5,67.4,0.86
CpG: 47,chr2,51147551,51148215,664,47,446,14.2,67.2,0.63
CpG: 20,chr2,51149071,51149277,206,20,126,19.4,61.2,1.08
CpG: 37,chr2,51934710,51935070,360,37,238,20.6,66.1,0.94
CpG: 31,chr2,51972744,51972995,251,31,176,24.7,70.1,1
CpG: 106,chr2,52072738,52073660,922,106,623,23,67.6,1.03
CpG: 21,chr2,52424258,52424483,225,21,148,18.7,65.8,0.86
CpG: 102,chr2,52675642,52676610,968,102,667,21.1,68.9,0.89
CpG: 79,chr2,52741892,52742737,845,79,552,18.7,65.3,0.88
CpG: 119,chr2,52857631,52858880,1249,119,777,19.1,62.2,1
CpG: 157,chr2,53190977,53192516,1539,157,1040,20.4,67.6,0.9
CpG: 70,chr2,54084866,54085694,828,70,540,16.9,65.2,0.8
CpG: 88,chr2,54436017,54436959,942,88,639,18.7,67.8,0.83
CpG: 21,chr2,55437145,55437407,262,21,158,16,60.3,0.88
CpG: 37,chr2,57102335,57102849,514,37,300,14.4,58.4,0.85
CpG: 41,chr2,57111606,57112089,483,41,310,17,64.2,0.85
CpG: 86,chr2,57114259,57115087,828,86,544,20.8,65.7,0.98
CpG: 35,chr2,57116354,57116857,503,35,310,13.9,61.6,0.74
CpG: 85,chr2,57123388,57124335,947,85,569,18,60.1,0.99
CpG: 83,chr2,57237684,57238584,900,83,625,18.4,69.4,0.77
CpG: 55,chr2,58357611,58358052,441,55,342,24.9,77.6,0.83
CpG: 160,chr2,59160665,59162066,1401,160,965,22.8,68.9,0.96
CpG: 101,chr2,59611853,59612747,894,101,659,22.6,73.7,0.85
CpG: 44,chr2,59882216,59882700,484,44,317,18.2,65.5,0.86
CpG: 42,chr2,60109806,60110191,385,42,279,21.8,72.5,0.85
CpG: 106,chr2,60209423,60210426,1003,106,610,21.1,60.8,1.15
CpG: 20,chr2,60275382,60275597,215,20,134,18.6,62.3,0.96
CpG: 35,chr2,60283976,60284269,293,35,212,23.9,72.4,0.94
CpG: 33,chr2,60383073,60383381,308,33,219,21.4,71.1,0.87
CpG: 104,chr2,60880959,60881768,809,104,563,25.7,69.6,1.07
CpG: 103,chr2,60962128,60963309,1181,103,764,17.4,64.7,0.83
CpG: 61,chr2,61593004,61593592,588,61,400,20.7,68,0.91
CpG: 76,chr2,61656428,61657146,718,76,477,21.2,66.4,0.97
CpG: 40,chr2,61711562,61711963,401,40,262,20,65.3,0.93
CpG: 60,chr2,61805053,61805900,847,60,523,14.2,61.7,0.75
CpG: 124,chr2,61811543,61812559,1016,124,679,24.4,66.8,1.11
CpG: 95,chr2,61815378,61816206,828,95,573,22.9,69.2,0.96
CpG: 26,chr2,62411766,62412024,258,26,164,20.2,63.6,1
CpG: 39,chr2,62664275,62664618,343,39,237,22.7,69.1,0.95
CpG: 23,chr2,63184084,63184301,217,23,142,21.2,65.4,1.01
CpG: 41,chr2,64098277,64098636,359,41,231,22.8,64.3,1.11
CpG: 60,chr2,65022421,65023052,631,60,417,19,66.1,0.88
CpG: 137,chr2,65238066,65239233,1167,137,813,23.5,69.7,0.97
CpG: 107,chr2,66123987,66125117,1130,107,760,18.9,67.3,0.84
CpG: 43,chr2,66256359,66256843,484,43,337,17.8,69.6,0.73
CpG: 21,chr2,66634723,66634982,259,21,177,16.2,68.3,0.69
CpG: 64,chr2,67565649,67566279,630,64,400,20.3,63.5,1.04
CpG: 149,chr2,68470867,68472497,1630,149,991,18.3,60.8,0.99
CpG: 98,chr2,68861288,68862296,1008,98,690,19.4,68.5,0.83
CpG: 103,chr2,69585320,69586490,1170,103,749,17.6,64,0.86
CpG: 35,chr2,69647125,69647462,337,35,221,20.8,65.6,0.97
CpG: 87,chr2,69722625,69723523,898,87,562,19.4,62.6,1
CpG: 45,chr2,69789427,69789895,468,45,300,19.2,64.1,0.94
CpG: 90,chr2,69822564,69823322,758,90,491,23.7,64.8,1.14
CpG: 63,chr2,69861478,69862152,674,63,428,18.7,63.5,0.95
CpG: 31,chr2,69885498,69885777,279,31,186,22.2,66.7,1.01
CpG: 84,chr2,69897119,69897896,777,84,514,21.6,66.2,1
CpG: 43,chr2,70471872,70472373,501,43,321,17.2,64.1,0.88
CpG: 179,chr2,70475115,70477188,2073,179,1304,17.3,62.9,0.87
CpG: 32,chr2,70509185,70509488,303,32,172,21.1,56.8,1.34
CpG: 142,chr2,70562044,70564007,1963,142,1199,14.5,61.1,0.79
CpG: 91,chr2,70661346,70662024,678,91,486,26.8,71.7,1.05
CpG: 73,chr2,70824739,70825639,900,73,487,16.2,54.1,1.11
CpG: 61,chr2,71055552,71056279,727,61,476,16.8,65.5,0.79
CpG: 46,chr2,71117866,71118373,507,46,351,18.1,69.2,0.76
CpG: 52,chr2,71211781,71212304,523,52,344,19.9,65.8,0.92
CpG: 17,chr2,71264608,71264814,206,17,122,16.5,59.2,0.95
CpG: 27,chr2,71367518,71367773,255,27,147,21.2,57.6,1.28
CpG: 58,chr2,71389036,71389586,550,58,377,21.1,68.5,0.9
CpG: 46,chr2,71453141,71453517,376,46,257,24.5,68.4,1.05
CpG: 82,chr2,71528908,71529726,818,82,539,20,65.9,0.93
CpG: 51,chr2,71541001,71541590,589,51,404,17.3,68.6,0.74
CpG: 33,chr2,71543089,71543374,285,33,197,23.2,69.1,0.99
CpG: 197,chr2,71544134,71546923,2789,197,1682,14.1,60.3,0.79
CpG: 39,chr2,71581086,71581421,335,39,241,23.3,71.9,0.9
CpG: 99,chr2,71786757,71787855,1098,99,656,18,59.7,1.01
CpG: 94,chr2,71872917,71873825,908,94,614,20.7,67.6,0.91
CpG: 21,chr2,71981291,71981507,216,21,150,19.4,69.4,0.81
CpG: 67,chr2,72285614,72286304,690,67,426,19.4,61.7,1.02
CpG: 99,chr2,72476059,72477161,1102,99,688,18,62.4,0.92
CpG: 23,chr2,72633853,72634092,239,23,159,19.2,66.5,0.87
CpG: 172,chr2,72978942,72980956,2014,172,1071,17.1,53.2,1.21
CpG: 63,chr2,73214073,73214632,559,63,400,22.5,71.6,0.88
CpG: 37,chr2,73271755,73272054,299,37,217,24.7,72.6,0.94
CpG: 199,chr2,73272853,73274915,2062,199,1229,19.3,59.6,1.09
CpG: 23,chr2,73277334,73277597,263,23,174,17.5,66.2,0.81
CpG: 18,chr2,73280984,73281239,255,18,145,14.1,56.9,0.87
CpG: 45,chr2,73312493,73312896,403,45,251,22.3,62.3,1.15
CpG: 46,chr2,73386327,73386908,581,46,400,15.8,68.8,0.72
CpG: 99,chr2,73528866,73529809,943,99,659,21,69.9,0.87
CpG: 105,chr2,73891894,73893090,1196,105,782,17.6,65.4,0.82
CpG: 72,chr2,73910623,73911368,745,72,502,19.3,67.4,0.86
CpG: 64,chr2,74578529,74579138,609,64,426,21,70,0.86
CpG: 84,chr2,74655439,74656362,923,84,523,18.2,56.7,1.14
CpG: 45,chr2,74657698,74658041,343,45,232,26.2,67.6,1.15
CpG: 33,chr2,74659014,74659333,319,33,208,20.7,65.2,0.99
CpG: 22,chr2,74659608,74659905,297,22,151,14.8,50.8,1.16
CpG: 107,chr2,74667775,74668850,1075,107,671,19.9,62.4,1.02
CpG: 27,chr2,74675196,74675530,334,27,217,16.2,65,0.79
CpG: 35,chr2,74679672,74680076,404,35,250,17.3,61.9,0.92
CpG: 109,chr2,74681964,74683076,1112,109,657,19.6,59.1,1.12
CpG: 26,chr2,74687643,74687963,320,26,207,16.2,64.7,0.78
CpG: 32,chr2,74691475,74691821,346,32,236,18.5,68.2,0.8
CpG: 22,chr2,74692525,74692821,296,22,187,14.9,63.2,0.75
CpG: 99,chr2,74697932,74698814,882,99,573,22.4,65,1.06
CpG: 117,chr2,74704727,74706004,1277,117,656,18.3,51.4,1.4
CpG: 54,chr2,74711842,74712395,553,54,382,19.5,69.1,0.84
CpG: 35,chr2,74727333,74727642,309,35,230,22.7,74.4,0.82
CpG: 30,chr2,74732705,74733037,332,30,207,18.1,62.3,0.93
CpG: 17,chr2,74740487,74740702,215,17,133,15.8,61.9,0.83
CpG: 84,chr2,74746371,74747291,920,84,611,18.3,66.4,0.84
CpG: 34,chr2,74749624,74750064,440,34,269,15.5,61.1,0.85
CpG: 55,chr2,74752888,74753402,514,55,344,21.4,66.9,0.96
CpG: 114,chr2,74762807,74763831,1024,114,741,22.3,72.4,0.85
CpG: 73,chr2,74825756,74826361,605,73,432,24.1,71.4,0.98
CpG: 55,chr2,75137423,75138154,731,55,481,15,65.8,0.7
CpG: 161,chr2,75658688,75660031,1343,161,927,24,69,1.03
CpG: 106,chr2,75703586,75704951,1365,106,912,15.5,66.8,0.7
CpG: 56,chr2,75832130,75832557,427,56,301,26.2,70.5,1.07
CpG: 23,chr2,75981547,75981815,268,23,162,17.2,60.4,0.94
CpG: 40,chr2,76369911,76370352,441,40,276,18.1,62.6,0.93
CpG: 141,chr2,76406109,76407537,1428,141,952,19.7,66.7,0.89
CpG: 69,chr2,76647565,76648459,894,69,621,15.4,69.5,0.67
CpG: 78,chr2,76675060,76675790,730,78,464,21.4,63.6,1.08
CpG: 73,chr2,77280119,77280914,795,73,433,18.4,54.5,1.24
CpG: 109,chr2,77816346,77817237,891,109,644,24.5,72.3,0.94
CpG: 39,chr2,77945834,77946218,384,39,253,20.3,65.9,0.97
CpG: 38,chr2,78512854,78513382,528,38,317,14.4,60,0.8
CpG: 140,chr2,78868540,78870016,1476,140,809,19,54.8,1.26
CpG: 36,chr2,79255402,79255897,495,36,320,14.5,64.6,0.7
CpG: 29,chr2,79428631,79428911,280,29,201,20.7,71.8,0.8
CpG: 37,chr2,79453918,79454486,568,37,331,13,58.3,0.85
CpG: 36,chr2,79456618,79457022,404,36,262,17.8,64.9,0.89
CpG: 116,chr2,79635067,79636265,1198,116,768,19.4,64.1,0.95
CpG: 61,chr2,80315407,80316056,649,61,430,18.8,66.3,0.87
CpG: 22,chr2,80446817,80447078,261,22,176,16.9,67.4,0.74
CpG: 32,chr2,80447351,80447771,420,32,274,15.2,65.2,0.74
CpG: 115,chr2,80580569,80581665,1096,115,636,21,58,1.25
CpG: 39,chr2,80638758,80639157,399,39,261,19.5,65.4,0.92
CpG: 87,chr2,82053062,82053782,720,87,511,24.2,71,0.96
CpG: 67,chr2,83644311,83644819,508,67,366,26.4,72,1.02
CpG: 80,chr2,83724235,83725044,809,80,523,19.8,64.6,0.97
CpG: 46,chr2,83812536,83812860,324,46,245,28.4,75.6,1.01
CpG: 26,chr2,83954869,83955135,266,26,169,19.5,63.5,1.06
CpG: 26,chr2,83960679,83960945,266,26,169,19.5,63.5,1.06
CpG: 26,chr2,83966489,83966755,266,26,169,19.5,63.5,1.06
CpG: 26,chr2,83972299,83972565,266,26,169,19.5,63.5,1.06
CpG: 26,chr2,83978109,83978375,266,26,169,19.5,63.5,1.06
CpG: 26,chr2,83983919,83984185,266,26,169,19.5,63.5,1.06
CpG: 26,chr2,83989729,83989995,266,26,169,19.5,63.5,1.06
CpG: 40,chr2,84658926,84659321,395,40,269,20.3,68.1,0.88
CpG: 50,chr2,84670189,84670791,602,50,378,16.6,62.8,0.85
CpG: 18,chr2,84678409,84678621,212,18,146,17,68.9,0.74
CpG: 94,chr2,84714579,84715525,946,94,568,19.9,60,1.11
CpG: 28,chr2,84727220,84727506,286,28,166,19.6,58,1.19
CpG: 22,chr2,84743416,84743679,263,22,165,16.7,62.7,0.97
CpG: 33,chr2,84839254,84839674,420,33,262,15.7,62.4,0.81
CpG: 59,chr2,84839970,84840712,742,59,490,15.9,66,0.73
CpG: 30,chr2,84866171,84866571,400,30,269,15,67.2,0.69
CpG: 90,chr2,84871906,84872648,742,90,510,24.3,68.7,1.03
CpG: 110,chr2,84886313,84887735,1422,110,877,15.5,61.7,0.82
CpG: 19,chr2,84888119,84888345,226,19,146,16.8,64.6,0.82
CpG: 21,chr2,84889031,84889266,235,21,158,17.9,67.2,0.91
CpG: 58,chr2,85037055,85037622,567,58,369,20.5,65.1,0.97
CpG: 49,chr2,85048092,85048627,535,49,361,18.3,67.5,0.81
CpG: 25,chr2,87526007,87526220,213,25,150,23.5,70.4,0.95
CpG: 139,chr2,90579592,90580877,1285,139,892,21.6,69.4,0.91
CpG: 61,chr2,90678998,90679513,515,61,336,23.7,65.2,1.12
CpG: 75,chr2,90745284,90746088,804,75,479,18.7,59.6,1.05
CpG: 19,chr2,90783011,90783265,254,19,166,15,65.4,0.71
CpG: 55,chr2,90847026,90847575,549,55,357,20,65,0.97
CpG: 44,chr2,90885644,90886082,438,44,316,20.1,72.1,0.78
CpG: 125,chr2,90889415,90890446,1031,125,656,24.2,63.6,1.2
CpG: 58,chr2,90904370,90905111,741,58,463,15.7,62.5,0.81
CpG: 69,chr2,90917417,90918027,610,69,421,22.6,69,0.95
CpG: 72,chr2,90940539,90941231,692,72,502,20.8,72.5,0.79
CpG: 40,chr2,91053926,91054314,388,40,253,20.6,65.2,0.97
CpG: 62,chr2,91070077,91070641,564,62,376,22,66.7,0.99
CpG: 37,chr2,91115203,91115607,404,37,284,18.3,70.3,0.75
CpG: 77,chr2,91182467,91183063,596,77,453,25.8,76,0.91
CpG: 17,chr2,91202693,91202906,213,17,125,16,58.7,1.02
CpG: 38,chr2,91236639,91237146,507,38,322,15,63.5,0.75
CpG: 23,chr2,91255732,91256014,282,23,193,16.3,68.4,0.7
CpG: 29,chr2,91256697,91257045,348,29,230,16.7,66.1,0.78
CpG: 62,chr2,91264997,91265590,593,62,380,20.9,64.1,1.03
CpG: 60,chr2,91457478,91458062,584,60,413,20.5,70.7,0.82
CpG: 58,chr2,91526671,91527220,549,58,369,21.1,67.2,0.96
CpG: 21,chr2,91629944,91630232,288,21,173,14.6,60.1,0.81
CpG: 35,chr2,91649927,91650421,494,35,294,14.2,59.5,0.85
CpG: 63,chr2,91710199,91711006,807,63,465,15.6,57.6,0.96
CpG: 35,chr2,91730091,91730424,333,35,221,21,66.4,0.95
CpG: 77,chr2,91921471,91922372,901,77,583,17.1,64.7,0.82
CpG: 18,chr2,91922628,91922830,202,18,135,17.8,66.8,0.86
CpG: 30,chr2,91923691,91924059,368,30,216,16.3,58.7,0.96
CpG: 82,chr2,91963178,91963808,630,82,440,26,69.8,1.09
CpG: 19,chr2,91965453,91965716,263,19,183,14.4,69.6,0.6
CpG: 74,chr2,91975472,91976221,749,74,524,19.8,70,0.81
CpG: 22,chr2,92008249,92008562,313,22,208,14.1,66.5,0.64
CpG: 54,chr2,92024060,92024631,571,54,406,18.9,71.1,0.76
CpG: 28,chr2,92055400,92055634,234,28,157,23.9,67.1,1.09
CpG: 24,chr2,92058466,92058734,268,24,167,17.9,62.3,0.92
CpG: 62,chr2,92059471,92060112,641,62,439,19.3,68.5,0.84
CpG: 38,chr2,92370592,92371064,472,38,318,16.1,67.4,0.71
CpG: 22,chr2,92375367,92375652,285,22,192,15.4,67.4,0.71
CpG: 53,chr2,92388981,92389543,562,53,395,18.9,70.3,0.76
CpG: 40,chr2,92400962,92401283,321,40,212,24.9,66,1.15
CpG: 63,chr2,92433817,92434385,568,63,368,22.2,64.8,1.06
CpG: 35,chr2,92459562,92459871,309,35,215,22.7,69.6,0.94
CpG: 49,chr2,92599913,92600500,587,49,358,16.7,61,0.9
CpG: 35,chr2,92914988,92915360,372,35,262,18.8,70.4,0.77
CpG: 69,chr2,93014696,93015265,569,69,407,24.3,71.5,0.95
CpG: 112,chr2,93045388,93046447,1059,112,662,21.2,62.5,1.09
CpG: 28,chr2,93180351,93180580,229,28,158,24.5,69,1.03
CpG: 120,chr2,93187374,93188704,1330,120,880,18,66.2,0.82
CpG: 91,chr2,93333602,93334506,904,91,624,20.1,69,0.85
CpG: 108,chr2,93642597,93643648,1051,108,683,20.6,65,0.97
CpG: 23,chr2,93646016,93646281,265,23,162,17.4,61.1,0.93
CpG: 30,chr2,93647064,93647409,345,30,202,17.4,58.6,1.05
CpG: 45,chr2,93822296,93822640,344,45,243,26.2,70.6,1.06
CpG: 127,chr2,93955934,93957253,1319,127,834,19.3,63.2,0.97
CpG: 26,chr2,93976510,93976757,247,26,172,21.1,69.6,0.87
CpG: 33,chr2,94010469,94010904,435,33,287,15.2,66,0.71
CpG: 61,chr2,94157596,94158274,678,61,405,18,59.7,1.01
CpG: 47,chr2,94241114,94241613,499,47,286,18.8,57.3,1.15
CpG: 68,chr2,94273219,94273872,653,68,472,20.8,72.3,0.81
CpG: 72,chr2,94406106,94406816,710,72,501,20.3,70.6,0.82
CpG: 111,chr2,94437452,94438255,803,111,554,27.6,69,1.18
CpG: 31,chr2,101678503,101678774,271,31,183,22.9,67.5,1
CpG: 93,chr2,101796406,101797658,1252,93,770,14.9,61.5,0.8
CpG: 18,chr2,102058557,102058767,210,18,127,17.1,60.5,1.07
CpG: 57,chr2,102185995,102186433,438,57,294,26,67.1,1.22
CpG: 86,chr2,102400437,102401261,824,86,514,20.9,62.4,1.08
CpG: 159,chr2,102450282,102451858,1576,159,1042,20.2,66.1,0.93
CpG: 70,chr2,102658650,102659347,697,70,450,20.1,64.6,0.96
CpG: 50,chr2,103073378,103073940,562,50,367,17.8,65.3,0.84
CpG: 30,chr2,103484762,103485109,347,30,230,17.3,66.3,0.79
CpG: 139,chr2,103566151,103567422,1271,139,857,21.9,67.4,0.96
CpG: 45,chr2,103760847,103761416,569,45,335,15.8,58.9,0.92
CpG: 114,chr2,103796541,103797768,1227,114,763,18.6,62.2,0.97
CpG: 23,chr2,103819412,103819619,207,23,136,22.2,65.7,1.06
CpG: 76,chr2,103970148,103970913,765,76,493,19.9,64.4,0.96
CpG: 60,chr2,104027697,104028455,758,60,500,15.8,66,0.73
CpG: 72,chr2,104122630,104123347,717,72,490,20.1,68.3,0.86
CpG: 112,chr2,104409871,104410866,995,112,677,22.5,68,0.97
CpG: 180,chr2,104493271,104494692,1421,180,1026,25.3,72.2,0.98
CpG: 26,chr2,104556642,104556908,266,26,179,19.5,67.3,0.88
CpG: 64,chr2,104590228,104591119,891,64,505,14.4,56.7,0.89
CpG: 98,chr2,104711648,104712465,817,98,581,24,71.1,0.95
CpG: 62,chr2,104742453,104742951,498,62,362,24.9,72.7,0.95
CpG: 91,chr2,104816114,104817238,1124,91,668,16.2,59.4,0.92
CpG: 62,chr2,104849274,104849927,653,62,438,19,67.1,0.85
CpG: 59,chr2,105016629,105017140,511,59,343,23.1,67.1,1.03
CpG: 117,chr2,105126291,105127506,1215,117,823,19.3,67.7,0.84
CpG: 28,chr2,105128045,105128457,412,28,211,13.6,51.2,1.04
CpG: 23,chr2,105130739,105131061,322,23,205,14.3,63.7,0.71
CpG: 24,chr2,105224327,105224568,241,24,149,19.9,61.8,1.05
CpG: 78,chr2,105398700,105399448,748,78,542,20.9,72.5,0.8
CpG: 17,chr2,105660037,105660246,209,17,133,16.3,63.6,0.82
CpG: 25,chr2,105668769,105669107,338,25,201,14.8,59.5,0.85
CpG: 28,chr2,105669480,105669780,300,28,174,18.7,58,1.12
CpG: 21,chr2,105672527,105672800,273,21,160,15.4,58.6,0.9
CpG: 18,chr2,105674671,105674893,222,18,147,16.2,66.2,0.77
CpG: 37,chr2,105675188,105675605,417,37,260,17.7,62.4,0.95
CpG: 71,chr2,105676053,105676670,617,71,429,23,69.5,0.95
CpG: 22,chr2,105681377,105681589,212,22,128,20.8,60.4,1.16
CpG: 17,chr2,105682175,105682387,212,17,116,16,54.7,1.07
CpG: 39,chr2,105904321,105904844,523,39,322,14.9,61.6,0.79
CpG: 27,chr2,106003104,106003389,285,27,180,18.9,63.2,0.95
CpG: 122,chr2,106693293,106694592,1299,122,853,18.8,65.7,0.87
CpG: 22,chr2,106695096,106695358,262,22,166,16.8,63.4,0.84
CpG: 24,chr2,106974187,106974428,241,24,166,19.9,68.9,0.89
CpG: 46,chr2,109280614,109281111,497,46,307,18.5,61.8,0.98
CpG: 18,chr2,109674032,109674244,212,18,142,17,67,0.76
CpG: 36,chr2,109677172,109677637,465,36,319,15.5,68.6,0.66
CpG: 60,chr2,109693466,109694207,741,60,487,16.2,65.7,0.76
CpG: 17,chr2,109723440,109723686,246,17,141,13.8,57.3,0.85
CpG: 76,chr2,109890585,109891268,683,76,467,22.3,68.4,0.95
CpG: 102,chr2,109917558,109918372,814,102,587,25.1,72.1,0.99
CpG: 37,chr2,110017740,110018038,298,37,204,24.8,68.5,1.06
CpG: 75,chr2,112239250,112239885,635,75,430,23.6,67.7,1.03
CpG: 68,chr2,112265478,112266086,608,68,394,22.4,64.8,1.07
CpG: 29,chr2,112367726,112368064,338,29,206,17.2,60.9,0.94
CpG: 49,chr2,112379093,112379539,446,49,321,22,72,0.86
CpG: 40,chr2,112454873,112455342,469,40,299,17.1,63.8,0.87
CpG: 53,chr2,112492914,112493511,597,53,318,17.8,53.3,1.28
CpG: 40,chr2,113216965,113217421,456,40,265,17.5,58.1,1.06
CpG: 33,chr2,113327376,113327814,438,33,272,15.1,62.1,0.78
CpG: 29,chr2,113757588,113757887,299,29,192,19.4,64.2,0.95
CpG: 41,chr2,113758478,113758827,349,41,243,23.5,69.6,0.98
CpG: 23,chr2,113848497,113848746,249,23,173,18.5,69.5,0.83
CpG: 58,chr2,114013363,114013823,460,58,321,25.2,69.8,1.05
CpG: 29,chr2,114175072,114175328,256,29,174,22.7,68,0.98
CpG: 33,chr2,114201165,114201500,335,33,219,19.7,65.4,0.92
CpG: 31,chr2,114654665,114654980,315,31,199,19.7,63.2,0.99
CpG: 29,chr2,115581352,115581741,389,29,232,14.9,59.6,0.84
CpG: 23,chr2,115854925,115855243,318,23,189,14.5,59.4,0.82
CpG: 21,chr2,115860418,115860660,242,21,134,17.4,55.4,1.18
CpG: 16,chr2,116062235,116062438,203,16,126,15.8,62.1,0.84
CpG: 55,chr2,116975568,116976108,540,55,381,20.4,70.6,0.82
CpG: 17,chr2,117120043,117120273,230,17,129,14.8,56.1,0.95
CpG: 170,chr2,117120513,117121957,1444,170,956,23.5,66.2,1.08
CpG: 46,chr2,117249674,117250186,512,46,338,18,66,0.83
CpG: 47,chr2,117342646,117343063,417,47,285,22.5,68.3,0.99
CpG: 18,chr2,118256769,118257007,238,18,147,15.1,61.8,0.8
CpG: 97,chr2,118372949,118374134,1185,97,815,16.4,68.8,0.69
CpG: 48,chr2,118388342,118388877,535,48,371,17.9,69.3,0.76
CpG: 26,chr2,118430867,118431204,337,26,219,15.4,65,0.73
CpG: 76,chr2,118479158,118479840,682,76,463,22.3,67.9,0.97
CpG: 34,chr2,118549448,118549699,251,34,185,27.1,73.7,1
CpG: 32,chr2,118598146,118598527,381,32,227,16.8,59.6,1.07
CpG: 19,chr2,118663248,118663468,220,19,140,17.3,63.6,0.87
CpG: 84,chr2,118676925,118677681,756,84,540,22.2,71.4,0.87
CpG: 173,chr2,118702419,118704307,1888,173,1288,18.3,68.2,0.79
CpG: 38,chr2,118711070,118711517,447,38,303,17,67.8,0.75
CpG: 123,chr2,118745610,118746808,1198,123,727,20.5,60.7,1.12
CpG: 31,chr2,118790566,118790955,389,31,235,15.9,60.4,0.87
CpG: 44,chr2,118814083,118814582,499,44,317,17.6,63.5,0.88
CpG: 30,chr2,118883308,118883656,348,30,223,17.2,64.1,0.84
CpG: 172,chr2,118901219,118902963,1744,172,1078,19.7,61.8,1.07
CpG: 26,chr2,118916046,118916378,332,26,217,15.7,65.4,0.73
CpG: 52,chr2,118926382,118927094,712,52,462,14.6,64.9,0.7
CpG: 24,chr2,118972707,118972963,256,24,172,18.8,67.2,0.83
CpG: 63,chr2,118976105,118976804,699,63,445,18,63.7,0.89
CpG: 53,chr2,119034782,119035433,651,53,419,16.3,64.4,0.8
CpG: 61,chr2,119047071,119047638,567,61,366,21.5,64.6,1.04
CpG: 52,chr2,119112699,119113180,481,52,309,21.6,64.2,1.08
CpG: 74,chr2,119156416,119157188,772,74,523,19.2,67.7,0.84
CpG: 60,chr2,119167445,119168086,641,60,421,18.7,65.7,0.87
CpG: 40,chr2,119208582,119209036,454,40,279,17.6,61.5,0.94
CpG: 123,chr2,119237017,119238232,1215,123,837,20.2,68.9,0.85
CpG: 33,chr2,119270941,119271233,292,33,209,22.6,71.6,0.88
CpG: 23,chr2,119288522,119288755,233,23,153,19.7,65.7,0.92
CpG: 24,chr2,119293742,119294047,305,24,182,15.7,59.7,0.89
CpG: 69,chr2,119322133,119322944,811,69,532,17,65.6,0.79
CpG: 109,chr2,119325901,119327393,1492,109,919,14.6,61.6,0.78
CpG: 49,chr2,119337792,119338215,423,49,309,23.2,73,0.87
CpG: 52,chr2,119350935,119351593,658,52,425,15.8,64.6,0.76
CpG: 107,chr2,119476896,119478266,1370,107,825,15.6,60.2,0.86
CpG: 20,chr2,119546916,119547155,239,20,158,16.7,66.1,0.77
CpG: 49,chr2,119547471,119547988,517,49,347,19,67.1,0.84
CpG: 54,chr2,119594231,119594717,486,54,332,22.2,68.3,0.96
CpG: 43,chr2,119618172,119618652,480,43,287,17.9,59.8,1.01
CpG: 21,chr2,119662621,119662879,258,21,163,16.3,63.2,0.9
CpG: 58,chr2,119674933,119675628,695,58,397,16.7,57.1,1.06
CpG: 114,chr2,119742275,119743425,1150,114,797,19.8,69.3,0.83
CpG: 44,chr2,119743825,119744442,617,44,375,14.3,60.8,0.78
CpG: 95,chr2,119758052,119758997,945,95,664,20.1,70.3,0.82
CpG: 24,chr2,119787486,119787689,203,24,137,23.6,67.5,1.05
CpG: 103,chr2,119872508,119873389,881,103,593,23.4,67.3,1.04
CpG: 62,chr2,119897055,119897698,643,62,409,19.3,63.6,0.96
CpG: 32,chr2,119972306,119972644,338,32,226,18.9,66.9,0.85
CpG: 26,chr2,120027420,120027622,202,26,142,25.7,70.3,1.08
CpG: 77,chr2,120154097,120154849,752,77,496,20.5,66,0.94
CpG: 36,chr2,120352722,120353179,457,36,302,15.8,66.1,0.74
CpG: 27,chr2,120403888,120404259,371,27,211,14.6,56.9,0.93
CpG: 33,chr2,120563473,120563870,397,33,234,16.6,58.9,0.99
CpG: 39,chr2,120567562,120568044,482,39,308,16.2,63.9,0.82
CpG: 33,chr2,120609236,120609581,345,33,225,19.1,65.2,0.9
CpG: 19,chr2,120629064,120629270,206,19,146,18.4,70.9,0.79
CpG: 102,chr2,120730818,120731678,860,102,637,23.7,74.1,0.87
CpG: 89,chr2,120849915,120850874,959,89,608,18.6,63.4,0.92
CpG: 34,chr2,120970521,120970792,271,34,187,25.1,69,1.06
CpG: 53,chr2,120977183,120977649,466,53,347,22.7,74.5,0.83
CpG: 25,chr2,121008340,121008641,301,25,188,16.6,62.5,0.87
CpG: 21,chr2,121044571,121044821,250,21,154,16.8,61.6,0.89
CpG: 102,chr2,121139733,121140708,975,102,641,20.9,65.7,0.97
CpG: 106,chr2,121170468,121171636,1168,106,756,18.2,64.7,0.87
CpG: 46,chr2,121271026,121271551,525,46,306,17.5,58.3,1.05
CpG: 19,chr2,121289113,121289394,281,19,167,13.5,59.4,0.77
CpG: 44,chr2,121289477,121289855,378,44,259,23.3,68.5,1
CpG: 17,chr2,121307042,121307283,241,17,156,14.1,64.7,0.68
CpG: 47,chr2,121355040,121355434,394,47,288,23.9,73.1,1.02
CpG: 101,chr2,121413518,121414456,938,101,645,21.5,68.8,0.91
CpG: 122,chr2,121449023,121450074,1051,122,739,23.2,70.3,0.94
CpG: 16,chr2,121469931,121470143,212,16,115,15.1,54.2,1.19
CpG: 16,chr2,121502484,121502696,212,16,115,15.1,54.2,1.19
CpG: 27,chr2,121506440,121506792,352,27,210,15.3,59.7,0.87
CpG: 99,chr2,121806320,121807266,946,99,655,20.9,69.2,0.88
CpG: 87,chr2,121866748,121867632,884,87,560,19.7,63.3,0.98
CpG: 86,chr2,121955799,121956772,973,86,615,17.7,63.2,0.9
CpG: 99,chr2,122028148,122029310,1162,99,683,17,58.8,0.99
CpG: 27,chr2,122118167,122118471,304,27,215,17.8,70.7,0.71
CpG: 27,chr2,122234509,122234877,368,27,221,14.7,60.1,0.88
CpG: 30,chr2,122298662,122299109,447,30,258,13.4,57.7,0.81
CpG: 22,chr2,122301684,122301888,204,22,135,21.6,66.2,1.07
CpG: 65,chr2,122348507,122349089,582,65,427,22.3,73.4,0.83
CpG: 39,chr2,122368627,122369001,374,39,262,20.9,70.1,0.88
CpG: 53,chr2,122467534,122468124,590,53,388,18,65.8,0.83
CpG: 41,chr2,122611032,122611442,410,41,277,20,67.6,0.89
CpG: 122,chr2,122630580,122631741,1161,122,836,21,72,0.81
CpG: 34,chr2,122637738,122638007,269,34,179,25.3,66.5,1.14
CpG: 101,chr2,122702203,122702926,723,101,525,27.9,72.6,1.06
CpG: 50,chr2,122738328,122738840,512,50,317,19.5,61.9,1.02
CpG: 38,chr2,122765088,122765522,434,38,296,17.5,68.2,0.75
CpG: 43,chr2,124089901,124090365,464,43,317,18.5,68.3,0.83
CpG: 17,chr2,124090511,124090722,211,17,143,16.1,67.8,0.71
CpG: 109,chr2,124609840,124610930,1090,109,743,20,68.2,0.87
CpG: 84,chr2,125123148,125123831,683,84,452,24.6,66.2,1.13
CpG: 95,chr2,125247190,125247958,768,95,556,24.7,72.4,0.96
CpG: 87,chr2,125505447,125506493,1046,87,690,16.6,66,0.78
CpG: 49,chr2,125624845,125625295,450,49,309,21.8,68.7,0.93
CpG: 29,chr2,125673359,125673642,283,29,175,20.5,61.8,1.1
CpG: 32,chr2,125723206,125723658,452,32,302,14.2,66.8,0.63
CpG: 54,chr2,125782498,125782912,414,54,288,26.1,69.6,1.08
CpG: 50,chr2,125858656,125859247,591,50,388,16.9,65.7,0.79
CpG: 53,chr2,126151922,126152502,580,53,380,18.3,65.5,0.86
CpG: 61,chr2,126552922,126553506,584,61,394,20.9,67.5,0.93
CpG: 151,chr2,126674608,126675949,1341,151,882,22.5,65.8,1.04
CpG: 59,chr2,126707136,126707658,522,59,357,22.6,68.4,0.97
CpG: 93,chr2,126875631,126876523,892,93,573,20.9,64.2,1.04
CpG: 29,chr2,126932979,126933301,322,29,208,18,64.6,0.87
CpG: 31,chr2,127070588,127070883,295,31,201,21,68.1,0.91
CpG: 49,chr2,127133630,127134104,474,49,308,20.7,65,0.99
CpG: 24,chr2,127143234,127143506,272,24,171,17.6,62.9,0.92
CpG: 35,chr2,127208233,127208604,371,35,219,18.9,59,1.09
CpG: 97,chr2,127247484,127248719,1235,97,819,15.7,66.3,0.72
CpG: 105,chr2,127269730,127270849,1119,105,725,18.8,64.8,0.89
CpG: 102,chr2,127335968,127336736,768,102,570,26.6,74.2,0.97
CpG: 63,chr2,127362915,127363630,715,63,474,17.6,66.3,0.81
CpG: 25,chr2,127444312,127444599,287,25,179,17.4,62.4,0.9
CpG: 64,chr2,127482109,127482724,615,64,451,20.8,73.3,0.77
CpG: 42,chr2,127541035,127541535,500,42,348,16.8,69.6,0.7
CpG: 19,chr2,127584568,127584792,224,19,132,17,58.9,1
CpG: 48,chr2,127587174,127587659,485,48,324,19.8,66.8,0.89
CpG: 36,chr2,127656112,127656491,379,36,258,19,68.1,0.82
CpG: 34,chr2,127788653,127788974,321,34,215,21.2,67,0.94
CpG: 31,chr2,127792199,127792560,361,31,229,17.2,63.4,0.86
CpG: 56,chr2,127831452,127831991,539,56,345,20.8,64,1.03
CpG: 256,chr2,128125625,128128313,2688,256,1769,19,65.8,0.89
CpG: 51,chr2,128686924,128687499,575,51,351,17.7,61,0.95
CpG: 32,chr2,128818186,128818534,348,32,227,18.4,65.2,0.86
CpG: 34,chr2,128863830,128864202,372,34,254,18.3,68.3,0.79
CpG: 29,chr2,128892289,128892574,285,29,195,20.4,68.4,0.87
CpG: 59,chr2,128943561,128944174,613,59,405,19.2,66.1,0.89
CpG: 69,chr2,128967018,128967731,713,69,459,19.4,64.4,0.93
CpG: 66,chr2,129038833,129039540,707,66,476,18.7,67.3,0.82
CpG: 52,chr2,129065868,129066352,484,52,304,21.5,62.8,1.1
CpG: 24,chr2,129101040,129101282,242,24,160,19.8,66.1,0.91
CpG: 18,chr2,129125765,129126038,273,18,150,13.2,54.9,0.87
CpG: 35,chr2,129129397,129129848,451,35,274,15.5,60.8,0.85
CpG: 115,chr2,129198171,129199236,1065,115,731,21.6,68.6,0.92
CpG: 32,chr2,129296978,129297296,318,32,203,20.1,63.8,0.99
CpG: 54,chr2,129593195,129593678,483,54,319,22.4,66,1.05
CpG: 20,chr2,129688046,129688338,292,20,172,13.7,58.9,0.83
CpG: 165,chr2,129800323,129801953,1630,165,1077,20.2,66.1,0.93
CpG: 80,chr2,130178748,130179429,681,80,471,23.5,69.2,1.02
CpG: 73,chr2,130274053,130274815,762,73,498,19.2,65.4,0.9
CpG: 45,chr2,130284119,130284541,422,45,274,21.3,64.9,1.01
CpG: 25,chr2,130294738,130295054,316,25,210,15.8,66.5,0.72
CpG: 82,chr2,130295425,130296228,803,82,510,20.4,63.5,1.01
CpG: 57,chr2,130361847,130362462,615,57,426,18.5,69.3,0.78
CpG: 41,chr2,130397413,130397861,448,41,295,18.3,65.8,0.85
CpG: 100,chr2,130423677,130424824,1147,100,735,17.4,64.1,0.85
CpG: 81,chr2,130450117,130450774,657,81,470,24.7,71.5,0.97
CpG: 79,chr2,130563566,130564314,748,79,518,21.1,69.3,0.88
CpG: 41,chr2,130576488,130576970,482,41,324,17,67.2,0.76
CpG: 51,chr2,130580656,130581246,590,51,407,17.3,69,0.74
CpG: 50,chr2,130629550,130630080,530,50,350,18.9,66,0.87
CpG: 19,chr2,130634979,130635229,250,19,174,15.2,69.6,0.67
CpG: 48,chr2,130642401,130642980,579,48,359,16.6,62,0.89
CpG: 36,chr2,130664301,130664667,366,36,244,19.7,66.7,0.9
CpG: 31,chr2,130667562,130667918,356,31,226,17.4,63.5,0.86
CpG: 89,chr2,130696902,130697789,887,89,600,20.1,67.6,0.89
CpG: 70,chr2,130839643,130840396,753,70,481,18.6,63.9,0.92
CpG: 76,chr2,130906267,130906976,709,76,461,21.4,65,1.02
CpG: 105,chr2,131041044,131041752,708,105,535,29.7,75.6,1.04
CpG: 26,chr2,131063425,131063752,327,26,224,15.9,68.5,0.68
CpG: 36,chr2,131144620,131145010,390,36,258,18.5,66.2,0.85
CpG: 56,chr2,131159928,131160570,642,56,405,17.4,63.1,0.88
CpG: 30,chr2,131171499,131171740,241,30,173,24.9,71.8,0.97
CpG: 73,chr2,131179167,131179864,697,73,472,20.9,67.7,0.91
CpG: 35,chr2,131210066,131210421,355,35,241,19.7,67.9,0.86
CpG: 35,chr2,131233995,131234508,513,35,329,13.6,64.1,0.66
CpG: 80,chr2,131262245,131262878,633,80,445,25.3,70.3,1.03
CpG: 71,chr2,131352450,131353160,710,71,448,20,63.1,1.01
CpG: 90,chr2,131491658,131492555,897,90,596,20.1,66.4,0.93
CpG: 18,chr2,131520580,131520808,228,18,148,15.8,64.9,0.79
CpG: 42,chr2,131546052,131546433,381,42,244,22,64,1.09
CpG: 145,chr2,131561114,131562649,1535,145,1039,18.9,67.7,0.82
CpG: 28,chr2,131909853,131910095,242,28,171,23.1,70.7,0.94
CpG: 21,chr2,132029074,132029328,254,21,157,16.5,61.8,0.87
CpG: 28,chr2,132029695,132029943,248,28,187,22.6,75.4,0.8
CpG: 62,chr2,132144516,132145099,583,62,367,21.3,63,1.07
CpG: 38,chr2,132247527,132247857,330,38,225,23,68.2,1
CpG: 82,chr2,132252581,132253554,973,82,595,16.9,61.2,0.9
CpG: 84,chr2,132262953,132263752,799,84,558,21,69.8,0.87
CpG: 34,chr2,132385076,132385503,427,34,284,15.9,66.5,0.74
CpG: 70,chr2,132577579,132578283,704,70,453,19.9,64.3,0.96
CpG: 20,chr2,132686949,132687166,217,20,146,18.4,67.3,0.82
CpG: 34,chr2,132781384,132781782,398,34,258,17.1,64.8,0.82
CpG: 60,chr2,132815842,132816413,571,60,369,21,64.6,1.01
CpG: 90,chr2,132846556,132847257,701,90,508,25.7,72.5,0.98
CpG: 51,chr2,132879247,132879758,511,51,356,20,69.7,0.83
CpG: 45,chr2,132944989,132945603,614,45,376,14.7,61.2,0.78
CpG: 158,chr2,133551963,133553485,1522,158,1033,20.8,67.9,0.9
CpG: 38,chr2,133554334,133554765,431,38,292,17.6,67.7,0.77
CpG: 54,chr2,134643672,134644243,571,54,398,18.9,69.7,0.78
CpG: 88,chr2,134785987,134786804,817,88,587,21.5,71.8,0.85
CpG: 16,chr2,136387569,136387780,211,16,130,15.2,61.6,0.82
CpG: 40,chr2,136678696,136679127,431,40,302,18.6,70.1,0.76
CpG: 30,chr2,136890970,136891306,336,30,219,17.9,65.2,0.87
CpG: 27,chr2,137114533,137114856,323,27,216,16.7,66.9,0.76
CpG: 171,chr2,137115363,137117627,2264,171,1356,15.1,59.9,0.84
CpG: 88,chr2,138256536,138257223,687,88,509,25.6,74.1,0.95
CpG: 148,chr2,139677248,139678860,1612,148,1057,18.4,65.6,0.86
CpG: 60,chr2,140066396,140066950,554,60,367,21.7,66.2,0.99
CpG: 41,chr2,140170493,140170996,503,41,313,16.3,62.2,0.84
CpG: 93,chr2,140395181,140396082,901,93,596,20.6,66.1,0.95
CpG: 47,chr2,142901137,142901691,554,47,378,17,68.2,0.73
CpG: 43,chr2,143062930,143063274,344,43,224,25,65.1,1.21
CpG: 82,chr2,143862425,143863111,686,82,459,23.9,66.9,1.07
CpG: 94,chr2,143914805,143915832,1027,94,687,18.3,66.9,0.82
CpG: 164,chr2,144010003,144011636,1633,164,1063,20.1,65.1,0.96
CpG: 25,chr2,144165464,144165758,294,25,199,17,67.7,0.76
CpG: 98,chr2,144270330,144271165,835,98,556,23.5,66.6,1.06
CpG: 130,chr2,144330649,144332212,1563,130,986,16.6,63.1,0.84
CpG: 52,chr2,144368886,144369304,418,52,270,24.9,64.6,1.21
CpG: 19,chr2,144393401,144393650,249,19,149,15.3,59.8,0.87
CpG: 69,chr2,144527315,144528079,764,69,491,18.1,64.3,0.88
CpG: 20,chr2,144555758,144556019,261,20,164,15.3,62.8,0.78
CpG: 30,chr2,144556209,144556574,365,30,228,16.4,62.5,0.91
CpG: 39,chr2,144599905,144600258,353,39,243,22.1,68.8,0.94
CpG: 89,chr2,145167399,145168328,929,89,553,19.2,59.5,1.08
CpG: 31,chr2,145674929,145675375,446,31,277,13.9,62.1,0.73
CpG: 20,chr2,145860522,145860749,227,20,157,17.6,69.2,0.74
CpG: 62,chr2,145903118,145903581,463,62,330,26.8,71.3,1.06
CpG: 61,chr2,145934364,145935089,725,61,446,16.8,61.5,0.89
CpG: 35,chr2,146218332,146218679,347,35,228,20.2,65.7,0.95
CpG: 252,chr2,146221265,146223848,2583,252,1573,19.5,60.9,1.06
CpG: 72,chr2,146511726,146512360,634,72,448,22.7,70.7,0.91
CpG: 42,chr2,146834344,146834803,459,42,272,18.3,59.3,1.04
CpG: 40,chr2,146855767,146856152,385,40,278,20.8,72.2,0.8
CpG: 92,chr2,147012760,147013799,1039,92,666,17.7,64.1,0.86
CpG: 193,chr2,147083838,147085557,1719,193,1097,22.5,63.8,1.1
CpG: 57,chr2,147183909,147184553,644,57,434,17.7,67.4,0.79
CpG: 24,chr2,147185733,147186032,299,24,192,16.1,64.2,0.78
CpG: 22,chr2,147188040,147188301,261,22,167,16.9,64,0.83
CpG: 112,chr2,147193859,147195194,1335,112,914,16.8,68.5,0.72
CpG: 97,chr2,147364897,147366395,1498,97,858,13,57.3,0.79
CpG: 24,chr2,148038531,148038816,285,24,166,16.8,58.2,1
CpG: 206,chr2,148043876,148046965,3089,206,1869,13.3,60.5,0.73
CpG: 35,chr2,148048644,148049050,406,35,260,17.2,64,0.85
CpG: 85,chr2,148395052,148395945,893,85,585,19,65.5,0.89
CpG: 31,chr2,148407307,148407689,382,31,239,16.2,62.6,0.83
CpG: 20,chr2,148408150,148408408,258,20,162,15.5,62.8,0.79
CpG: 39,chr2,148672581,148672875,294,39,204,26.5,69.4,1.11
CpG: 45,chr2,148680939,148681444,505,45,335,17.8,66.3,0.83
CpG: 29,chr2,148732096,148732473,377,29,245,15.4,65,0.73
CpG: 41,chr2,148875076,148875576,500,41,324,16.4,64.8,0.79
CpG: 85,chr2,149830393,149831294,901,85,624,18.9,69.3,0.79
CpG: 22,chr2,150470084,150470288,204,22,150,21.6,73.5,0.8
CpG: 44,chr2,150500521,150500909,388,44,249,22.7,64.2,1.1
CpG: 45,chr2,150525839,150526229,390,45,274,23.1,70.3,0.94
CpG: 32,chr2,150667985,150668235,250,32,186,25.6,74.4,0.93
CpG: 44,chr2,150688516,150688951,435,44,311,20.2,71.5,0.79
CpG: 49,chr2,150748996,150749469,473,49,317,20.7,67,0.92
CpG: 52,chr2,150786624,150787229,605,52,402,17.2,66.4,0.79
CpG: 74,chr2,150904191,150904823,632,74,456,23.4,72.2,0.91
CpG: 56,chr2,151008873,151009479,606,56,383,18.5,63.2,0.93
CpG: 60,chr2,151039005,151039502,497,60,343,24.1,69,1.02
CpG: 72,chr2,151494132,151494799,667,72,466,21.6,69.9,0.91
CpG: 89,chr2,151542372,151543206,834,89,530,21.3,63.5,1.06
CpG: 26,chr2,151576026,151576362,336,26,198,15.5,58.9,0.9
CpG: 49,chr2,151632027,151632439,412,49,307,23.8,74.5,0.86
CpG: 114,chr2,151701994,151702987,993,114,697,23,70.2,0.93
CpG: 57,chr2,151740827,151741394,567,57,354,20.1,62.4,1.03
CpG: 34,chr2,151842765,151843046,281,34,191,24.2,68,1.05
CpG: 29,chr2,151970018,151970419,401,29,255,14.5,63.6,0.72
CpG: 24,chr2,151970535,151970877,342,24,228,14,66.7,0.64
CpG: 35,chr2,151979936,151980339,403,35,274,17.4,68,0.76
CpG: 47,chr2,152029384,152029870,486,47,312,19.3,64.2,0.94
CpG: 66,chr2,152048381,152049175,794,66,460,16.6,57.9,0.99
CpG: 67,chr2,152081643,152082368,725,67,486,18.5,67,0.82
CpG: 110,chr2,152092956,152093939,983,110,642,22.4,65.3,1.06
CpG: 20,chr2,152095184,152095428,244,20,170,16.4,69.7,0.72
CpG: 76,chr2,152105395,152106004,609,76,441,25,72.4,0.96
CpG: 127,chr2,152143213,152144174,961,127,674,26.4,70.1,1.08
CpG: 91,chr2,152226505,152227469,964,91,640,18.9,66.4,0.86
CpG: 72,chr2,152293709,152294303,594,72,427,24.2,71.9,0.94
CpG: 34,chr2,152332162,152332478,316,34,219,21.5,69.3,0.9
CpG: 32,chr2,152343877,152344209,332,32,228,19.3,68.7,0.87
CpG: 169,chr2,152396728,152399000,2272,169,1202,14.9,52.9,1.06
CpG: 142,chr2,152413861,152415027,1166,142,803,24.4,68.9,1.03
CpG: 45,chr2,152626972,152627572,600,45,390,15,65,0.71
CpG: 28,chr2,152634450,152634683,233,28,156,24,67,1.08
CpG: 57,chr2,152669387,152669832,445,57,314,25.6,70.6,1.03
CpG: 44,chr2,152686809,152687230,421,44,257,20.9,61,1.12
CpG: 29,chr2,152707611,152707865,254,29,191,22.8,75.2,0.81
CpG: 26,chr2,152735017,152735298,281,26,189,18.5,67.3,0.83
CpG: 52,chr2,152736313,152737020,707,52,433,14.7,61.2,0.78
CpG: 23,chr2,152739383,152739589,206,23,149,22.3,72.3,0.85
CpG: 84,chr2,152830857,152831819,962,84,651,17.5,67.7,0.76
CpG: 26,chr2,152847975,152848240,265,26,168,19.6,63.4,1.04
CpG: 20,chr2,152932771,152933028,257,20,157,15.6,61.1,0.85
CpG: 60,chr2,152943009,152943484,475,60,345,25.3,72.6,0.97
CpG: 42,chr2,152951258,152951798,540,42,357,15.6,66.1,0.71
CpG: 37,chr2,153015134,153015481,347,37,239,21.3,68.9,0.91
CpG: 58,chr2,153031905,153032546,641,58,369,18.1,57.6,1.11
CpG: 17,chr2,153054641,153054864,223,17,142,15.2,63.7,0.75
CpG: 19,chr2,153080976,153081187,211,19,136,18,64.5,0.87
CpG: 45,chr2,153108436,153108921,485,45,336,18.6,69.3,0.79
CpG: 20,chr2,153225169,153225429,260,20,179,15.4,68.8,0.66
CpG: 80,chr2,153241076,153241801,725,80,489,22.1,67.4,0.97
CpG: 54,chr2,153291227,153291687,460,54,311,23.5,67.6,1.03
CpG: 113,chr2,153345424,153346759,1335,113,748,16.9,56,1.09
CpG: 81,chr2,153443593,153444512,919,81,621,17.6,67.6,0.78
CpG: 31,chr2,153445507,153445831,324,31,204,19.1,63,0.97
CpG: 50,chr2,153492290,153492775,485,50,292,20.6,60.2,1.15
CpG: 198,chr2,153527857,153530609,2752,198,1527,14.4,55.5,0.94
CpG: 36,chr2,153632538,153632819,281,36,205,25.6,73,0.99
CpG: 77,chr2,153649431,153649930,499,77,376,30.9,75.4,1.09
CpG: 73,chr2,153741141,153741640,499,73,368,29.3,73.7,1.11
CpG: 19,chr2,153779022,153779269,247,19,154,15.4,62.3,0.88
CpG: 39,chr2,154372360,154372838,478,39,293,16.3,61.3,0.88
CpG: 82,chr2,154407700,154408359,659,82,473,24.9,71.8,0.97
CpG: 83,chr2,154436129,154436995,866,83,542,19.2,62.6,1
CpG: 55,chr2,154549461,154549969,508,55,362,21.7,71.3,0.86
CpG: 22,chr2,154552496,154552797,301,22,185,14.6,61.5,0.78
CpG: 27,chr2,154558715,154558959,244,27,182,22.1,74.6,0.8
CpG: 116,chr2,154569321,154570198,877,116,616,26.5,70.2,1.07
CpG: 82,chr2,154613115,154613968,853,82,533,19.2,62.5,1
CpG: 24,chr2,154657169,154657516,347,24,212,13.8,61.1,0.74
CpG: 154,chr2,154790680,154792163,1483,154,1025,20.8,69.1,0.87
CpG: 75,chr2,154892232,154893035,803,75,508,18.7,63.3,0.93
CpG: 29,chr2,155050579,155050864,285,29,188,20.4,66,0.95
CpG: 39,chr2,155074084,155074476,392,39,246,19.9,62.8,1.01
CpG: 44,chr2,155133430,155133879,449,44,306,19.6,68.2,0.88
CpG: 44,chr2,155236468,155236906,438,44,292,20.1,66.7,0.91
CpG: 85,chr2,155276142,155277111,969,85,589,17.5,60.8,0.95
CpG: 20,chr2,155357307,155357546,239,20,147,16.7,61.5,0.88
CpG: 69,chr2,155381659,155382332,673,69,459,20.5,68.2,0.88
CpG: 25,chr2,155386547,155386840,293,25,195,17.1,66.6,0.78
CpG: 25,chr2,155514635,155514943,308,25,213,16.2,69.2,0.68
CpG: 52,chr2,155517874,155518363,489,52,340,21.3,69.5,0.88
CpG: 38,chr2,155592468,155592799,331,38,220,23,66.5,1.1
CpG: 34,chr2,155629338,155629701,363,34,250,18.7,68.9,0.83
CpG: 57,chr2,155691846,155692448,602,57,377,18.9,62.6,0.97
CpG: 29,chr2,155729175,155729446,271,29,192,21.4,70.8,0.85
CpG: 23,chr2,155775691,155775896,205,23,126,22.4,61.5,1.31
CpG: 28,chr2,155818920,155819289,369,28,243,15.2,65.9,0.7
CpG: 62,chr2,155826090,155826831,741,62,473,16.7,63.8,0.85
CpG: 28,chr2,155929944,155930265,321,28,195,17.4,60.7,0.96
CpG: 32,chr2,155941843,155942331,488,32,298,13.1,61.1,0.71
CpG: 47,chr2,155956464,155956970,506,47,360,18.6,71.1,0.74
CpG: 35,chr2,156007896,156008301,405,35,282,17.3,69.6,0.71
CpG: 64,chr2,156065178,156065913,735,64,457,17.4,62.2,0.91
CpG: 71,chr2,156111413,156112012,599,71,433,23.7,72.3,0.94
CpG: 73,chr2,156143881,156144601,720,73,483,20.3,67.1,0.9
CpG: 108,chr2,156179356,156180438,1082,108,676,20,62.5,1.03
CpG: 82,chr2,156196538,156197224,686,82,492,23.9,71.7,0.97
CpG: 92,chr2,156311913,156312809,896,92,584,20.5,65.2,0.97
CpG: 72,chr2,156420600,156421386,786,72,470,18.3,59.8,1.03
CpG: 62,chr2,156613878,156614368,490,62,380,25.3,77.6,0.84
CpG: 27,chr2,156710098,156710506,408,27,254,13.2,62.3,0.79
CpG: 83,chr2,156720628,156721469,841,83,495,19.7,58.9,1.15
CpG: 18,chr2,156747990,156748239,249,18,144,14.5,57.8,0.87
CpG: 153,chr2,156839861,156841293,1432,153,1024,21.4,71.5,0.85
CpG: 106,chr2,156862764,156863637,873,106,603,24.3,69.1,1.02
CpG: 56,chr2,156991692,156992148,456,56,298,24.6,65.4,1.16
CpG: 47,chr2,157006760,157007187,427,47,294,22,68.9,0.94
CpG: 32,chr2,157020678,157021147,469,32,291,13.6,62,0.71
CpG: 55,chr2,157040038,157040753,715,55,474,15.4,66.3,0.71
CpG: 170,chr2,157078239,157079868,1629,170,990,20.9,60.8,1.13
CpG: 56,chr2,157134669,157135329,660,56,428,17,64.8,0.82
CpG: 97,chr2,157203986,157205019,1033,97,643,18.8,62.2,0.97
CpG: 93,chr2,157278862,157279666,804,93,573,23.1,71.3,0.92
CpG: 44,chr2,157367522,157367966,444,44,300,19.8,67.6,0.88
CpG: 69,chr2,157423977,157424677,700,69,373,19.7,53.3,1.39
CpG: 55,chr2,157457113,157457779,666,55,453,16.5,68,0.72
CpG: 51,chr2,157560050,157560581,531,51,341,19.2,64.2,0.94
CpG: 35,chr2,157565924,157566252,328,35,234,21.3,71.3,0.84
CpG: 29,chr2,157737253,157737603,350,29,211,16.6,60.3,0.91
CpG: 82,chr2,157914323,157915248,925,82,553,17.7,59.8,1
CpG: 16,chr2,157941356,157941559,203,16,116,15.8,57.1,0.97
CpG: 58,chr2,157943804,157944466,662,58,450,17.5,68,0.77
CpG: 75,chr2,158028259,158029063,804,75,528,18.7,65.7,0.88
CpG: 44,chr2,158228889,158229473,584,44,374,15.1,64,0.74
CpG: 22,chr2,158361333,158361609,276,22,173,15.9,62.7,0.81
CpG: 20,chr2,158375542,158375765,223,20,146,17.9,65.5,0.84
CpG: 101,chr2,158409629,158410484,855,101,604,23.6,70.6,0.95
CpG: 30,chr2,158609779,158610151,372,30,215,16.1,57.8,0.98
CpG: 91,chr2,158610743,158611614,871,91,604,20.9,69.3,0.88
CpG: 97,chr2,158613842,158614993,1151,97,701,16.9,60.9,0.92
CpG: 70,chr2,158624837,158625555,718,70,463,19.5,64.5,0.94
CpG: 84,chr2,158667070,158668051,981,84,675,17.1,68.8,0.73
CpG: 24,chr2,158695912,158696204,292,24,193,16.4,66.1,0.76
CpG: 59,chr2,158768122,158768608,486,59,327,24.3,67.3,1.07
CpG: 34,chr2,158794640,158795062,422,34,286,16.1,67.8,0.71
CpG: 217,chr2,160365382,160367635,2253,217,1514,19.3,67.2,0.85
CpG: 20,chr2,160369068,160369297,229,20,144,17.5,62.9,0.91
CpG: 122,chr2,160645668,160646951,1283,122,775,19,60.4,1.05
CpG: 116,chr2,160731006,160732126,1120,116,710,20.7,63.4,1.03
CpG: 103,chr2,160872348,160873274,926,103,661,22.2,71.4,0.87
CpG: 32,chr2,160887761,160888229,468,32,275,13.7,58.8,0.82
CpG: 110,chr2,160911649,160912548,899,110,650,24.5,72.3,0.94
CpG: 91,chr2,161108518,161109676,1158,91,701,15.7,60.5,0.86
CpG: 104,chr2,162660429,162661436,1007,104,658,20.7,65.3,0.97
CpG: 17,chr2,162908307,162908538,231,17,149,14.7,64.5,0.72
CpG: 154,chr2,162930968,162932371,1403,154,892,22,63.6,1.08
CpG: 26,chr2,162943429,162943667,238,26,174,21.8,73.1,0.83
CpG: 38,chr2,163017350,163017742,392,38,259,19.4,66.1,0.89
CpG: 83,chr2,163054524,163055339,815,83,556,20.4,68.2,0.88
CpG: 141,chr2,163202925,163204657,1732,141,1050,16.3,60.6,0.89
CpG: 93,chr2,163339165,163340023,858,93,621,21.7,72.4,0.83
CpG: 87,chr2,163375610,163376385,775,87,528,22.5,68.1,0.97
CpG: 119,chr2,163418939,163420022,1083,119,733,22,67.7,0.96
CpG: 26,chr2,163438488,163438801,313,26,218,16.6,69.6,0.69
CpG: 53,chr2,163472210,163472708,498,53,338,21.3,67.9,0.95
CpG: 35,chr2,163602260,163602581,321,35,211,21.8,65.7,1.03
CpG: 67,chr2,163644701,163645273,572,67,409,23.4,71.5,0.92
CpG: 54,chr2,163658307,163658846,539,54,297,20,55.1,1.34
CpG: 44,chr2,163749780,163750326,546,44,344,16.1,63,0.82
CpG: 57,chr2,163853669,163854101,432,57,306,26.4,70.8,1.06
CpG: 49,chr2,163858195,163858728,533,49,352,18.4,66,0.85
CpG: 67,chr2,163918461,163919206,745,67,391,18,52.5,1.31
CpG: 45,chr2,163995281,163995733,452,45,320,19.9,70.8,0.81
CpG: 68,chr2,164070405,164071023,618,68,432,22,69.9,0.93
CpG: 51,chr2,164073997,164074597,600,51,402,17,67,0.79
CpG: 130,chr2,164167817,164168844,1027,130,711,25.3,69.2,1.06
CpG: 28,chr2,164170971,164171226,255,28,185,22,72.5,0.85
CpG: 30,chr2,164389555,164389887,332,30,224,18.1,67.5,0.8
CpG: 26,chr2,164393167,164393457,290,26,188,17.9,64.8,0.86
CpG: 60,chr2,164397341,164398216,875,60,561,13.7,64.1,0.82
CpG: 54,chr2,164400606,164401044,438,54,291,24.7,66.4,1.12
CpG: 41,chr2,164404397,164404951,554,41,375,14.8,67.7,0.65
CpG: 27,chr2,164414360,164414612,252,27,170,21.4,67.5,0.98
CpG: 24,chr2,164443089,164443369,280,24,201,17.1,71.8,0.67
CpG: 90,chr2,164460802,164461692,890,90,586,20.2,65.8,0.93
CpG: 112,chr2,164485967,164487110,1143,112,797,19.6,69.7,0.81
CpG: 43,chr2,164497339,164497749,410,43,271,21,66.1,0.96
CpG: 45,chr2,164507384,164507892,508,45,349,17.7,68.7,0.77
CpG: 40,chr2,164745729,164746085,356,40,248,22.5,69.7,0.93
CpG: 45,chr2,164769626,164770104,478,45,310,18.8,64.9,0.9
CpG: 86,chr2,164785608,164786389,781,86,574,22,73.5,0.82
CpG: 31,chr2,164804633,164804974,341,31,204,18.2,59.8,1.02
CpG: 21,chr2,164822982,164823192,210,21,138,20,65.7,0.94
CpG: 45,chr2,164832787,164833426,639,45,401,14.1,62.8,0.72
CpG: 21,chr2,164833897,164834185,288,21,179,14.6,62.2,0.76
CpG: 69,chr2,164856831,164857749,918,69,587,15,63.9,0.74
CpG: 80,chr2,164879316,164880115,799,80,485,20,60.7,1.1
CpG: 119,chr2,164910638,164911930,1292,119,877,18.4,67.9,0.8
CpG: 52,chr2,164949194,164949837,643,52,390,16.2,60.7,0.88
CpG: 17,chr2,164953348,164953565,217,17,139,15.7,64.1,0.77
CpG: 33,chr2,164960781,164960997,216,33,166,30.6,76.9,1.05
CpG: 83,chr2,164967876,164968857,981,83,593,16.9,60.4,0.95
CpG: 23,chr2,164969316,164969617,301,23,200,15.3,66.4,0.72
CpG: 29,chr2,164970999,164971247,248,29,172,23.4,69.4,0.97
CpG: 67,chr2,164997528,164998294,766,67,517,17.5,67.5,0.77
CpG: 16,chr2,165012928,165013137,209,16,119,15.3,56.9,0.98
CpG: 102,chr2,165034047,165035034,987,102,598,20.7,60.6,1.13
CpG: 71,chr2,165112049,165112596,547,71,394,26,72,1
CpG: 21,chr2,165116169,165116454,285,21,186,14.7,65.3,0.72
CpG: 28,chr2,165142029,165142238,209,28,153,26.8,73.2,1
CpG: 21,chr2,165215278,165215521,243,21,143,17.3,58.8,1.01
CpG: 161,chr2,165233432,165235092,1660,161,1112,19.4,67,0.86
CpG: 41,chr2,165287401,165287882,481,41,327,17,68,0.74
CpG: 48,chr2,165326173,165326655,482,48,332,19.9,68.9,0.85
CpG: 26,chr2,165368546,165368841,295,26,189,17.6,64.1,0.87
CpG: 39,chr2,165380155,165380639,484,39,296,16.1,61.2,0.86
CpG: 33,chr2,165387949,165388334,385,33,258,17.1,67,0.78
CpG: 18,chr2,165396057,165396266,209,18,141,17.2,67.5,0.79
CpG: 30,chr2,165473020,165473271,251,30,187,23.9,74.5,0.86
CpG: 73,chr2,165492858,165493445,587,73,409,24.9,69.7,1.08
CpG: 25,chr2,165503861,165504148,287,25,206,17.4,71.8,0.7
CpG: 51,chr2,165563372,165563841,469,51,333,21.7,71,0.87
CpG: 52,chr2,165594912,165595349,437,52,284,23.8,65,1.13
CpG: 28,chr2,165796193,165796571,378,28,260,14.8,68.8,0.63
CpG: 25,chr2,165807680,165807917,237,25,162,21.1,68.4,0.92
CpG: 18,chr2,165845571,165845816,245,18,142,14.7,58,0.87
CpG: 19,chr2,165861622,165861885,263,19,158,14.4,60.1,1.01
CpG: 110,chr2,165992468,165993539,1071,110,723,20.5,67.5,0.97
CpG: 107,chr2,166154259,166155588,1329,107,752,16.1,56.6,1.02
CpG: 101,chr2,166713474,166714348,874,101,615,23.1,70.4,0.94
CpG: 22,chr2,166786632,166786858,226,22,150,19.5,66.4,0.88
CpG: 75,chr2,166793660,166794219,559,75,399,26.8,71.4,1.11
CpG: 70,chr2,166805343,166805987,644,70,475,21.7,73.8,0.82
CpG: 80,chr2,166905915,166906629,714,80,496,22.4,69.5,0.93
CpG: 90,chr2,166995696,166996441,745,90,528,24.2,70.9,0.96
CpG: 48,chr2,167015190,167015563,373,48,259,25.7,69.4,1.09
CpG: 98,chr2,167062517,167063280,763,98,531,25.7,69.6,1.07
CpG: 31,chr2,167104810,167105275,465,31,304,13.3,65.4,0.63
CpG: 190,chr2,167188125,167190391,2266,190,1389,16.8,61.3,0.89
CpG: 35,chr2,167240129,167240584,455,35,300,15.4,65.9,0.71
CpG: 86,chr2,167348898,167349851,953,86,569,18,59.7,1.04
CpG: 62,chr2,167421325,167421982,657,62,443,18.9,67.4,0.83
CpG: 81,chr2,167492357,167493167,810,81,527,20,65.1,0.95
CpG: 105,chr2,167503283,167504249,966,105,654,21.7,67.7,0.95
CpG: 106,chr2,167537867,167538970,1103,106,767,19.2,69.5,0.8
CpG: 38,chr2,167597342,167597800,458,38,332,16.6,72.5,0.64
CpG: 111,chr2,167631356,167632333,977,111,717,22.7,73.4,0.85
CpG: 75,chr2,167661296,167661907,611,75,374,24.5,61.2,1.31
CpG: 206,chr2,167688552,167690184,1632,206,1028,25.2,63,1.28
CpG: 22,chr2,167777455,167777726,271,22,188,16.2,69.4,0.69
CpG: 27,chr2,167895111,167895364,253,27,160,21.3,63.2,1.07
CpG: 100,chr2,167931993,167932734,741,100,538,27,72.6,1.03
CpG: 39,chr2,168050281,168050608,327,39,235,23.9,71.9,0.93
CpG: 124,chr2,168080520,168081559,1039,124,685,23.9,65.9,1.1
CpG: 47,chr2,168098447,168099088,641,47,393,14.7,61.3,0.78
CpG: 44,chr2,168117255,168117628,373,44,268,23.6,71.8,0.92
CpG: 101,chr2,168206358,168207480,1122,101,656,18,58.5,1.07
CpG: 224,chr2,168229744,168231738,1994,224,1314,22.5,65.9,1.04
CpG: 29,chr2,168262792,168263124,332,29,214,17.5,64.5,0.84
CpG: 50,chr2,168268518,168269229,711,50,444,14.1,62.4,0.72
CpG: 56,chr2,168280659,168281123,464,56,340,24.1,73.3,0.9
CpG: 26,chr2,168281225,168281610,385,26,240,13.5,62.3,0.74
CpG: 63,chr2,168570749,168571524,775,63,521,16.3,67.2,0.76
CpG: 42,chr2,168590130,168590446,316,42,240,26.6,75.9,0.98
CpG: 80,chr2,168601193,168602100,907,80,603,17.6,66.5,0.8
CpG: 18,chr2,168619254,168619522,268,18,156,13.4,58.2,1.16
CpG: 38,chr2,168741381,168741745,364,38,274,20.9,75.3,0.76
CpG: 24,chr2,168750087,168750425,338,24,214,14.2,63.3,0.71
CpG: 19,chr2,168752423,168752644,221,19,136,17.2,61.5,0.91
CpG: 23,chr2,168755929,168756239,310,23,193,14.8,62.3,0.77
CpG: 23,chr2,168765055,168765272,217,23,147,21.2,67.7,0.92
CpG: 110,chr2,168765751,168767131,1380,110,891,15.9,64.6,0.76
CpG: 23,chr2,168893989,168894333,344,23,216,13.4,62.8,0.68
CpG: 39,chr2,168912194,168912543,349,39,247,22.3,70.8,0.89
CpG: 30,chr2,168926327,168926706,379,30,231,15.8,60.9,0.85
CpG: 34,chr2,168935186,168935510,324,34,210,21,64.8,1.01
CpG: 50,chr2,168954889,168955596,707,50,463,14.1,65.5,0.67
CpG: 20,chr2,169567201,169567455,254,20,153,15.7,60.2,0.94
CpG: 32,chr2,169633588,169633907,319,32,229,20.1,71.8,0.79
CpG: 22,chr2,170133456,170133728,272,22,156,16.2,57.4,0.98
CpG: 49,chr2,170496072,170496799,727,49,442,13.5,60.8,0.73
CpG: 31,chr2,170497210,170497548,338,31,233,18.3,68.9,0.79
CpG: 56,chr2,170511377,170511886,509,56,346,22,68,0.96
CpG: 103,chr2,172042063,172043477,1414,103,867,14.6,61.3,0.78
CpG: 50,chr2,172345329,172345900,571,50,399,17.5,69.9,0.72
CpG: 71,chr2,172370596,172371333,737,71,473,19.3,64.2,0.94
CpG: 42,chr2,172440316,172440790,474,42,291,17.7,61.4,0.94
CpG: 19,chr2,172548756,172548974,218,19,146,17.4,67,0.78
CpG: 180,chr2,172549568,172551833,2265,180,1404,15.9,62,0.83
CpG: 63,chr2,172728201,172728855,654,63,432,19.3,66.1,0.91
CpG: 151,chr2,172938929,172940663,1734,151,1146,17.4,66.1,0.8
CpG: 40,chr2,172979754,172980130,376,40,265,21.3,70.5,0.86
CpG: 85,chr2,172999941,173000732,791,85,545,21.5,68.9,0.91
CpG: 100,chr2,173021656,173022437,781,100,534,25.6,68.4,1.1
CpG: 44,chr2,173578063,173578438,375,44,278,23.5,74.1,0.87
CpG: 116,chr2,173585548,173586891,1343,116,753,17.3,56.1,1.13
CpG: 92,chr2,173659402,173660339,937,92,674,19.6,71.9,0.77
CpG: 42,chr2,173737344,173737962,618,42,331,13.6,53.6,0.95
CpG: 49,chr2,174076148,174076916,768,49,486,12.8,63.3,0.68
CpG: 59,chr2,174110023,174110831,808,59,467,14.6,57.8,0.88
CpG: 18,chr2,174120976,174121227,251,18,162,14.3,64.5,0.7
CpG: 56,chr2,174284647,174285390,743,56,425,15.1,57.2,0.93
CpG: 21,chr2,174286011,174286221,210,21,137,20,65.2,0.94
CpG: 25,chr2,174297262,174297532,270,25,166,18.5,61.5,0.98
CpG: 163,chr2,174298463,174300644,2181,163,1415,14.9,64.9,0.71
CpG: 16,chr2,174300746,174300959,213,16,121,15,56.8,0.94
CpG: 289,chr2,174327293,174331145,3852,289,2142,15,55.6,0.97
CpG: 34,chr2,174415808,174416135,327,34,220,20.8,67.3,0.92
CpG: 35,chr2,174438740,174439077,337,35,240,20.8,71.2,0.85
CpG: 22,chr2,174457131,174457452,321,22,190,13.7,59.2,0.82
CpG: 45,chr2,174463851,174464296,445,45,307,20.2,69,0.85
CpG: 66,chr2,174472550,174473208,658,66,430,20.1,65.3,0.94
CpG: 46,chr2,174760577,174761098,521,46,360,17.7,69.1,0.74
CpG: 38,chr2,178119043,178119439,396,38,287,19.2,72.5,0.74
CpG: 30,chr2,178142310,178142646,336,30,238,17.9,70.8,0.71
CpG: 38,chr2,178407225,178407650,425,38,275,17.9,64.7,0.88
CpG: 136,chr2,178413393,178414702,1309,136,878,20.8,67.1,0.93
CpG: 16,chr2,179293552,179293754,202,16,108,15.8,53.5,1.11
CpG: 176,chr2,179442275,179443758,1483,176,1040,23.7,70.1,0.97
CpG: 16,chr2,179931966,179932187,221,16,148,14.5,67,0.65
CpG: 33,chr2,179975288,179975568,280,33,210,23.6,75,0.84
CpG: 79,chr2,179976501,179977237,736,79,466,21.5,63.3,1.08
CpG: 145,chr2,180024309,180025831,1522,145,957,19.1,62.9,0.96
CpG: 200,chr2,180041799,180043419,1620,200,1171,24.7,72.3,0.95
CpG: 33,chr2,180070521,180070791,270,33,186,24.4,68.9,1.08
CpG: 129,chr2,180103320,180104780,1460,129,955,17.7,65.4,0.83
CpG: 104,chr2,180119181,180119906,725,104,548,28.7,75.6,1.03
CpG: 107,chr2,180171337,180172081,744,107,566,28.8,76.1,1
CpG: 92,chr2,180225009,180226077,1068,92,741,17.2,69.4,0.72
CpG: 61,chr2,180256996,180257849,853,61,507,14.3,59.4,0.81
CpG: 22,chr2,180273069,180273347,278,22,166,15.8,59.7,0.89
CpG: 32,chr2,180273502,180273772,270,32,169,23.7,62.6,1.23
CpG: 117,chr2,180333677,180335011,1334,117,882,17.5,66.1,0.81
CpG: 57,chr2,180456281,180457005,724,57,463,15.7,64,0.82
CpG: 37,chr2,180499880,180500311,431,37,287,17.2,66.6,0.78
CpG: 54,chr2,180582594,180583042,448,54,322,24.1,71.9,0.94
CpG: 59,chr2,180589226,180589789,563,59,373,21,66.3,0.97
CpG: 41,chr2,180598100,180598487,387,41,287,21.2,74.2,0.77
CpG: 103,chr2,180641944,180642920,976,103,550,21.1,56.4,1.37
CpG: 65,chr2,180701547,180702196,649,65,407,20,62.7,1.04
CpG: 104,chr2,180709650,180710724,1074,104,658,19.4,61.3,1.03
CpG: 96,chr2,180776047,180777062,1015,96,607,18.9,59.8,1.06
CpG: 19,chr2,180891500,180891737,237,19,148,16,62.4,0.83
CpG: 203,chr2,180892784,180894599,1815,203,1241,22.4,68.4,0.96
CpG: 73,chr2,180920342,180921136,794,73,467,18.4,58.8,1.06
CpG: 19,chr2,180954407,180954641,234,19,151,16.2,64.5,0.8
CpG: 60,chr2,180966968,180967732,764,60,502,15.7,65.7,0.74
CpG: 19,chr2,181028921,181029150,229,19,137,16.6,59.8,1.01
CpG: 41,chr2,181038876,181039235,359,41,231,22.8,64.3,1.12
CpG: 73,chr2,181134627,181135211,584,73,390,25,66.8,1.13
CpG: 47,chr2,181147685,181148173,488,47,294,19.3,60.2,1.07
CpG: 38,chr2,181156705,181157058,353,38,234,21.5,66.3,1.02
CpG: 58,chr2,181187245,181187935,690,58,458,16.8,66.4,0.76
CpG: 66,chr2,181287558,181288161,603,66,345,21.9,57.2,1.34
CpG: 70,chr2,181364734,181365592,858,70,542,16.3,63.2,0.82
CpG: 18,chr2,181365927,181366165,238,18,154,15.1,64.7,0.74
CpG: 172,chr2,181458502,181460531,2029,172,1177,17,58,1.01
CpG: 19,chr2,181494404,181494628,224,19,134,17,59.8,0.95
CpG: 38,chr2,181497117,181497534,417,38,274,18.2,65.7,0.85
CpG: 84,chr2,181520214,181520976,762,84,531,22,69.7,0.91
CpG: 33,chr2,181581759,181582060,301,33,215,21.9,71.4,0.86
CpG: 58,chr2,181592331,181592948,617,58,318,18.8,51.5,1.42
CpG: 62,chr2,181598743,181599286,543,62,384,22.8,70.7,0.92
CpG: 48,chr2,181600977,181601518,541,48,316,17.7,58.4,1.04
CpG: 144,chr2,181670291,181671731,1440,144,963,20,66.9,0.9
CpG: 61,chr2,181680143,181680698,555,61,376,22,67.7,0.96
CpG: 65,chr2,181693473,181694138,665,65,451,19.5,67.8,0.85
CpG: 19,chr2,181697242,181697469,227,19,132,16.7,58.1,1
CpG: 23,chr2,181837868,181838110,242,23,151,19,62.4,1
CpG: 40,chr2,181864189,181864721,532,40,325,15,61.1,0.81
CpG: 59,chr3,40893822,40894519,697,59,459,16.9,65.9,0.78
CpG: 56,chr3,103809014,103809590,576,56,348,19.4,60.4,1.08
CpG: 17,chr3,101056333,101056556,223,17,130,15.2,58.3,0.9
CpG: 16,chr3,3309040,3309248,208,16,130,15.4,62.5,0.83
CpG: 47,chr3,5219318,5219878,560,47,325,16.8,58,1.01
CpG: 80,chr3,5575795,5576577,782,80,500,20.5,63.9,1.01
CpG: 33,chr3,7366450,7366795,345,33,232,19.1,67.2,0.85
CpG: 52,chr3,7503335,7503745,410,52,310,25.4,75.6,0.9
CpG: 27,chr3,7612873,7613165,292,27,199,18.5,68.2,0.8
CpG: 27,chr3,8327265,8327511,246,27,180,22,73.2,0.82
CpG: 27,chr3,8462763,8463058,295,27,200,18.3,67.8,0.8
CpG: 39,chr3,8664657,8665054,397,39,262,19.6,66,0.91
CpG: 108,chr3,8666662,8667747,1085,108,707,19.9,65.2,0.94
CpG: 18,chr3,8766969,8767194,225,18,135,16,60,0.9
CpG: 26,chr3,8767575,8767815,240,26,174,21.7,72.5,0.83
CpG: 16,chr3,8805767,8805993,226,16,135,14.2,59.7,0.79
CpG: 58,chr3,8923456,8923964,508,58,350,22.8,68.9,0.97
CpG: 19,chr3,8963997,8964216,219,19,158,17.4,72.1,0.67
CpG: 64,chr3,9004109,9004643,534,64,336,24,62.9,1.27
CpG: 150,chr3,9250167,9251819,1652,150,847,18.2,51.3,1.39
CpG: 121,chr3,9450803,9452280,1477,121,1001,16.4,67.8,0.72
CpG: 33,chr3,9608980,9609332,352,33,188,18.8,53.4,1.38
CpG: 50,chr3,9609693,9610197,504,50,289,19.8,57.3,1.21
CpG: 70,chr3,9833090,9833701,611,70,418,22.9,68.4,0.98
CpG: 18,chr3,9968626,9968876,250,18,148,14.4,59.2,0.82
CpG: 32,chr3,10012269,10012608,339,32,239,18.9,70.5,0.76
CpG: 50,chr3,10331002,10331481,479,50,315,20.9,65.8,0.97
CpG: 22,chr3,10366841,10367127,286,22,191,15.4,66.8,0.69
CpG: 74,chr3,10439504,10440158,654,74,462,22.6,70.6,0.91
CpG: 40,chr3,13471591,13471869,278,40,209,28.8,75.2,1.03
CpG: 45,chr3,13472896,13473372,476,45,325,18.9,68.3,0.81
CpG: 33,chr3,14533765,14534090,325,33,220,20.3,67.7,0.9
CpG: 100,chr3,14578450,14579227,777,100,558,25.7,71.8,1
CpG: 57,chr3,14611032,14611738,706,57,440,16.1,62.3,0.84
CpG: 23,chr3,14641648,14641854,206,23,154,22.3,74.8,0.8
CpG: 93,chr3,14886138,14887025,887,93,630,21,71,0.83
CpG: 103,chr3,16182947,16183830,883,103,603,23.3,68.3,1.01
CpG: 79,chr3,17786168,17787096,928,79,637,17,68.6,0.72
CpG: 22,chr3,17794652,17794938,286,22,187,15.4,65.4,0.76
CpG: 157,chr3,18054413,18055885,1472,157,961,21.3,65.3,1
CpG: 23,chr3,18243008,18243233,225,23,156,20.4,69.3,0.87
CpG: 45,chr3,19162701,19163059,358,45,258,25.1,72.1,0.97
CpG: 59,chr3,19188029,19188573,544,59,399,21.7,73.3,0.82
CpG: 144,chr3,19310693,19311848,1155,144,769,24.9,66.6,1.13
CpG: 48,chr3,19694032,19694513,481,48,333,20,69.2,0.84
CpG: 65,chr3,19894634,19895495,861,65,530,15.1,61.6,0.8
CpG: 38,chr3,20035027,20035372,345,38,239,22,69.3,0.94
CpG: 47,chr3,20057627,20058195,568,47,349,16.5,61.4,0.88
CpG: 69,chr3,20154660,20155227,567,69,419,24.3,73.9,0.89
CpG: 139,chr3,22075736,22077228,1492,139,779,18.6,52.2,1.37
CpG: 104,chr3,25143676,25144419,743,104,536,28,72.1,1.08
CpG: 54,chr3,26331359,26331926,567,54,389,19,68.6,0.81
CpG: 25,chr3,26602036,26602356,320,25,216,15.6,67.5,0.69
CpG: 58,chr3,27153413,27154068,655,58,418,17.7,63.8,0.87
CpG: 37,chr3,27182877,27183286,409,37,262,18.1,64.1,0.89
CpG: 74,chr3,27371767,27372546,779,74,508,19,65.2,0.9
CpG: 122,chr3,27709973,27711161,1188,122,789,20.5,66.4,0.94
CpG: 59,chr3,27938473,27939115,642,59,439,18.4,68.4,0.8
CpG: 24,chr3,28262539,28262845,306,24,190,15.7,62.1,0.82
CpG: 39,chr3,28263361,28263691,330,39,225,23.6,68.2,1.02
CpG: 83,chr3,28781032,28781821,789,83,542,21,68.7,0.91
CpG: 60,chr3,28805313,28805759,446,60,293,26.9,65.7,1.25
CpG: 59,chr3,29082389,29083018,629,59,418,18.8,66.5,0.85
CpG: 143,chr3,30507627,30509377,1750,143,1136,16.3,64.9,0.78
CpG: 94,chr3,30514154,30515265,1111,94,655,16.9,59,0.98
CpG: 38,chr3,30595182,30595631,449,38,250,16.9,55.7,1.09
CpG: 20,chr3,30599720,30599987,267,20,172,15,64.4,0.72
CpG: 59,chr3,30602350,30603016,666,59,436,17.7,65.5,0.84
CpG: 110,chr3,30792959,30793798,839,110,564,26.2,67.2,1.17
CpG: 63,chr3,30855833,30856403,570,63,410,22.1,71.9,0.88
CpG: 80,chr3,30968682,30969506,824,80,565,19.4,68.6,0.83
CpG: 64,chr3,30995675,30996205,530,64,366,24.2,69.1,1.06
CpG: 18,chr3,31093713,31093932,219,18,126,16.4,57.5,0.99
CpG: 162,chr3,31094091,31095695,1604,162,962,20.2,60,1.14
CpG: 44,chr3,31149708,31150224,516,44,342,17.1,66.3,0.78
CpG: 19,chr3,31209064,31209346,282,19,158,13.5,56,0.86
CpG: 46,chr3,31309478,31310055,577,46,378,15.9,65.5,0.76
CpG: 67,chr3,32365290,32365820,530,67,347,25.3,65.5,1.18
CpG: 96,chr3,32396872,32397940,1068,96,618,18,57.9,1.07
CpG: 51,chr3,32510331,32510917,586,51,374,17.4,63.8,0.85
CpG: 40,chr3,32529379,32529841,462,40,298,17.3,64.5,0.83
CpG: 81,chr3,32616260,32616933,673,81,472,24.1,70.1,0.99
CpG: 100,chr3,32708371,32709402,1031,100,642,19.4,62.3,1
CpG: 89,chr3,32736300,32737547,1247,89,767,14.3,61.5,0.76
CpG: 69,chr3,32817317,32817959,642,69,438,21.5,68.2,0.92
CpG: 60,chr3,33142876,33143241,365,60,287,32.9,78.6,1.06
CpG: 92,chr3,33799710,33800589,879,92,591,20.9,67.2,0.93
CpG: 115,chr3,34019543,34020819,1276,115,734,18,57.5,1.11
CpG: 38,chr3,34081111,34081407,296,38,202,25.7,68.2,1.11
CpG: 19,chr3,34454197,34454418,221,19,126,17.2,57,1.13
CpG: 31,chr3,34642003,34642371,368,31,217,16.8,59,0.97
CpG: 186,chr3,34648829,34651366,2537,186,1530,14.7,60.3,0.81
CpG: 77,chr3,34663378,34664473,1095,77,641,14.1,58.5,0.82
CpG: 20,chr3,34894620,34894826,206,20,127,19.4,61.7,1.03
CpG: 14,chr3,34959185,34959396,211,14,116,13.3,55,0.88
CpG: 74,chr3,35753871,35754721,850,74,427,17.4,50.2,1.4
CpG: 82,chr3,35932342,35933154,812,82,475,20.2,58.5,1.21
CpG: 27,chr3,36000423,36000679,256,27,166,21.1,64.8,1.04
CpG: 42,chr3,36065948,36066403,455,42,294,18.5,64.6,0.9
CpG: 39,chr3,36151114,36151512,398,39,282,19.6,70.9,0.8
CpG: 29,chr3,36475547,36475970,423,29,278,13.7,65.7,0.68
CpG: 36,chr3,36552485,36552854,369,36,231,19.5,62.6,1
CpG: 106,chr3,36571391,36572316,925,106,631,22.9,68.2,0.99
CpG: 40,chr3,36613139,36613583,444,40,309,18,69.6,0.74
CpG: 37,chr3,36671153,36671669,516,37,323,14.3,62.6,0.74
CpG: 77,chr3,36689487,36690160,673,77,465,22.9,69.1,0.97
CpG: 49,chr3,36863001,36863537,536,49,361,18.3,67.4,0.85
CpG: 46,chr3,37063500,37063863,363,46,270,25.3,74.4,0.92
CpG: 49,chr3,37312371,37312802,431,49,309,22.7,71.7,0.89
CpG: 32,chr3,37348823,37349120,297,32,207,21.5,69.7,0.9
CpG: 147,chr3,37419151,37420945,1794,147,1008,16.4,56.2,1.04
CpG: 158,chr3,37639746,37641149,1403,158,860,22.5,61.3,1.2
CpG: 23,chr3,37669011,37669350,339,23,175,13.6,51.6,1.06
CpG: 25,chr3,38455890,38456228,338,25,210,14.8,62.1,0.77
CpG: 76,chr3,38484377,38485349,972,76,587,15.6,60.4,0.9
CpG: 251,chr3,38885050,38888327,3277,251,2065,15.3,63,0.77
CpG: 46,chr3,40531509,40532014,505,46,350,18.2,69.3,0.76
CpG: 38,chr3,40540693,40541093,400,38,277,19,69.2,0.79
CpG: 48,chr3,40708698,40709241,543,48,344,17.7,63.4,0.88
CpG: 95,chr3,40745019,40745862,843,95,559,22.5,66.3,1.03
CpG: 94,chr3,40799867,40800738,871,94,596,21.6,68.4,0.93
CpG: 52,chr3,40846515,40847132,617,52,409,16.9,66.3,0.77
CpG: 198,chr3,40949305,40950945,1640,198,1156,24.1,70.5,0.97
CpG: 130,chr3,41082420,41083669,1249,130,821,20.8,65.7,0.96
CpG: 52,chr3,41563389,41563958,569,52,288,18.3,50.6,1.45
CpG: 153,chr3,41564711,41566311,1600,153,998,19.1,62.4,0.99
CpG: 77,chr3,41742170,41742675,505,77,377,30.5,74.7,1.1
CpG: 21,chr3,41839459,41839684,225,21,156,18.7,69.3,0.78
CpG: 50,chr3,45376698,45377317,619,50,370,16.2,59.8,0.9
CpG: 23,chr3,45378166,45378399,233,23,149,19.7,63.9,0.97
CpG: 158,chr3,45379653,45381683,2030,158,1218,15.6,60,0.86
CpG: 17,chr3,49382594,49382798,204,17,118,16.7,57.8,1.03
CpG: 136,chr3,51224454,51225511,1057,136,764,25.7,72.3,1
CpG: 166,chr3,51275954,51277670,1716,166,1036,19.3,60.4,1.07
CpG: 212,chr3,51339765,51341474,1709,212,1172,24.8,68.6,1.09
CpG: 30,chr3,51358785,51359164,379,30,241,15.8,63.6,0.79
CpG: 21,chr3,51396376,51396619,243,21,172,17.3,70.8,0.69
CpG: 32,chr3,51408731,51409033,302,32,205,21.2,67.9,0.92
CpG: 114,chr3,51415791,51416885,1094,114,730,20.8,66.7,0.94
CpG: 103,chr3,51483779,51484689,910,103,637,22.6,70,0.92
CpG: 119,chr3,51559583,51561105,1522,119,909,15.6,59.7,0.88
CpG: 16,chr3,52007675,52007885,210,16,132,15.2,62.9,0.78
CpG: 192,chr3,52102331,52105132,2801,192,1599,13.7,57.1,0.85
CpG: 244,chr3,52267610,52270060,2450,244,1568,19.9,64,0.97
CpG: 41,chr3,53016871,53017305,434,41,281,18.9,64.7,0.9
CpG: 51,chr3,53041360,53041805,445,51,322,22.9,72.4,0.88
CpG: 82,chr3,53463062,53464009,947,82,585,17.3,61.8,0.91
CpG: 20,chr3,53478794,53479092,298,20,198,13.4,66.4,0.69
CpG: 58,chr3,53656616,53657328,712,58,450,16.3,63.2,0.82
CpG: 33,chr3,53863621,53863879,258,33,171,25.6,66.3,1.17
CpG: 24,chr3,54155976,54156294,318,24,206,15.1,64.8,0.74
CpG: 34,chr3,54633257,54633725,468,34,294,14.5,62.8,0.74
CpG: 58,chr3,54692486,54693059,573,58,374,20.2,65.3,0.95
CpG: 119,chr3,54734602,54735704,1102,119,723,21.6,65.6,1
CpG: 58,chr3,54755446,54755887,441,58,336,26.3,76.2,0.92
CpG: 16,chr3,54786131,54786350,219,16,137,14.6,62.6,0.84
CpG: 17,chr3,54794247,54794472,225,17,137,15.1,60.9,0.82
CpG: 92,chr3,54807174,54807903,729,92,523,25.2,71.7,0.99
CpG: 40,chr3,54810972,54811405,433,40,253,18.5,58.4,1.1
CpG: 21,chr3,54899481,54899688,207,21,126,20.3,60.9,1.1
CpG: 33,chr3,54915756,54916067,311,33,220,21.2,70.7,0.86
CpG: 65,chr3,55055046,55055673,627,65,426,20.7,67.9,0.91
CpG: 40,chr3,55112020,55112362,342,40,256,23.4,74.9,0.86
CpG: 41,chr3,55242455,55242935,480,41,333,17.1,69.4,0.71
CpG: 37,chr3,55780206,55780681,475,37,284,15.6,59.8,0.88
CpG: 36,chr3,55782800,55783379,579,36,340,12.4,58.7,0.72
CpG: 29,chr3,55787504,55787800,296,29,193,19.6,65.2,0.93
CpG: 138,chr3,56182802,56184121,1319,138,838,20.9,63.5,1.04
CpG: 18,chr3,57136951,57137210,259,18,171,13.9,66,0.64
CpG: 123,chr3,57574868,57576564,1696,123,1046,14.5,61.7,0.77
CpG: 34,chr3,57651424,57651807,383,34,243,17.8,63.4,0.89
CpG: 55,chr3,57735620,57736346,726,55,460,15.2,63.4,0.75
CpG: 121,chr3,57846855,57848105,1250,121,761,19.4,60.9,1.05
CpG: 261,chr3,58414621,58417207,2586,261,1756,20.2,67.9,0.88
CpG: 95,chr3,58525245,58526146,901,95,577,21.1,64,1.03
CpG: 90,chr3,58576589,58577316,727,90,512,24.8,70.4,1
CpG: 17,chr3,58636585,58636808,223,17,147,15.2,65.9,0.71
CpG: 126,chr3,58691569,58692626,1057,126,681,23.8,64.4,1.15
CpG: 226,chr3,59005377,59007530,2153,226,1477,21,68.6,0.89
CpG: 106,chr3,60500946,60501710,764,106,561,27.7,73.4,1.03
CpG: 86,chr3,61002583,61003400,817,86,567,21.1,69.4,0.87
CpG: 123,chr3,61364473,61365665,1192,123,797,20.6,66.9,0.93
CpG: 125,chr3,62338718,62339974,1256,125,830,19.9,66.1,0.91
CpG: 50,chr3,62506615,62507174,559,50,321,17.9,57.4,1.09
CpG: 30,chr3,62603693,62604077,384,30,249,15.6,64.8,0.75
CpG: 68,chr3,63295495,63296087,592,68,437,23,73.8,0.87
CpG: 36,chr3,63898684,63899161,477,36,294,15.1,61.6,0.8
CpG: 18,chr3,63905340,63905548,208,18,143,17.3,68.8,0.73
CpG: 40,chr3,63929109,63929463,354,40,258,22.6,72.9,0.86
CpG: 79,chr3,63963979,63964864,885,79,562,17.9,63.5,0.89
CpG: 52,chr3,63976057,63976587,530,52,359,19.6,67.7,0.87
CpG: 45,chr3,65392275,65392745,470,45,273,19.1,58.1,1.14
CpG: 207,chr3,65527714,65529467,1753,207,1253,23.6,71.5,0.93
CpG: 68,chr3,65658872,65659617,745,68,498,18.3,66.8,0.83
CpG: 71,chr3,65666031,65666732,701,71,458,20.3,65.3,0.95
CpG: 122,chr3,65957452,65958596,1144,122,683,21.3,59.7,1.2
CpG: 36,chr3,65974587,65975002,415,36,269,17.3,64.8,0.83
CpG: 15,chr3,66112436,66112664,228,15,135,13.2,59.2,0.76
CpG: 51,chr3,66220641,66221066,425,51,309,24,72.7,0.92
CpG: 56,chr3,66973459,66973929,470,56,330,23.8,70.2,1
CpG: 17,chr3,66978213,66978438,225,17,125,15.1,55.6,0.98
CpG: 25,chr3,66978754,66979046,292,25,186,17.1,63.7,0.85
CpG: 75,chr3,66980844,66981613,769,75,460,19.5,59.8,1.13
CpG: 55,chr3,66985596,66986137,541,55,374,20.3,69.1,0.87
CpG: 48,chr3,67373941,67374357,416,48,278,23.1,66.8,1.03
CpG: 38,chr3,67430041,67430570,529,38,339,14.4,64.1,0.7
CpG: 28,chr3,67463663,67464017,354,28,237,15.8,66.9,0.71
CpG: 67,chr3,67515050,67515627,577,67,416,23.2,72.1,0.89
CpG: 48,chr3,67582605,67583081,476,48,319,20.2,67,0.9
CpG: 149,chr3,68493636,68495346,1710,149,1101,17.4,64.4,0.84
CpG: 20,chr3,68572336,68572589,253,20,171,15.8,67.6,0.7
CpG: 152,chr3,68869157,68870536,1379,152,929,22,67.4,0.97
CpG: 134,chr3,69004820,69006319,1499,134,977,17.9,65.2,0.84
CpG: 101,chr3,69044369,69045276,907,101,569,22.3,62.7,1.13
CpG: 106,chr3,69126332,69127323,991,106,637,21.4,64.3,1.04
CpG: 143,chr3,69316275,69318046,1771,143,1032,16.1,58.3,0.95
CpG: 60,chr3,69598350,69599035,685,60,368,17.5,53.7,1.22
CpG: 83,chr3,69721871,69722735,864,83,553,19.2,64,0.94
CpG: 36,chr3,73057410,73057792,382,36,235,18.8,61.5,1.02
CpG: 48,chr3,75556341,75556896,555,48,377,17.3,67.9,0.79
CpG: 22,chr3,75946715,75947014,299,22,186,14.7,62.2,0.76
CpG: 90,chr3,75956176,75957134,958,90,640,18.8,66.8,0.85
CpG: 29,chr3,78966879,78967138,259,29,161,22.4,62.2,1.16
CpG: 22,chr3,79066572,79066779,207,22,154,21.3,74.4,0.77
CpG: 144,chr3,79286440,79287592,1152,144,806,25,70,1.03
CpG: 48,chr3,79591233,79591735,502,48,326,19.1,64.9,0.91
CpG: 58,chr3,79628595,79629374,779,58,482,14.9,61.9,0.78
CpG: 58,chr3,80913266,80913760,494,58,323,23.5,65.4,1.1
CpG: 81,chr3,81036672,81037695,1023,81,672,15.8,65.7,0.75
CpG: 32,chr3,82073785,82074134,349,32,235,18.3,67.3,0.81
CpG: 45,chr3,82358038,82358470,432,45,305,20.8,70.6,0.85
CpG: 102,chr3,82875877,82876702,825,102,598,24.7,72.5,0.94
CpG: 53,chr3,82903749,82904502,753,53,445,14.1,59.1,0.81
CpG: 45,chr3,83055251,83055643,392,45,261,23,66.6,1.07
CpG: 154,chr3,83127241,83129235,1994,154,1244,15.4,62.4,0.79
CpG: 28,chr3,83764193,83764543,350,28,212,16,60.6,0.88
CpG: 104,chr3,83765931,83767030,1099,104,746,18.9,67.9,0.84
CpG: 32,chr3,83789777,83790042,265,32,187,24.2,70.6,0.97
CpG: 23,chr3,83841390,83841674,284,23,198,16.2,69.7,0.67
CpG: 130,chr3,84039364,84040753,1389,130,876,18.7,63.1,0.94
CpG: 45,chr3,84155427,84155845,418,45,298,21.5,71.3,0.86
CpG: 48,chr3,84190483,84191108,625,48,378,15.4,60.5,0.84
CpG: 75,chr3,84259237,84259920,683,75,456,22,66.8,1
CpG: 130,chr3,84479312,84480891,1579,130,1004,16.5,63.6,0.82
CpG: 85,chr3,84582339,84583167,828,85,549,20.5,66.3,0.94
CpG: 153,chr3,84814010,84815782,1772,153,1077,17.3,60.8,0.94
CpG: 65,chr3,85887129,85887931,802,65,475,16.2,59.2,0.92
CpG: 56,chr3,85971013,85971495,482,56,339,23.2,70.3,0.95
CpG: 74,chr3,86142270,86142769,499,74,349,29.7,69.9,1.23
CpG: 95,chr3,86223757,86224547,790,95,542,24.1,68.6,1.03
CpG: 80,chr3,86546787,86547794,1007,80,612,15.9,60.8,0.86
CpG: 152,chr3,86919593,86920997,1404,152,963,21.7,68.6,0.92
CpG: 49,chr3,87174232,87174794,562,49,338,17.4,60.1,1.03
CpG: 61,chr3,87525465,87525918,453,61,340,26.9,75.1,0.98
CpG: 61,chr3,87617117,87617798,681,61,344,17.9,50.5,1.47
CpG: 36,chr3,87768883,87769188,305,36,234,23.6,76.7,0.8
CpG: 16,chr3,87783726,87783939,213,16,132,15,62,0.8
CpG: 53,chr3,87794866,87795289,423,53,318,25.1,75.2,0.9
CpG: 22,chr3,87796869,87797074,205,22,146,21.5,71.2,0.85
CpG: 18,chr3,87809395,87809603,208,18,142,17.3,68.3,0.74
CpG: 118,chr3,87906093,87907026,933,118,654,25.3,70.1,1.03
CpG: 23,chr3,87919429,87919749,320,23,166,14.4,51.9,1.08
CpG: 76,chr3,87929832,87930586,754,76,471,20.2,62.5,1.04
CpG: 102,chr3,87971020,87971963,943,102,656,21.6,69.6,0.9
CpG: 48,chr3,87997017,87997448,431,48,292,22.3,67.7,0.97
CpG: 77,chr3,87999753,88000469,716,77,464,21.5,64.8,1.02
CpG: 139,chr3,88022523,88024078,1555,139,1026,17.9,66,0.82
CpG: 40,chr3,88058282,88058640,358,40,252,22.3,70.4,0.95
CpG: 23,chr3,88081963,88082194,231,23,157,19.9,68,0.91
CpG: 97,chr3,88142154,88142958,804,97,570,24.1,70.9,0.96
CpG: 32,chr3,88177745,88178051,306,32,192,20.9,62.7,1.07
CpG: 80,chr3,88200511,88201287,776,80,509,20.6,65.6,0.96
CpG: 89,chr3,88214461,88215599,1138,89,749,15.6,65.8,0.72
CpG: 45,chr3,88240996,88241413,417,45,291,21.6,69.8,0.89
CpG: 26,chr3,88254449,88254740,291,26,193,17.9,66.3,0.82
CpG: 51,chr3,88296880,88297643,763,51,431,13.4,56.5,0.85
CpG: 20,chr3,88332967,88333238,271,20,180,14.8,66.4,0.67
CpG: 19,chr3,88336030,88336253,223,19,135,17,60.5,0.93
CpG: 18,chr3,88365848,88366065,217,18,142,16.6,65.4,0.81
CpG: 51,chr3,88409831,88410425,594,51,386,17.2,65,0.82
CpG: 37,chr3,88484616,88485123,507,37,322,14.6,63.5,0.73
CpG: 54,chr3,88502655,88503301,646,54,440,16.7,68.1,0.73
CpG: 48,chr3,88531525,88532132,607,48,387,15.8,63.8,0.78
CpG: 22,chr3,88532722,88532934,212,22,137,20.8,64.6,1
CpG: 67,chr3,88536236,88537018,782,67,500,17.1,63.9,0.84
CpG: 20,chr3,88552932,88553220,288,20,173,13.9,60.1,0.78
CpG: 28,chr3,88553384,88553676,292,28,201,19.2,68.8,0.81
CpG: 22,chr3,88554046,88554299,253,22,177,17.4,70,0.77
CpG: 22,chr3,88579602,88579812,210,22,145,21,69,0.91
CpG: 86,chr3,88621020,88621727,707,86,506,24.3,71.6,0.95
CpG: 21,chr3,88643984,88644204,220,21,159,19.1,72.3,0.73
CpG: 102,chr3,88685440,88686597,1157,102,725,17.6,62.7,0.91
CpG: 22,chr3,88716781,88717076,295,22,198,14.9,67.1,0.7
CpG: 34,chr3,88775140,88775461,321,34,218,21.2,67.9,1
CpG: 33,chr3,88835155,88835476,321,33,217,20.6,67.6,0.98
CpG: 59,chr3,88913462,88914088,626,59,411,18.8,65.7,0.88
CpG: 121,chr3,88949895,88951000,1105,121,677,21.9,61.3,1.17
CpG: 98,chr3,89090451,89091592,1141,98,799,17.2,70,0.71
CpG: 41,chr3,89101566,89102191,625,41,358,13.1,57.3,0.8
CpG: 22,chr3,89132363,89132635,272,22,175,16.2,64.3,0.82
CpG: 48,chr3,89159735,89160229,494,48,331,19.4,67,0.87
CpG: 53,chr3,89164637,89165252,615,53,314,17.2,51.1,1.35
CpG: 19,chr3,89168711,89168913,202,19,120,18.8,59.4,1.08
CpG: 19,chr3,89169426,89169681,255,19,170,14.9,66.7,0.77
CpG: 21,chr3,89177413,89177670,257,21,161,16.3,62.6,0.84
CpG: 23,chr3,89187162,89187479,317,23,219,14.5,69.1,0.63
CpG: 84,chr3,89213659,89214537,878,84,603,19.1,68.7,0.81
CpG: 30,chr3,89227366,89227789,423,30,243,14.2,57.4,0.86
CpG: 25,chr3,89246377,89246639,262,25,167,19.1,63.7,0.94
CpG: 22,chr3,89266357,89266652,295,22,162,14.9,54.9,1.01
CpG: 26,chr3,89280826,89281155,329,26,205,15.8,62.3,0.84
CpG: 21,chr3,89316505,89316748,243,21,149,17.3,61.3,0.92
CpG: 165,chr3,89319627,89322016,2389,165,1472,13.8,61.6,0.73
CpG: 24,chr3,89322861,89323083,222,24,158,21.6,71.2,0.94
CpG: 41,chr3,89337635,89338011,376,41,278,21.8,73.9,0.8
CpG: 57,chr3,89349821,89350487,666,57,411,17.1,61.7,0.9
CpG: 60,chr3,89391872,89392672,800,60,544,15,68,0.65
CpG: 16,chr3,89393042,89393245,203,16,145,15.8,71.4,0.62
CpG: 30,chr3,89396134,89396451,317,30,221,18.9,69.7,0.85
CpG: 32,chr3,89418026,89418350,324,32,199,19.8,61.4,1.13
CpG: 53,chr3,89430159,89430653,494,53,357,21.5,72.3,0.82
CpG: 74,chr3,89715009,89715697,688,74,477,21.5,69.3,0.91
CpG: 26,chr3,89764398,89764652,254,26,178,20.5,70.1,0.84
CpG: 95,chr3,89773101,89774061,960,95,538,19.8,56,1.27
CpG: 112,chr3,89830950,89831920,970,112,650,23.1,67,1.03
CpG: 69,chr3,89912795,89913379,584,69,407,23.6,69.7,0.97
CpG: 43,chr3,89960329,89960805,476,43,332,18.1,69.7,0.76
CpG: 35,chr3,89963072,89963478,406,35,237,17.2,58.4,1.01
CpG: 81,chr3,90052048,90053111,1063,81,566,15.2,53.2,1.08
CpG: 74,chr3,90079538,90080448,910,74,589,16.3,64.7,0.78
CpG: 42,chr3,90213380,90213814,434,42,259,19.4,59.7,1.09
CpG: 16,chr3,90220723,90220949,226,16,150,14.2,66.4,0.65
CpG: 50,chr3,90231496,90231997,501,50,331,20,66.1,0.92
CpG: 32,chr3,90247994,90248423,429,32,244,14.9,56.9,0.93
CpG: 52,chr3,90254061,90254689,628,52,366,16.6,58.3,1.01
CpG: 69,chr3,90265112,90265940,828,69,504,16.7,60.9,0.9
CpG: 16,chr3,90292740,90292961,221,16,123,14.5,55.7,0.94
CpG: 20,chr3,90293709,90293943,234,20,147,17.1,62.8,0.96
CpG: 93,chr3,90389127,90390045,918,93,610,20.3,66.4,0.92
CpG: 46,chr3,90433355,90433800,445,46,295,20.7,66.3,0.96
CpG: 145,chr3,90464746,90466177,1431,145,926,20.3,64.7,0.97
CpG: 35,chr3,90476089,90476537,448,35,284,15.6,63.4,0.84
CpG: 29,chr3,90490806,90491054,248,29,182,23.4,73.4,0.88
CpG: 46,chr3,90509190,90509669,479,46,306,19.2,63.9,0.94
CpG: 32,chr3,92024518,92025003,485,32,292,13.2,60.2,0.75
CpG: 328,chr3,93443613,93447951,4338,328,2555,15.1,58.9,0.92
CpG: 15,chr3,93520766,93520982,216,15,134,13.9,62,0.73
CpG: 27,chr3,93555092,93555367,275,27,192,19.6,69.8,0.83
CpG: 35,chr3,94309980,94310342,362,35,237,19.3,65.5,0.91
CpG: 112,chr3,94363448,94364383,935,112,691,24,73.9,0.88
CpG: 82,chr3,94412490,94413511,1021,82,644,16.1,63.1,0.82
CpG: 52,chr3,94443183,94443771,588,52,392,17.7,66.7,0.8
CpG: 64,chr3,94582109,94582734,625,64,387,20.5,61.9,1.07
CpG: 23,chr3,94604510,94604848,338,23,185,13.6,54.7,0.91
CpG: 68,chr3,94658340,94659011,671,68,439,20.3,65.4,0.95
CpG: 67,chr3,94757650,94758321,671,67,438,20,65.3,0.94
CpG: 18,chr3,94779211,94779426,215,18,133,16.7,61.9,0.88
CpG: 52,chr3,94786305,94786988,683,52,432,15.2,63.3,0.78
CpG: 91,chr3,94837330,94838318,988,91,542,18.4,54.9,1.23
CpG: 49,chr3,94886480,94886958,478,49,311,20.5,65.1,0.97
CpG: 33,chr3,94954070,94954498,428,33,278,15.4,65,0.75
CpG: 97,chr3,95014806,95016246,1440,97,881,13.5,61.2,0.72
CpG: 28,chr3,95042335,95042656,321,28,214,17.4,66.7,0.85
CpG: 48,chr3,95106348,95107016,668,48,412,14.4,61.7,0.78
CpG: 24,chr3,95140179,95140481,302,24,181,15.9,59.9,0.89
CpG: 91,chr3,95160311,95161596,1285,91,821,14.2,63.9,0.69
CpG: 158,chr3,95172327,95173803,1476,158,1046,21.4,70.9,0.87
CpG: 46,chr3,95217487,95218104,617,46,367,14.9,59.5,0.84
CpG: 53,chr3,95228619,95229041,422,53,291,25.1,69,1.06
CpG: 43,chr3,95281294,95281823,529,43,347,16.3,65.6,0.76
CpG: 29,chr3,95283299,95283576,277,29,191,20.9,69,0.88
CpG: 72,chr3,95315012,95315693,681,72,487,21.1,71.5,0.85
CpG: 51,chr3,95356816,95357319,503,51,350,20.3,69.6,0.88
CpG: 35,chr3,95427634,95427943,309,35,228,22.7,73.8,0.99
CpG: 30,chr3,95434343,95434705,362,30,250,16.6,69.1,0.72
CpG: 20,chr3,95559526,95559728,202,20,135,19.8,66.8,0.89
CpG: 122,chr3,95658487,95659477,990,122,650,24.6,65.7,1.14
CpG: 28,chr3,95687798,95688032,234,28,177,23.9,75.6,0.87
CpG: 97,chr3,95818652,95819902,1250,97,725,15.5,58,0.92
CpG: 38,chr3,95855674,95856024,350,38,209,21.7,59.7,1.25
CpG: 33,chr3,95871360,95871699,339,33,218,19.5,64.3,0.95
CpG: 84,chr3,95881904,95882938,1034,84,655,16.2,63.3,0.82
CpG: 34,chr3,95893949,95894316,367,34,247,18.5,67.3,0.82
CpG: 121,chr3,95929201,95930411,1210,121,764,20,63.1,1.03
CpG: 48,chr3,95950720,95951382,662,48,390,14.5,58.9,0.84
CpG: 94,chr3,95995451,95996253,802,94,499,23.4,62.2,1.21
CpG: 24,chr3,96057861,96058132,271,24,166,17.7,61.3,0.94
CpG: 58,chr3,96104273,96104902,629,58,362,18.4,57.6,1.12
CpG: 43,chr3,96172146,96172774,628,43,365,13.7,58.1,0.82
CpG: 65,chr3,96196942,96197675,733,65,456,17.7,62.2,0.92
CpG: 84,chr3,96219948,96220811,863,84,531,19.5,61.5,1.03
CpG: 22,chr3,96221316,96221570,254,22,151,17.3,59.4,0.98
CpG: 209,chr3,96238527,96240550,2023,209,1295,20.7,64,1.01
CpG: 201,chr3,96245231,96247299,2068,201,1251,19.4,60.5,1.06
CpG: 31,chr3,96262983,96263260,277,31,179,22.4,64.6,1.08
CpG: 54,chr3,96268667,96269107,440,54,301,24.5,68.4,1.05
CpG: 33,chr3,96269676,96270106,430,33,238,15.3,55.3,1
CpG: 43,chr3,96277934,96278548,614,43,362,14,59,0.81
CpG: 37,chr3,96328139,96328414,275,37,191,26.9,69.5,1.28
CpG: 27,chr3,96360131,96360370,239,27,154,22.6,64.4,1.19
CpG: 27,chr3,96373767,96374006,239,27,154,22.6,64.4,1.19
CpG: 32,chr3,96401869,96402183,314,32,203,20.4,64.6,0.98
CpG: 23,chr3,96404435,96404653,218,23,146,21.1,67,0.95
CpG: 36,chr3,96414572,96414904,332,36,218,21.7,65.7,1.01
CpG: 56,chr3,96449897,96450435,538,56,367,20.8,68.2,0.95
CpG: 115,chr3,96451177,96452488,1311,115,763,17.5,58.2,1.04
CpG: 115,chr3,96458147,96459458,1311,115,763,17.5,58.2,1.04
CpG: 56,chr3,96460199,96460737,538,56,367,20.8,68.2,0.95
CpG: 38,chr3,96474858,96475267,409,38,266,18.6,65,0.89
CpG: 47,chr3,96486729,96487128,399,47,275,23.6,68.9,1.08
CpG: 47,chr3,96488319,96488718,399,47,275,23.6,68.9,1.08
CpG: 24,chr3,96557677,96557953,276,24,190,17.4,68.8,0.74
CpG: 25,chr3,96593996,96594283,287,25,179,17.4,62.4,0.9
CpG: 99,chr3,96597431,96598815,1384,99,875,14.3,63.2,0.72
CpG: 25,chr3,96601046,96601299,253,25,183,19.8,72.3,0.76
CpG: 23,chr3,96629788,96630052,264,23,152,17.4,57.6,1.1
CpG: 46,chr3,96635355,96635811,456,46,311,20.2,68.2,0.87
CpG: 26,chr3,96670062,96670418,356,26,230,14.6,64.6,0.72
CpG: 27,chr3,96684839,96685103,264,27,178,20.5,67.4,0.94
CpG: 91,chr3,96696310,96697463,1153,91,716,15.8,62.1,0.82
CpG: 27,chr3,96708345,96708616,271,27,189,19.9,69.7,0.82
CpG: 79,chr3,96727457,96728141,684,79,482,23.1,70.5,0.93
CpG: 45,chr3,96904773,96905377,604,45,394,14.9,65.2,0.7
CpG: 56,chr3,97158586,97159427,841,56,522,13.3,62.1,0.69
CpG: 19,chr3,97227607,97227810,203,19,122,18.7,60.1,1.19
CpG: 49,chr3,97609900,97610306,406,49,266,24.1,65.5,1.13
CpG: 74,chr3,97658047,97658795,748,74,504,19.8,67.4,0.89
CpG: 21,chr3,97751682,97751934,252,21,156,16.7,61.9,0.91
CpG: 28,chr3,97767843,97768145,302,28,199,18.5,65.9,0.86
CpG: 43,chr3,97867932,97868364,432,43,299,19.9,69.2,0.83
CpG: 35,chr3,97888441,97888854,413,35,284,16.9,68.8,0.72
CpG: 35,chr3,97901108,97901529,421,35,265,16.6,62.9,0.85
CpG: 98,chr3,98013308,98014020,712,98,522,27.5,73.3,1.03
CpG: 25,chr3,98339180,98339487,307,25,206,16.3,67.1,0.72
CpG: 35,chr3,98382202,98382616,414,35,278,16.9,67.1,0.75
CpG: 123,chr3,98427375,98428664,1289,123,806,19.1,62.5,0.98
CpG: 52,chr3,99140955,99141669,714,52,415,14.6,58.1,0.87
CpG: 47,chr3,99240888,99241581,693,47,401,13.6,57.9,0.81
CpG: 60,chr3,99253630,99254149,519,60,363,23.1,69.9,0.96
CpG: 73,chr3,100162159,100162886,727,73,489,20.1,67.3,0.89
CpG: 106,chr3,100488362,100489724,1362,106,798,15.6,58.6,0.91
CpG: 163,chr3,100685026,100686314,1288,163,878,25.3,68.2,1.09
CpG: 42,chr3,100921999,100922560,561,42,353,15,62.9,0.76
CpG: 27,chr3,100969403,100969705,302,27,191,17.9,63.2,0.9
CpG: 19,chr3,101077154,101077373,219,19,141,17.4,64.4,0.85
CpG: 16,chr3,101080279,101080488,209,16,136,15.3,65.1,0.74
CpG: 99,chr3,101109652,101110725,1073,99,627,18.5,58.4,1.1
CpG: 92,chr3,101376810,101377563,753,92,504,24.4,66.9,1.1
CpG: 22,chr3,101450979,101451186,207,22,134,21.3,64.7,1.02
CpG: 104,chr3,101604018,101605202,1184,104,766,17.6,64.7,0.84
CpG: 54,chr3,101924084,101924625,541,54,295,20,54.5,1.35
CpG: 111,chr3,102011670,102013119,1449,111,919,15.3,63.4,0.77
CpG: 95,chr3,102203760,102204765,1005,95,682,18.9,67.9,0.83
CpG: 37,chr3,102469923,102470379,456,37,290,16.2,63.6,0.83
CpG: 60,chr3,102734705,102735518,813,60,509,14.8,62.6,0.76
CpG: 82,chr3,102935374,102936230,856,82,572,19.2,66.8,0.86
CpG: 53,chr3,102995674,102996030,356,53,259,29.8,72.8,1.15
CpG: 68,chr3,103020324,103021122,798,68,503,17,63,0.88
CpG: 30,chr3,103058217,103058519,302,30,208,19.9,68.9,0.88
CpG: 69,chr3,103102395,103103064,669,69,461,20.6,68.9,0.91
CpG: 40,chr3,103171645,103171985,340,40,225,23.5,66.2,1.1
CpG: 129,chr3,103279249,103280584,1335,129,777,19.3,58.2,1.14
CpG: 112,chr3,103575178,103576605,1427,112,965,15.7,67.6,0.69
CpG: 71,chr3,103790817,103791566,749,71,436,19,58.2,1.12
CpG: 93,chr3,103914157,103915120,963,93,587,19.3,61,1.05
CpG: 85,chr3,103968016,103968848,832,85,582,20.4,70,0.84
CpG: 72,chr3,104511415,104512158,743,72,501,19.4,67.4,0.85
CpG: 139,chr3,104638095,104639440,1345,139,897,20.7,66.7,0.93
CpG: 25,chr3,104752976,104753297,321,25,176,15.6,54.8,1.04
CpG: 22,chr3,104758452,104758704,252,22,164,17.5,65.1,0.83
CpG: 82,chr3,104780765,104781874,1109,82,724,14.8,65.3,0.7
CpG: 47,chr3,104788640,104789199,559,47,399,16.8,71.4,0.66
CpG: 59,chr3,104817628,104818139,511,59,369,23.1,72.2,0.89
CpG: 80,chr3,104864279,104865337,1058,80,680,15.1,64.3,0.73
CpG: 108,chr3,104961365,104962508,1143,108,780,18.9,68.2,0.81
CpG: 42,chr3,104967849,104968183,334,42,244,25.1,73.1,0.96
CpG: 39,chr3,105052675,105053071,396,39,275,19.7,69.4,0.85
CpG: 105,chr3,105452012,105453070,1058,105,706,19.8,66.7,0.89
CpG: 25,chr3,105458909,105459252,343,25,190,14.6,55.4,0.95
CpG: 114,chr3,105687017,105688004,987,114,664,23.1,67.3,1.02
CpG: 23,chr3,105704506,105704767,261,23,170,17.6,65.1,0.85
CpG: 25,chr3,105705194,105705526,332,25,242,15.1,72.9,0.61
CpG: 61,chr3,105800761,105801430,669,61,355,18.2,53.1,1.3
CpG: 82,chr3,105958874,105959817,943,82,602,17.4,63.8,0.85
CpG: 38,chr3,106482394,106482814,420,38,299,18.1,71.2,0.73
CpG: 81,chr3,106547325,106548175,850,81,565,19.1,66.5,0.87
CpG: 59,chr3,106721605,106722498,893,59,525,13.2,58.8,0.78
CpG: 124,chr3,107035842,107037127,1285,124,810,19.3,63,0.98
CpG: 79,chr3,107101479,107102556,1077,79,690,14.7,64.1,0.72
CpG: 52,chr3,107278925,107279432,507,52,317,20.5,62.5,1.09
CpG: 180,chr3,107331962,107334117,2155,180,1299,16.7,60.3,0.93
CpG: 16,chr3,107343037,107343254,217,16,133,14.7,61.3,0.83
CpG: 199,chr3,107458206,107460358,2152,199,1420,18.5,66,0.85
CpG: 108,chr3,107517115,107518107,992,108,679,21.8,68.4,0.93
CpG: 57,chr3,107582745,107583305,560,57,333,20.4,59.5,1.16
CpG: 151,chr3,107595121,107597090,1969,151,1229,15.3,62.4,0.79
CpG: 54,chr3,107631235,107631804,569,54,400,19,70.3,0.77
CpG: 68,chr3,107695898,107696722,824,68,466,16.5,56.6,1.04
CpG: 24,chr3,107760064,107760286,222,24,156,21.6,70.3,0.88
CpG: 37,chr3,107895765,107896270,505,37,326,14.7,64.6,0.72
CpG: 42,chr3,108086240,108086696,456,42,305,18.4,66.9,0.82
CpG: 49,chr3,108145798,108146286,488,49,333,20.1,68.2,0.87
CpG: 56,chr3,108186153,108186736,583,56,337,19.2,57.8,1.15
CpG: 37,chr3,108200467,108200961,494,37,333,15,67.4,0.67
CpG: 60,chr3,108210145,108210908,763,60,463,15.7,60.7,0.86
CpG: 84,chr3,108225838,108226768,930,84,608,18.1,65.4,0.85
CpG: 28,chr3,108239707,108239993,286,28,177,19.6,61.9,1.02
CpG: 71,chr3,108256774,108257574,800,71,480,17.8,60,0.99
CpG: 54,chr3,108283674,108284297,623,54,392,17.3,62.9,0.88
CpG: 29,chr3,108383593,108383950,357,29,223,16.2,62.5,0.83
CpG: 24,chr3,108406845,108407086,241,24,155,19.9,64.3,1
CpG: 21,chr3,108412815,108413074,259,21,154,16.2,59.5,0.92
CpG: 26,chr3,108414221,108414553,332,26,210,15.7,63.3,0.78
CpG: 86,chr3,108415472,108416111,639,86,457,26.9,71.5,1.08
CpG: 38,chr3,108444759,108445272,513,38,323,14.8,63,0.75
CpG: 36,chr3,108554158,108554511,353,36,232,20.4,65.7,0.95
CpG: 42,chr3,108562164,108562572,408,42,271,20.6,66.4,0.94
CpG: 23,chr3,108571613,108571862,249,23,159,18.5,63.9,0.91
CpG: 91,chr3,108591198,108592217,1019,91,699,17.9,68.6,0.76
CpG: 46,chr3,108653880,108654230,350,46,245,26.3,70,1.08
CpG: 59,chr3,108721738,108722412,674,59,440,17.5,65.3,0.83
CpG: 55,chr3,108839984,108840658,674,55,452,16.3,67.1,0.73
CpG: 80,chr3,108911102,108911874,772,80,509,20.7,65.9,0.96
CpG: 41,chr3,108940042,108940443,401,41,277,20.4,69.1,0.86
CpG: 88,chr3,109026972,109027815,843,88,521,20.9,61.8,1.09
CpG: 35,chr3,109123111,109123423,312,35,225,22.4,72.1,0.86
CpG: 76,chr3,109340495,109341153,658,76,440,23.1,66.9,1.04
CpG: 19,chr3,110142276,110142510,234,19,154,16.2,65.8,0.76
CpG: 84,chr3,110142690,110143902,1212,84,630,13.9,52,1.03
CpG: 115,chr3,110249889,110251074,1185,115,788,19.4,66.5,0.88
CpG: 60,chr3,113629646,113630274,628,60,381,19.1,60.7,1.04
CpG: 25,chr3,115714651,115714922,271,25,179,18.5,66.1,0.88
CpG: 27,chr3,115887836,115888172,336,27,215,16.1,64,0.79
CpG: 58,chr3,116007224,116007852,628,58,410,18.5,65.3,0.87
CpG: 119,chr3,116251523,116252709,1186,119,808,20.1,68.1,0.87
CpG: 32,chr3,116347639,116348031,392,32,212,16.3,54.1,1.13
CpG: 67,chr3,116423201,116423957,756,67,511,17.7,67.6,0.78
CpG: 47,chr3,116507758,116508231,473,47,330,19.9,69.8,0.82
CpG: 80,chr3,116594493,116595423,930,80,578,17.2,62.2,0.89
CpG: 107,chr3,116661939,116662745,806,107,599,26.6,74.3,0.96
CpG: 81,chr3,116711732,116712422,690,81,501,23.5,72.6,0.93
CpG: 51,chr3,116807932,116808331,399,51,293,25.6,73.4,0.97
CpG: 29,chr3,117360092,117360314,222,29,166,26.1,74.8,0.98
CpG: 60,chr3,117575283,117575923,640,60,396,18.8,61.9,0.98
CpG: 38,chr3,117868763,117869041,278,38,215,27.3,77.3,0.96
CpG: 106,chr3,119782567,119783431,864,106,601,24.5,69.6,1.02
CpG: 98,chr3,121262507,121263239,732,98,527,26.8,72,1.04
CpG: 36,chr3,121291628,121292123,495,36,280,14.5,56.6,0.92
CpG: 141,chr3,121425984,121427506,1522,141,1003,18.5,65.9,0.86
CpG: 29,chr3,121532087,121532457,370,29,253,15.7,68.4,0.68
CpG: 65,chr3,121723318,121723846,528,65,377,24.6,71.4,0.97
CpG: 20,chr3,121770881,121771088,207,20,118,19.3,57,1.23
CpG: 98,chr3,121814661,121815543,882,98,560,22.2,63.5,1.1
CpG: 62,chr3,121953293,121953816,523,62,378,23.7,72.3,0.92
CpG: 97,chr3,122245258,122246270,1012,97,578,19.2,57.1,1.18
CpG: 62,chr3,122274119,122274814,695,62,455,17.8,65.5,0.83
CpG: 134,chr3,122293047,122293957,910,134,684,29.5,75.2,1.04
CpG: 45,chr3,122419854,122420233,379,45,270,23.7,71.2,0.94
CpG: 165,chr3,122618454,122620244,1790,165,1076,18.4,60.1,1.03
CpG: 166,chr3,122728915,122730767,1852,166,1232,17.9,66.5,0.81
CpG: 42,chr3,122924118,122924520,402,42,238,20.9,59.2,1.29
CpG: 117,chr3,122983891,122985018,1127,117,736,20.8,65.3,0.98
CpG: 63,chr3,123267163,123268114,951,63,539,13.2,56.7,0.84
CpG: 30,chr3,123385717,123386044,327,30,209,18.3,63.9,0.95
CpG: 80,chr3,123446778,123447566,788,80,544,20.3,69,0.85
CpG: 76,chr3,123508115,123508911,796,76,494,19.1,62.1,1
CpG: 41,chr3,123690706,123691099,393,41,263,20.9,66.9,0.94
CpG: 49,chr3,124320926,124321391,465,49,313,21.1,67.3,0.94
CpG: 129,chr3,125937825,125939109,1284,129,794,20.1,61.8,1.06
CpG: 20,chr3,126363780,126364050,270,20,177,14.8,65.6,0.7
CpG: 116,chr3,126596603,126597611,1008,116,722,23,71.6,0.9
CpG: 80,chr3,127498423,127499274,851,80,585,18.8,68.7,0.8
CpG: 73,chr3,127552972,127553685,713,73,459,20.5,64.4,0.99
CpG: 34,chr3,127625359,127625692,333,34,236,20.4,70.9,0.82
CpG: 177,chr3,127632486,127634503,2017,177,1190,17.6,59,1.01
CpG: 34,chr3,127695407,127695763,356,34,243,19.1,68.3,0.85
CpG: 29,chr3,127789835,127790096,261,29,187,22.2,71.6,0.87
CpG: 18,chr3,127790645,127790863,218,18,141,16.5,64.7,0.84
CpG: 88,chr3,127837070,127837845,775,88,491,22.7,63.4,1.14
CpG: 49,chr3,129199724,129200373,649,49,370,15.1,57,0.94
CpG: 35,chr3,129204341,129204673,332,35,229,21.1,69,0.89
CpG: 93,chr3,129213790,129214994,1204,93,777,15.4,64.5,0.74
CpG: 36,chr3,129215678,129216190,512,36,321,14.1,62.7,0.72
CpG: 31,chr3,129218629,129218932,303,31,194,20.5,64,1.01
CpG: 72,chr3,129533652,129534280,628,72,464,22.9,73.9,0.84
CpG: 104,chr3,129830644,129831662,1018,104,635,20.4,62.4,1.08
CpG: 51,chr3,129878501,129879061,560,51,343,18.2,61.2,1
CpG: 28,chr3,129901406,129901709,303,28,204,18.5,67.3,0.88
CpG: 50,chr3,129969698,129970195,497,50,352,20.1,70.8,0.82
CpG: 113,chr3,130060205,130061087,882,113,634,25.6,71.9,1
CpG: 23,chr3,130068396,130068610,214,23,136,21.5,63.6,1.07
CpG: 66,chr3,130180706,130181597,891,66,551,14.8,61.8,0.78
CpG: 34,chr3,130709097,130709460,363,34,234,18.7,64.5,0.9
CpG: 83,chr3,130729866,130730551,685,83,453,24.2,66.1,1.11
CpG: 57,chr3,131106087,131106791,704,57,421,16.2,59.8,0.91
CpG: 196,chr3,131110256,131112543,2287,196,1418,17.1,62,0.9
CpG: 44,chr3,131271705,131272121,416,44,275,21.2,66.1,0.97
CpG: 71,chr3,131302583,131303345,762,71,508,18.6,66.7,0.84
CpG: 89,chr3,131489964,131490876,912,89,587,19.5,64.4,0.95
CpG: 61,chr3,131564555,131565228,673,61,441,18.1,65.5,0.85
CpG: 32,chr3,132085624,132086089,465,32,284,13.8,61.1,0.74
CpG: 32,chr3,132684076,132684352,276,32,194,23.2,70.3,0.95
CpG: 70,chr3,132949461,132950223,762,70,496,18.4,65.1,0.87
CpG: 46,chr3,133091771,133092236,465,46,307,19.8,66,0.92
CpG: 74,chr3,133310038,133310636,598,74,380,24.7,63.5,1.23
CpG: 115,chr3,133544178,133545117,939,115,689,24.5,73.4,0.92
CpG: 31,chr3,134235994,134236297,303,31,180,20.5,59.4,1.16
CpG: 29,chr3,134829264,134829633,369,29,230,15.7,62.3,0.81
CpG: 40,chr3,135212474,135212868,394,40,261,20.3,66.2,0.93
CpG: 70,chr3,135422919,135423611,692,70,393,20.2,56.8,1.26
CpG: 176,chr3,135437832,135439788,1956,176,1205,18,61.6,0.95
CpG: 44,chr3,135485253,135485846,593,44,380,14.8,64.1,0.73
CpG: 84,chr3,135690883,135691635,752,84,485,22.3,64.5,1.08
CpG: 32,chr3,135826329,135826632,303,32,223,21.1,73.6,0.78
CpG: 169,chr3,136669471,136671682,2211,169,1216,15.3,55,1.01
CpG: 27,chr3,137623639,137623919,280,27,197,19.3,70.4,0.81
CpG: 142,chr3,137864037,137865781,1744,142,959,16.3,55,1.08
CpG: 55,chr3,137867581,137868040,459,55,277,24,60.3,1.32
CpG: 25,chr3,137918408,137918684,276,25,160,18.1,58,1.08
CpG: 84,chr3,138143237,138144135,898,84,555,18.7,61.8,0.98
CpG: 84,chr3,138442658,138443447,789,84,521,21.3,66,0.98
CpG: 99,chr3,138488935,138489828,893,99,618,22.2,69.2,0.93
CpG: 122,chr3,138526990,138528136,1146,122,708,21.3,61.8,1.12
CpG: 114,chr3,138742008,138743188,1180,114,717,19.3,60.8,1.06
CpG: 155,chr3,139074471,139075968,1497,155,936,20.7,62.5,1.06
CpG: 48,chr3,139205481,139205959,478,48,320,20.1,66.9,0.9
CpG: 39,chr3,141211320,141211889,569,39,325,13.7,57.1,0.84
CpG: 87,chr3,141464867,141465750,883,87,620,19.7,70.2,0.8
CpG: 63,chr3,142168883,142169575,692,63,451,18.2,65.2,0.88
CpG: 79,chr3,142395069,142395774,705,79,485,22.4,68.8,0.98
CpG: 22,chr3,142701092,142701302,210,22,138,21,65.7,1
CpG: 57,chr3,142765070,142765593,523,57,336,21.8,64.2,1.06
CpG: 151,chr3,142881150,142882528,1378,151,916,21.9,66.5,0.99
CpG: 42,chr3,143100780,143101147,367,42,230,22.9,62.7,1.18
CpG: 44,chr3,144198566,144198938,372,44,265,23.7,71.2,0.93
CpG: 42,chr3,144201950,144202443,493,42,305,17,61.9,0.89
CpG: 118,chr3,144204596,144205861,1265,118,770,18.7,60.9,1.01
CpG: 140,chr3,144569538,144570979,1441,140,968,19.4,67.2,0.86
CpG: 89,chr3,144719647,144720452,805,89,477,22.1,59.3,1.26
CpG: 55,chr3,145118468,145119062,594,55,405,18.5,68.2,0.8
CpG: 30,chr3,145576144,145576448,304,30,192,19.7,63.2,1.03
CpG: 65,chr3,145649314,145650059,745,65,477,17.4,64,0.86
CpG: 51,chr3,145653292,145653814,522,51,356,19.5,68.2,0.84
CpG: 77,chr3,145758684,145759279,595,77,427,25.9,71.8,1.01
CpG: 79,chr3,145924001,145924994,993,79,596,15.9,60,0.89
CpG: 69,chr3,145937926,145938585,659,69,399,20.9,60.5,1.14
CpG: 160,chr3,145987645,145988894,1249,160,906,25.6,72.5,0.98
CpG: 46,chr3,146149793,146150308,515,46,340,17.9,66,0.82
CpG: 65,chr3,146220813,146221423,610,65,398,21.3,65.2,1
CpG: 18,chr3,146284737,146285009,272,18,164,13.2,60.3,0.74
CpG: 86,chr3,146404405,146405065,660,86,480,26.1,72.7,1.03
CpG: 23,chr3,146450386,146450652,266,23,179,17.3,67.3,0.8
CpG: 124,chr3,146499302,146500456,1154,124,727,21.5,63,1.08
CpG: 16,chr3,146520825,146521027,202,16,137,15.8,67.8,0.69
CpG: 37,chr3,146521157,146521490,333,37,206,22.2,61.9,1.18
CpG: 44,chr3,146684995,146685549,554,44,351,15.9,63.4,0.8
CpG: 104,chr3,146812356,146813365,1009,104,685,20.6,67.9,0.89
CpG: 28,chr3,148817472,148817845,373,28,216,15,57.9,0.9
CpG: 27,chr3,148819606,148819951,345,27,192,15.7,55.7,1.01
CpG: 265,chr3,148987630,148990644,3014,265,1941,17.6,64.4,0.85
CpG: 40,chr3,152165649,152166033,384,40,267,20.8,69.5,0.86
CpG: 172,chr3,152209685,152211169,1484,172,982,23.2,66.2,1.06
CpG: 47,chr3,152265393,152265931,538,47,328,17.5,61,0.97
CpG: 44,chr3,152340151,152340487,336,44,252,26.2,75,0.94
CpG: 68,chr3,152346360,152346991,631,68,371,21.6,58.8,1.26
CpG: 116,chr3,152395702,152396851,1149,116,649,20.2,56.5,1.28
CpG: 52,chr3,152486104,152486705,601,52,420,17.3,69.9,0.73
CpG: 68,chr3,152667613,152668191,578,68,414,23.5,71.6,0.92
CpG: 43,chr3,152714056,152714603,547,43,356,15.7,65.1,0.74
CpG: 49,chr3,153724731,153725246,515,49,361,19,70.1,0.79
CpG: 44,chr3,153905619,153906071,452,44,289,19.5,63.9,0.95
CpG: 53,chr3,153912667,153913128,461,53,322,23,69.8,0.96
CpG: 31,chr3,153944252,153944586,334,31,240,18.6,71.9,0.72
CpG: 56,chr3,153973329,153973741,412,56,314,27.2,76.2,0.96
CpG: 78,chr3,154328064,154328820,756,78,514,20.6,68,0.89
CpG: 53,chr3,154329302,154330035,733,53,433,14.5,59.1,0.85
CpG: 51,chr3,154596628,154597204,576,51,371,17.7,64.4,0.86
CpG: 37,chr3,155093198,155093621,423,37,255,17.5,60.3,0.97
CpG: 24,chr3,156560893,156561148,255,24,159,18.8,62.4,1.03
CpG: 70,chr3,156561486,156562366,880,70,550,15.9,62.5,0.82
CpG: 92,chr3,157534040,157534824,784,92,540,23.5,68.9,0.99
CpG: 108,chr3,157566761,157567839,1078,108,740,20,68.6,0.85
CpG: 115,chr3,157946941,157948090,1149,115,726,20,63.2,1
CpG: 65,chr3,158031331,158031830,499,65,358,26.1,71.7,1.02
CpG: 57,chr3,158036299,158036934,635,57,412,18,64.9,0.85
CpG: 75,chr3,158561302,158562304,1002,75,647,15,64.6,0.72
CpG: 60,chr4,136052619,136053349,730,60,458,16.4,62.7,0.85
CpG: 29,chr4,3230990,3231230,240,29,178,24.2,74.2,0.89
CpG: 57,chr4,3574584,3575142,558,57,356,20.4,63.8,1
CpG: 66,chr4,3678102,3678705,603,66,422,21.9,70,0.9
CpG: 87,chr4,3835054,3835814,760,87,497,22.9,65.4,1.07
CpG: 38,chr4,3874952,3875274,322,38,222,23.6,68.9,0.99
CpG: 136,chr4,3937509,3939319,1810,136,1026,15,56.7,0.95
CpG: 60,chr4,4138424,4138985,561,60,376,21.4,67,0.96
CpG: 84,chr4,4792494,4793432,938,84,591,17.9,63,0.91
CpG: 61,chr4,5644083,5644644,561,61,419,21.7,74.7,0.78
CpG: 40,chr4,6190924,6191271,347,40,252,23.1,72.6,0.89
CpG: 53,chr4,6365530,6365937,407,53,307,26,75.4,0.98
CpG: 73,chr4,6453533,6454363,830,73,464,17.6,55.9,1.13
CpG: 87,chr4,6990149,6991184,1035,87,597,16.8,57.7,1.01
CpG: 32,chr4,8238808,8239111,303,32,189,21.1,62.4,1.09
CpG: 99,chr4,8535470,8536325,855,99,561,23.2,65.6,1.08
CpG: 84,chr4,8647022,8647758,736,84,499,22.8,67.8,0.99
CpG: 226,chr4,8690003,8692237,2234,226,1220,20.2,54.6,1.38
CpG: 21,chr4,8751762,8752020,258,21,174,16.3,67.4,0.72
CpG: 28,chr4,8816961,8817396,435,28,266,12.9,61.1,0.71
CpG: 45,chr4,8911252,8911702,450,45,330,20,73.3,0.75
CpG: 16,chr4,8922101,8922303,202,16,123,15.8,60.9,0.86
CpG: 71,chr4,9668611,9669416,805,71,498,17.6,61.9,0.92
CpG: 74,chr4,9843944,9844772,828,74,589,17.9,71.1,0.72
CpG: 59,chr4,9859435,9860095,660,59,447,17.9,67.7,0.78
CpG: 85,chr4,10874291,10875069,778,85,517,21.9,66.5,0.99
CpG: 121,chr4,11007046,11008230,1184,121,728,20.4,61.5,1.1
CpG: 40,chr4,11075880,11076272,392,40,280,20.4,71.4,0.8
CpG: 66,chr4,11156138,11156762,624,66,424,21.2,67.9,0.92
CpG: 161,chr4,11190408,11191788,1380,161,940,23.3,68.1,1.01
CpG: 57,chr4,11253680,11254312,632,57,372,18,58.9,1.05
CpG: 54,chr4,11321721,11322311,590,54,372,18.3,63.1,0.97
CpG: 29,chr4,11385344,11385695,351,29,240,16.5,68.4,0.71
CpG: 110,chr4,11387026,11388595,1569,110,963,14,61.4,0.75
CpG: 58,chr4,11485725,11486328,603,58,392,19.2,65,0.91
CpG: 41,chr4,11558866,11559184,318,41,246,25.8,77.4,0.92
CpG: 108,chr4,11965884,11966967,1083,108,689,19.9,63.6,0.99
CpG: 16,chr4,12087725,12087930,205,16,124,15.6,60.5,0.89
CpG: 79,chr4,12089288,12090122,834,79,525,18.9,62.9,1
CpG: 71,chr4,12140246,12141000,754,71,475,18.8,63,0.99
CpG: 67,chr4,12171401,12171897,496,67,379,27,76.4,0.93
CpG: 29,chr4,12906838,12907238,400,29,274,14.5,68.5,0.62
CpG: 96,chr4,13742984,13743844,860,96,583,22.3,67.8,0.97
CpG: 44,chr4,14826344,14826743,399,44,268,22.1,67.2,0.98
CpG: 35,chr4,14864148,14864524,376,35,255,18.6,67.8,0.82
CpG: 66,chr4,14930314,14930968,654,66,355,20.2,54.3,1.37
CpG: 22,chr4,15148892,15149129,237,22,164,18.6,69.2,0.8
CpG: 120,chr4,15265511,15266706,1195,120,789,20.1,66,0.92
CpG: 39,chr4,15945147,15945621,474,39,313,16.5,66,0.76
CpG: 75,chr4,15957831,15958459,628,75,440,23.9,70.1,0.98
CpG: 97,chr4,16013507,16014274,767,97,561,25.3,73.1,0.95
CpG: 63,chr4,16163132,16163599,467,63,352,27,75.4,0.95
CpG: 28,chr4,17853331,17853559,228,28,163,24.6,71.5,0.98
CpG: 59,chr4,19569570,19570166,596,59,422,19.8,70.8,0.79
CpG: 47,chr4,19574983,19575450,467,47,316,20.1,67.7,0.88
CpG: 87,chr4,19708571,19709296,725,87,539,24,74.3,0.87
CpG: 64,chr4,20008266,20008787,521,64,378,24.6,72.6,0.94
CpG: 50,chr4,20041802,20042363,561,50,304,17.8,54.2,1.22
CpG: 59,chr4,20778001,20778605,604,59,415,19.5,68.7,0.83
CpG: 169,chr4,21678219,21679876,1657,169,1105,20.4,66.7,0.92
CpG: 32,chr4,21685576,21685856,280,32,193,22.9,68.9,0.97
CpG: 99,chr4,21688426,21689258,832,99,581,23.8,69.8,0.98
CpG: 29,chr4,21727555,21727838,283,29,187,20.5,66.1,0.94
CpG: 41,chr4,21776184,21776712,528,41,345,15.5,65.3,0.73
CpG: 58,chr4,21847928,21848554,626,58,377,18.5,60.2,1.05
CpG: 48,chr4,21879600,21880128,528,48,342,18.2,64.8,0.88
CpG: 67,chr4,21931069,21931603,534,67,379,25.1,71,1
CpG: 41,chr4,22357541,22357945,404,41,255,20.3,63.1,1.02
CpG: 24,chr4,22477512,22477757,245,24,168,19.6,68.6,0.85
CpG: 74,chr4,22487213,22488174,961,74,552,15.4,57.4,0.95
CpG: 76,chr4,22489463,22490548,1085,76,653,14,60.2,0.78
CpG: 18,chr4,22494892,22495125,233,18,158,15.5,67.8,0.7
CpG: 31,chr4,22498175,22498564,389,31,239,15.9,61.4,0.85
CpG: 21,chr4,23519115,23519334,219,21,162,19.2,74,0.77
CpG: 80,chr4,24496201,24496880,679,80,465,23.6,68.5,1.01
CpG: 48,chr4,24850856,24851200,344,48,255,27.9,74.1,1.03
CpG: 54,chr4,24897928,24898446,518,54,351,20.8,67.8,0.91
CpG: 67,chr4,24966384,24966909,525,67,361,25.5,68.8,1.08
CpG: 48,chr4,25281505,25281928,423,48,298,22.7,70.4,0.92
CpG: 27,chr4,25799588,25799814,226,27,165,23.9,73,0.92
CpG: 56,chr4,26346409,26346989,580,56,401,19.3,69.1,0.82
CpG: 213,chr4,28812868,28815750,2882,213,1674,14.8,58.1,0.88
CpG: 25,chr4,31937552,31937855,303,25,208,16.5,68.6,0.72
CpG: 113,chr4,31963386,31964438,1052,113,665,21.5,63.2,1.08
CpG: 179,chr4,32238406,32240295,1889,179,1173,19,62.1,0.99
CpG: 61,chr4,32615167,32615776,609,61,414,20,68,0.87
CpG: 64,chr4,32656954,32657532,578,64,373,22.1,64.5,1.06
CpG: 51,chr4,32799970,32800499,529,51,342,19.3,64.7,0.93
CpG: 66,chr4,32950491,32951079,588,66,407,22.4,69.2,0.95
CpG: 102,chr4,32983046,32984008,962,102,666,21.2,69.2,0.92
CpG: 151,chr4,33030828,33031959,1131,151,767,26.7,67.8,1.17
CpG: 113,chr4,33188856,33189680,824,113,580,27.4,70.4,1.11
CpG: 33,chr4,33209289,33209766,477,33,302,13.8,63.3,0.73
CpG: 141,chr4,33247482,33248746,1264,141,886,22.3,70.1,0.91
CpG: 50,chr4,33310153,33310655,502,50,347,19.9,69.1,0.87
CpG: 135,chr4,33923649,33924889,1240,135,862,21.8,69.5,0.91
CpG: 34,chr4,34049767,34050143,376,34,237,18.1,63,0.92
CpG: 58,chr4,34550434,34550905,471,58,324,24.6,68.8,1.04
CpG: 41,chr4,34614737,34615125,388,41,264,21.1,68,0.91
CpG: 58,chr4,34687020,34687476,456,58,342,25.4,75,0.9
CpG: 20,chr4,34716323,34716575,252,20,141,15.9,56,1.02
CpG: 29,chr4,34730084,34730315,231,29,165,25.1,71.4,1
CpG: 98,chr4,34882326,34883150,824,98,560,23.8,68,1.03
CpG: 43,chr4,34886675,34887068,393,43,290,21.9,73.8,0.8
CpG: 36,chr4,35157038,35157498,460,36,295,15.7,64.1,0.76
CpG: 51,chr4,35225353,35225820,467,51,337,21.8,72.2,0.85
CpG: 38,chr4,36950318,36950647,329,38,240,23.1,72.9,0.9
CpG: 28,chr4,36951345,36951711,366,28,243,15.3,66.4,0.7
CpG: 53,chr4,40143246,40143838,592,53,415,17.9,70.1,0.73
CpG: 48,chr4,40268291,40268700,409,48,293,23.5,71.6,0.93
CpG: 33,chr4,40269517,40269890,373,33,242,17.7,64.9,0.84
CpG: 33,chr4,40279112,40279475,363,33,243,18.2,66.9,0.83
CpG: 37,chr4,40473139,40473426,287,37,209,25.8,72.8,1.02
CpG: 25,chr4,40703052,40703371,319,25,184,15.7,57.7,0.96
CpG: 105,chr4,40722233,40723250,1017,105,715,20.6,70.3,0.84
CpG: 55,chr4,40757483,40758008,525,55,322,21,61.3,1.12
CpG: 106,chr4,40853510,40854604,1094,106,740,19.4,67.6,0.87
CpG: 79,chr4,40947952,40948731,779,79,518,20.3,66.5,0.93
CpG: 87,chr4,40970626,40971509,883,87,579,19.7,65.6,0.92
CpG: 30,chr4,41098028,41098306,278,30,192,21.6,69.1,0.9
CpG: 87,chr4,41135143,41136326,1183,87,648,14.7,54.8,0.98
CpG: 59,chr4,41275025,41275765,740,59,439,15.9,59.3,0.91
CpG: 58,chr4,41314333,41314990,657,58,399,17.7,60.7,0.96
CpG: 46,chr4,41348945,41349491,546,46,370,16.8,67.8,0.87
CpG: 56,chr4,41464556,41465299,743,56,450,15.1,60.6,0.82
CpG: 161,chr4,41497500,41499385,1885,161,1150,17.1,61,0.92
CpG: 28,chr4,41507017,41507326,309,28,201,18.1,65,0.87
CpG: 78,chr4,41568936,41569852,916,78,565,17,61.7,0.9
CpG: 32,chr4,41639925,41640240,315,32,169,20.3,53.7,1.44
CpG: 48,chr4,41683712,41684178,466,48,314,20.6,67.4,0.92
CpG: 21,chr4,41684719,41685006,287,21,183,14.6,63.8,0.72
CpG: 107,chr4,41695104,41696047,943,107,559,22.7,59.3,1.34
CpG: 46,chr4,41713321,41713777,456,46,301,20.2,66,0.93
CpG: 24,chr4,41722982,41723275,293,24,181,16.4,61.8,0.88
CpG: 39,chr4,41725709,41726228,519,39,341,15,65.7,0.7
CpG: 44,chr4,41731024,41731519,495,44,345,17.8,69.7,0.73
CpG: 59,chr4,41740724,41741402,678,59,438,17.4,64.6,0.85
CpG: 39,chr4,41755424,41755871,447,39,289,17.4,64.7,0.84
CpG: 46,chr4,41773153,41773799,646,46,381,14.2,59,0.82
CpG: 16,chr4,41881598,41881818,220,16,135,14.5,61.4,0.85
CpG: 44,chr4,41942040,41942590,550,44,375,16,68.2,0.72
CpG: 35,chr4,42054170,42054617,447,35,304,15.7,68,0.68
CpG: 42,chr4,42153842,42154412,570,42,337,14.7,59.1,0.86
CpG: 106,chr4,42172559,42173502,943,106,558,22.5,59.2,1.33
CpG: 35,chr4,42184695,42184961,266,35,180,26.3,67.7,1.15
CpG: 16,chr4,42230839,42231059,220,16,135,14.5,61.4,0.85
CpG: 44,chr4,42294270,42294820,550,44,375,16,68.2,0.72
CpG: 44,chr4,42439381,42439931,550,44,375,16,68.2,0.72
CpG: 35,chr4,42551496,42551943,447,35,304,15.7,68,0.68
CpG: 42,chr4,42651001,42651571,570,42,337,14.7,59.1,0.86
CpG: 106,chr4,42669718,42670661,943,106,558,22.5,59.2,1.33
CpG: 35,chr4,42681854,42682120,266,35,180,26.3,67.7,1.15
CpG: 41,chr4,42734568,42735139,571,41,383,14.4,67.1,0.67
CpG: 75,chr4,42916954,42917600,646,75,394,23.2,61,1.25
CpG: 57,chr4,42949720,42950369,649,57,431,17.6,66.4,0.81
CpG: 94,chr4,42999712,43000650,938,94,640,20,68.2,0.87
CpG: 27,chr4,43010203,43010566,363,27,235,14.9,64.7,0.71
CpG: 50,chr4,43030893,43031551,658,50,416,15.2,63.2,0.77
CpG: 82,chr4,43058854,43059515,661,82,465,24.8,70.3,1.01
CpG: 16,chr4,43371732,43371954,222,16,134,14.4,60.4,0.84
CpG: 73,chr4,43381789,43382341,552,73,423,26.4,76.6,0.9
CpG: 17,chr4,43416189,43416409,220,17,146,15.5,66.4,0.7
CpG: 117,chr4,43442128,43443684,1556,117,885,15,56.9,0.95
CpG: 70,chr4,43492789,43493730,941,70,551,14.9,58.6,0.87
CpG: 41,chr4,43499500,43499853,353,41,231,23.2,65.4,1.09
CpG: 83,chr4,43523272,43524543,1271,83,826,13.1,65,0.62
CpG: 64,chr4,43562057,43562784,727,64,468,17.6,64.4,0.85
CpG: 81,chr4,43578304,43579197,893,81,602,18.1,67.4,0.8
CpG: 42,chr4,43631356,43631799,443,42,276,19,62.3,0.98
CpG: 37,chr4,43656100,43656535,435,37,280,17,64.4,0.82
CpG: 24,chr4,43669222,43669484,262,24,142,18.3,54.2,1.26
CpG: 64,chr4,43875351,43875866,515,64,387,24.9,75.1,0.89
CpG: 51,chr4,43957358,43958012,654,51,421,15.6,64.4,0.75
CpG: 64,chr4,44012680,44013235,555,64,382,23.1,68.8,1
CpG: 63,chr4,44072312,44072846,534,63,380,23.6,71.2,0.95
CpG: 113,chr4,44167370,44168501,1131,113,671,20,59.3,1.17
CpG: 93,chr4,44233352,44234284,932,93,568,20,60.9,1.08
CpG: 55,chr4,44425180,44425727,547,55,387,20.1,70.7,0.8
CpG: 52,chr4,44664071,44664673,602,52,319,17.3,53,1.24
CpG: 156,chr4,44703124,44704717,1593,156,1083,19.6,68,0.85
CpG: 39,chr4,44710638,44711138,500,39,306,15.6,61.2,0.83
CpG: 37,chr4,44712905,44713335,430,37,259,17.2,60.2,0.95
CpG: 52,chr4,44756498,44756999,501,52,340,20.8,67.9,0.91
CpG: 58,chr4,45011741,45012423,682,58,446,17,65.4,0.81
CpG: 27,chr4,45018565,45018943,378,27,231,14.3,61.1,0.77
CpG: 72,chr4,45084142,45084782,640,72,464,22.5,72.5,0.86
CpG: 35,chr4,45107565,45108040,475,35,286,14.7,60.2,0.82
CpG: 85,chr4,45184551,45185385,834,85,584,20.4,70,0.83
CpG: 53,chr4,45320186,45320643,457,53,311,23.2,68.1,1.05
CpG: 96,chr4,45341989,45342797,808,96,543,23.8,67.2,1.05
CpG: 26,chr4,45399741,45400021,280,26,173,18.6,61.8,0.97
CpG: 78,chr4,45408260,45409059,799,78,533,19.5,66.7,0.88
CpG: 164,chr4,45529581,45531015,1434,164,915,22.9,63.8,1.13
CpG: 25,chr4,45799008,45799273,265,25,173,18.9,65.3,0.89
CpG: 70,chr4,45826357,45826849,492,70,365,28.5,74.2,1.03
CpG: 29,chr4,45883487,45883912,425,29,243,13.6,57.2,0.88
CpG: 80,chr4,45972128,45972847,719,80,459,22.3,63.8,1.1
CpG: 68,chr4,46039120,46039800,680,68,476,20,70,0.82
CpG: 86,chr4,46138271,46139050,779,86,529,22.1,67.9,0.96
CpG: 66,chr4,46195843,46196399,556,66,388,23.7,69.8,0.98
CpG: 66,chr4,46304810,46305266,456,66,317,28.9,69.5,1.2
CpG: 251,chr4,46343394,46345541,2147,251,1462,23.4,68.1,1.01
CpG: 55,chr4,46389088,46389594,506,55,322,21.7,63.6,1.08
CpG: 222,chr4,46450682,46452589,1907,222,1257,23.3,65.9,1.07
CpG: 53,chr4,46489157,46489721,564,53,382,18.8,67.7,0.84
CpG: 82,chr4,46506931,46507525,594,82,434,27.6,73.1,1.04
CpG: 33,chr4,46535837,46536076,239,33,178,27.6,74.5,1.01
CpG: 114,chr4,46601167,46602292,1125,114,772,20.3,68.6,0.86
CpG: 26,chr4,46614070,46614452,382,26,245,13.6,64.1,0.66
CpG: 23,chr4,46620419,46620741,322,23,212,14.3,65.8,0.66
CpG: 96,chr4,46649724,46650710,986,96,638,19.5,64.7,0.93
CpG: 24,chr4,46664594,46664942,348,24,233,13.8,67,0.63
CpG: 115,chr4,46991019,46992185,1166,115,674,19.7,57.8,1.19
CpG: 76,chr4,47056901,47057616,715,76,444,21.3,62.1,1.12
CpG: 58,chr4,47091911,47092433,522,58,380,22.2,72.8,0.87
CpG: 55,chr4,47208248,47208819,571,55,386,19.3,67.6,0.85
CpG: 24,chr4,47245426,47245761,335,24,202,14.3,60.3,0.79
CpG: 124,chr4,47352408,47353954,1546,124,900,16,58.2,0.97
CpG: 48,chr4,47473929,47474397,468,48,306,20.5,65.4,0.97
CpG: 79,chr4,48042872,48043491,619,79,395,25.5,63.8,1.25
CpG: 80,chr4,48044734,48045725,991,80,561,16.1,56.6,1.02
CpG: 29,chr4,48047189,48047577,388,29,251,14.9,64.7,0.71
CpG: 48,chr4,48051612,48052178,566,48,396,17,70,0.72
CpG: 55,chr4,48124848,48125340,492,55,358,22.4,72.8,0.85
CpG: 61,chr4,48279256,48280058,802,61,526,15.2,65.6,0.71
CpG: 82,chr4,48472917,48473545,628,82,425,26.1,67.7,1.16
CpG: 37,chr4,48539926,48540333,407,37,271,18.2,66.6,0.83
CpG: 24,chr4,48552522,48552845,323,24,199,14.9,61.6,0.78
CpG: 123,chr4,48584870,48585924,1054,123,716,23.3,67.9,1.02
CpG: 58,chr4,49059222,49059927,705,58,436,16.5,61.8,0.86
CpG: 22,chr4,49521030,49521279,249,22,150,17.7,60.2,0.98
CpG: 89,chr4,49596861,49597835,974,89,673,18.3,69.1,0.77
CpG: 53,chr4,49631849,49632463,614,53,392,17.3,63.8,0.87
CpG: 104,chr4,49844690,49845920,1230,104,829,16.9,67.4,0.75
CpG: 43,chr4,52438898,52439450,552,43,325,15.6,58.9,0.91
CpG: 59,chr4,53011803,53012331,528,59,371,22.3,70.3,0.95
CpG: 40,chr4,53159785,53160188,403,40,262,19.9,65,0.94
CpG: 117,chr4,53440003,53441019,1016,117,664,23,65.4,1.1
CpG: 68,chr4,53631316,53631968,652,68,400,20.9,61.3,1.11
CpG: 54,chr4,53714091,53714630,539,54,349,20,64.7,0.96
CpG: 20,chr4,53779616,53779874,258,20,169,15.5,65.5,0.73
CpG: 36,chr4,53826002,53826330,328,36,228,22,69.5,0.91
CpG: 42,chr4,54945037,54945439,402,42,277,20.9,68.9,0.88
CpG: 135,chr4,55349617,55350776,1159,135,832,23.3,71.8,0.91
CpG: 22,chr4,55480373,55480669,296,22,195,14.9,65.9,0.69
CpG: 39,chr4,55514807,55515178,371,39,255,21,68.7,0.89
CpG: 248,chr4,55530171,55533292,3121,248,1944,15.9,62.3,0.82
CpG: 54,chr4,55651120,55651739,619,54,396,17.4,64,0.86
CpG: 19,chr4,56740665,56740940,275,19,174,13.8,63.3,0.69
CpG: 77,chr4,56801922,56802802,880,77,554,17.5,63,0.88
CpG: 92,chr4,56864599,56865514,915,92,652,20.1,71.3,0.82
CpG: 105,chr4,56946691,56947530,839,105,604,25,72,0.97
CpG: 25,chr4,56990050,56990300,250,25,140,20,56,1.28
CpG: 18,chr4,57141905,57142146,241,18,157,14.9,65.1,0.7
CpG: 96,chr4,57142826,57143840,1014,96,508,18.9,50.1,1.51
CpG: 80,chr4,57299726,57300366,640,80,470,25,73.4,0.93
CpG: 77,chr4,57433887,57434728,841,77,554,18.3,65.9,0.85
CpG: 54,chr4,57567839,57568287,448,54,335,24.1,74.8,0.86
CpG: 26,chr4,57782104,57782377,273,26,198,19,72.5,0.75
CpG: 86,chr4,57955626,57956636,1010,86,663,17,65.6,0.79
CpG: 66,chr4,58205842,58206499,657,66,442,20.1,67.3,0.89
CpG: 61,chr4,58552973,58553456,483,61,350,25.3,72.5,0.96
CpG: 159,chr4,58911438,58912955,1517,159,922,21,60.8,1.13
CpG: 33,chr4,58943527,58943818,291,33,198,22.7,68,0.99
CpG: 76,chr4,59002877,59003573,696,76,439,21.8,63.1,1.1
CpG: 60,chr4,59035062,59035597,535,60,364,22.4,68,0.97
CpG: 82,chr4,59189067,59189943,876,82,478,18.7,54.6,1.27
CpG: 65,chr4,59437946,59438525,579,65,427,22.5,73.7,0.84
CpG: 147,chr4,59548495,59549829,1334,147,836,22,62.7,1.12
CpG: 58,chr4,59581259,59582026,767,58,454,15.1,59.2,0.87
CpG: 111,chr4,59625909,59626857,948,111,637,23.4,67.2,1.04
CpG: 64,chr4,59783410,59784041,631,64,400,20.3,63.4,1.01
CpG: 77,chr4,59805711,59806548,837,77,607,18.4,72.5,0.71
CpG: 45,chr4,62208319,62208792,473,45,308,19,65.1,0.9
CpG: 46,chr4,62286291,62286719,428,46,298,21.5,69.6,0.91
CpG: 50,chr4,62360201,62360786,585,50,378,17.1,64.6,0.83
CpG: 30,chr4,62408671,62408990,319,30,197,18.8,61.8,0.99
CpG: 27,chr4,62470753,62471016,263,27,183,20.5,69.6,0.86
CpG: 46,chr4,62479985,62480473,488,46,264,18.9,54.1,1.32
CpG: 26,chr4,62502032,62502311,279,26,189,18.6,67.7,0.86
CpG: 55,chr4,62519594,62520176,582,55,394,18.9,67.7,0.83
CpG: 66,chr4,62524695,62525573,878,66,522,15,59.5,0.86
CpG: 31,chr4,62583387,62583685,298,31,213,20.8,71.5,0.82
CpG: 142,chr4,63213962,63216015,2053,142,1201,13.8,58.5,0.81
CpG: 36,chr4,63410376,63410808,432,36,290,16.7,67.1,0.74
CpG: 17,chr4,63416304,63416547,243,17,156,14,64.2,0.71
CpG: 141,chr4,63494624,63496133,1509,141,943,18.7,62.5,0.97
CpG: 52,chr4,63544771,63545365,594,52,393,17.5,66.2,0.8
CpG: 64,chr4,63558441,63558995,554,64,376,23.1,67.9,1.01
CpG: 23,chr4,64017529,64017827,298,23,183,15.4,61.4,0.83
CpG: 46,chr4,65124446,65124914,468,46,275,19.7,58.8,1.17
CpG: 31,chr4,65604887,65605207,320,31,215,19.4,67.2,0.96
CpG: 25,chr4,66402788,66403061,273,25,169,18.3,61.9,0.96
CpG: 46,chr4,66403653,66404185,532,46,330,17.3,62,0.9
CpG: 32,chr4,68953777,68954136,359,32,230,17.8,64.1,0.9
CpG: 29,chr4,70249184,70249439,255,29,171,22.7,67.1,1.02
CpG: 53,chr4,70410101,70410673,572,53,369,18.5,64.5,0.9
CpG: 117,chr4,70534251,70535408,1157,117,788,20.2,68.1,0.88
CpG: 227,chr4,72199645,72201675,2030,227,1374,22.4,67.7,0.98
CpG: 79,chr4,73790554,73791142,588,79,420,26.9,71.4,1.05
CpG: 39,chr4,74013561,74013962,401,39,256,19.5,63.8,0.96
CpG: 76,chr4,74251721,74252438,717,76,497,21.2,69.3,0.88
CpG: 31,chr4,75278061,75278398,337,31,210,18.4,62.3,0.97
CpG: 111,chr4,76449343,76450536,1193,111,734,18.6,61.5,0.99
CpG: 42,chr4,78211708,78211991,283,42,193,29.7,68.2,1.3
CpG: 59,chr4,80911185,80911937,752,59,489,15.7,65,0.74
CpG: 94,chr4,81442266,81442944,678,94,521,27.7,76.8,0.94
CpG: 167,chr4,82504346,82506555,2209,167,1248,15.1,56.5,0.95
CpG: 20,chr4,82506710,82506941,231,20,159,17.3,68.8,0.74
CpG: 37,chr4,82513158,82513499,341,37,212,21.7,62.2,1.13
CpG: 75,chr4,82859220,82859801,581,75,429,25.8,73.8,0.95
CpG: 77,chr4,83323598,83324336,738,77,504,20.9,68.3,0.91
CpG: 58,chr4,83417522,83418164,642,58,421,18.1,65.6,0.84
CpG: 120,chr4,83485658,83486817,1159,120,774,20.7,66.8,0.93
CpG: 62,chr4,83525138,83525623,485,62,339,25.6,69.9,1.06
CpG: 41,chr4,84545328,84545724,396,41,239,20.7,60.4,1.15
CpG: 137,chr4,84674411,84676066,1655,137,948,16.6,57.3,1.01
CpG: 101,chr4,84884169,84884961,792,101,573,25.5,72.3,0.98
CpG: 78,chr4,85205260,85206130,870,78,575,17.9,66.1,0.83
CpG: 30,chr4,85514186,85514538,352,30,247,17,70.2,0.69
CpG: 52,chr4,86575600,86576070,470,52,308,22.1,65.5,1.03
CpG: 54,chr4,86611491,86612079,588,54,381,18.4,64.8,0.9
CpG: 98,chr4,86748322,86749246,924,98,665,21.2,72,0.83
CpG: 97,chr4,86856753,86857753,1000,97,628,19.4,62.8,0.98
CpG: 67,chr4,86874033,86874720,687,67,464,19.5,67.5,0.86
CpG: 58,chr4,87230147,87230588,441,58,329,26.3,74.6,0.95
CpG: 168,chr4,88031599,88033530,1931,168,1143,17.4,59.2,0.99
CpG: 53,chr4,88094496,88095069,573,53,394,18.5,68.8,0.8
CpG: 71,chr4,88721900,88722673,773,71,479,18.4,62,0.96
CpG: 23,chr4,88760450,88760667,217,23,155,21.2,71.4,0.83
CpG: 42,chr4,88763363,88763880,517,42,339,16.2,65.6,0.76
CpG: 32,chr4,88773670,88773981,311,32,215,20.6,69.1,0.86
CpG: 32,chr4,88776598,88776909,311,32,215,20.6,69.1,0.86
CpG: 32,chr4,88779526,88779837,311,32,215,20.6,69.1,0.86
CpG: 31,chr4,88782462,88782773,311,31,214,19.9,68.8,0.84
CpG: 30,chr4,88785385,88785696,311,30,213,19.3,68.5,0.82
CpG: 25,chr4,88788308,88788533,225,25,160,22.2,71.1,0.88
CpG: 27,chr4,88791226,88791451,225,27,162,24,72,0.93
CpG: 32,chr4,88794163,88794474,311,32,215,20.6,69.1,0.86
CpG: 27,chr4,88797073,88797298,225,27,162,24,72,0.93
CpG: 32,chr4,88799996,88800307,311,32,215,20.6,69.1,0.86
CpG: 32,chr4,88802930,88803241,311,32,215,20.6,69.1,0.86
CpG: 32,chr4,88805862,88806173,311,32,216,20.6,69.5,0.86
CpG: 23,chr4,88868106,88868455,349,23,194,13.2,55.6,0.85
CpG: 30,chr4,88938052,88938286,234,30,155,25.6,66.2,1.17
CpG: 42,chr4,89137359,89137890,531,42,368,15.8,69.3,0.66
CpG: 30,chr4,89276672,89276968,296,30,188,20.3,63.5,1.01
CpG: 145,chr4,89294132,89295553,1421,145,868,20.4,61.1,1.1
CpG: 19,chr4,89307030,89307249,219,19,146,17.4,66.7,0.78
CpG: 48,chr4,89310607,89311040,433,48,308,22.2,71.1,0.88
CpG: 77,chr4,89688123,89688810,687,77,476,22.4,69.3,0.94
CpG: 123,chr4,91371164,91372167,1003,123,723,24.5,72.1,0.95
CpG: 39,chr4,91374647,91375123,476,39,295,16.4,62,0.88
CpG: 30,chr4,91400568,91400871,303,30,219,19.8,72.3,0.76
CpG: 109,chr4,93334723,93335771,1048,109,668,20.8,63.7,1.02
CpG: 63,chr4,94556325,94556860,535,63,320,23.6,59.8,1.32
CpG: 85,chr4,94602694,94603518,824,85,551,20.6,66.9,0.93
CpG: 26,chr4,94614398,94614640,242,26,157,21.5,64.9,1.03
CpG: 61,chr4,94978703,94979389,686,61,410,17.8,59.8,1.03
CpG: 254,chr4,95049985,95053224,3239,254,1943,15.7,60,0.87
CpG: 38,chr4,95161229,95161482,253,38,205,30,81,0.95
CpG: 82,chr4,95967016,95967710,694,82,494,23.6,71.2,0.93
CpG: 27,chr4,97745808,97746126,318,27,191,17,60.1,0.95
CpG: 30,chr4,97751594,97752001,407,30,251,14.7,61.7,0.78
CpG: 29,chr4,97772046,97772411,365,29,225,15.9,61.6,0.84
CpG: 149,chr4,97777172,97778896,1724,149,969,17.3,56.2,1.09
CpG: 34,chr4,98382928,98383269,341,34,244,19.9,71.6,0.79
CpG: 70,chr4,98395669,98396214,545,70,418,25.7,76.7,0.88
CpG: 79,chr4,98817048,98817762,714,79,498,22.1,69.7,0.91
CpG: 172,chr4,98922812,98924544,1732,172,1110,19.9,64.1,0.97
CpG: 109,chr4,99120338,99121153,815,109,569,26.7,69.8,1.1
CpG: 22,chr4,99445464,99445743,279,22,177,15.8,63.4,0.78
CpG: 54,chr4,99650896,99651569,673,54,372,16,55.3,1.05
CpG: 45,chr4,99653363,99653955,592,45,324,15.2,54.7,1.02
CpG: 219,chr4,99655945,99658098,2153,219,1402,20.3,65.1,0.97
CpG: 52,chr4,99715351,99715891,540,52,376,19.3,69.6,0.8
CpG: 34,chr4,99829081,99829515,434,34,242,15.7,55.8,1.01
CpG: 71,chr4,99929380,99930163,783,71,527,18.1,67.3,0.8
CpG: 62,chr4,100095755,100096426,671,62,448,18.5,66.8,0.83
CpG: 137,chr4,100776432,100778008,1576,137,1020,17.4,64.7,0.84
CpG: 74,chr4,101068788,101069748,960,74,569,15.4,59.3,0.92
CpG: 88,chr4,101264531,101265321,790,88,523,22.3,66.2,1.02
CpG: 37,chr4,101292109,101292476,367,37,236,20.2,64.3,0.98
CpG: 38,chr4,101292974,101293370,396,38,270,19.2,68.2,0.83
CpG: 84,chr4,101356054,101356931,877,84,506,19.2,57.7,1.15
CpG: 138,chr4,101419138,101420526,1388,138,906,19.9,65.3,0.93
CpG: 71,chr4,101496375,101496973,598,71,426,23.7,71.2,0.94
CpG: 17,chr4,101508849,101509063,214,17,143,15.9,66.8,0.71
CpG: 56,chr4,101550244,101550901,657,56,425,17,64.7,0.85
CpG: 41,chr4,101647611,101648034,423,41,285,19.4,67.4,0.88
CpG: 27,chr4,101717345,101717617,272,27,188,19.9,69.1,0.84
CpG: 71,chr4,102087536,102088232,696,71,482,20.4,69.3,0.88
CpG: 25,chr4,102759312,102759554,242,25,169,20.7,69.8,0.85
CpG: 19,chr4,102760069,102760321,252,19,168,15.1,66.7,0.78
CpG: 94,chr4,103113924,103114882,958,94,598,19.6,62.4,1.01
CpG: 89,chr4,103119197,103119913,716,89,452,24.9,63.1,1.25
CpG: 77,chr4,103214434,103215420,986,77,528,15.6,53.5,1.09
CpG: 53,chr4,103313673,103314175,502,53,353,21.1,70.3,0.87
CpG: 48,chr4,103619606,103620122,516,48,350,18.6,67.8,0.83
CpG: 107,chr4,104366973,104367904,931,107,655,23,70.4,0.94
CpG: 45,chr4,105109426,105109826,400,45,286,22.5,71.5,0.92
CpG: 18,chr4,105109954,105110155,201,18,135,17.9,67.2,0.9
CpG: 99,chr4,105157313,105158466,1153,99,736,17.2,63.8,0.85
CpG: 132,chr4,106315716,106316945,1229,132,803,21.5,65.3,1.01
CpG: 29,chr4,106463881,106464248,367,29,240,15.8,65.4,0.75
CpG: 87,chr4,106560805,106561507,702,87,495,24.8,70.5,1
CpG: 53,chr4,106622395,106623099,704,53,478,15.1,67.9,0.65
CpG: 27,chr4,106639012,106639329,317,27,209,17,65.9,0.8
CpG: 29,chr4,106650930,106651301,371,29,231,15.6,62.3,0.81
CpG: 37,chr4,106678639,106679041,402,37,258,18.4,64.2,0.91
CpG: 33,chr4,106827880,106828187,307,33,215,21.5,70,0.89
CpG: 97,chr4,106839043,106840364,1321,97,785,14.7,59.4,0.83
CpG: 203,chr4,106910717,106912517,1800,203,1228,22.6,68.2,0.98
CpG: 78,chr4,107066512,107067447,935,78,577,16.7,61.7,0.88
CpG: 93,chr4,107178222,107179349,1127,93,737,16.5,65.4,0.78
CpG: 76,chr4,107253287,107254095,808,76,531,18.8,65.7,0.94
CpG: 21,chr4,107314177,107314399,222,21,135,18.9,60.8,1.02
CpG: 45,chr4,107367757,107368295,538,45,354,16.7,65.8,0.78
CpG: 146,chr4,107434249,107435969,1720,146,1072,17,62.3,0.88
CpG: 39,chr4,107683544,107683992,448,39,329,17.4,73.4,0.65
CpG: 90,chr4,107802489,107803693,1204,90,755,15,62.7,0.77
CpG: 52,chr4,107846210,107846613,403,52,290,25.8,72,1
CpG: 18,chr4,107854242,107854448,206,18,123,17.5,59.7,0.98
CpG: 43,chr4,107879659,107880130,471,43,279,18.3,59.2,1.05
CpG: 49,chr4,107889687,107890217,530,49,339,18.5,64,0.92
CpG: 32,chr4,107923369,107923704,335,32,237,19.1,70.7,0.76
CpG: 15,chr4,108021181,108021399,218,15,136,13.8,62.4,0.71
CpG: 78,chr4,108031542,108032302,760,78,532,20.5,70,0.84
CpG: 33,chr4,108118282,108118619,337,33,216,19.6,64.1,0.96
CpG: 31,chr4,108165395,108165625,230,31,166,27,72.2,1.07
CpG: 100,chr4,108217336,108218204,868,100,600,23,69.1,0.97
CpG: 29,chr4,108300783,108301084,301,29,222,19.3,73.8,0.72
CpG: 35,chr4,108328045,108328456,411,35,270,17,65.7,0.82
CpG: 54,chr4,108383205,108383697,492,54,347,22,70.5,0.89
CpG: 49,chr4,108406292,108406812,520,49,355,18.8,68.3,0.81
CpG: 119,chr4,108459230,108460514,1284,119,835,18.5,65,0.88
CpG: 16,chr4,108460650,108460856,206,16,124,15.5,60.2,0.86
CpG: 51,chr4,108579238,108579811,573,51,355,17.8,62,0.93
CpG: 83,chr4,108619652,108620390,738,83,489,22.5,66.3,1.03
CpG: 97,chr4,108780045,108780825,780,97,553,24.9,70.9,0.99
CpG: 56,chr4,108833263,108833800,537,56,379,20.9,70.6,0.84
CpG: 86,chr4,108847822,108848661,839,86,552,20.5,65.8,0.95
CpG: 30,chr4,108879020,108879386,366,30,254,16.4,69.4,0.68
CpG: 58,chr4,109000330,109001078,748,58,425,15.5,56.8,0.96
CpG: 29,chr4,109117815,109118169,354,29,238,16.4,67.2,0.73
CpG: 45,chr4,109201834,109202340,506,45,330,17.8,65.2,0.85
CpG: 103,chr4,109280116,109281166,1050,103,659,19.6,62.8,1.01
CpG: 68,chr4,109406683,109407333,650,68,446,20.9,68.6,0.89
CpG: 66,chr4,109476034,109476721,687,66,433,19.2,63,0.97
CpG: 45,chr4,109657136,109657719,583,45,413,15.4,70.8,0.62
CpG: 142,chr4,109665677,109667173,1496,142,1002,19,67,0.85
CpG: 88,chr4,109676288,109677165,877,88,536,20.1,61.1,1.08
CpG: 110,chr4,109977332,109978615,1283,110,862,17.1,67.2,0.76
CpG: 53,chr4,109979980,109980420,440,53,314,24.1,71.4,0.95
CpG: 222,chr4,109981640,109984252,2612,222,1630,17,62.4,0.87
CpG: 34,chr4,110051029,110051338,309,34,215,22,69.6,0.92
CpG: 72,chr4,110351310,110351976,666,72,455,21.6,68.3,0.93
CpG: 25,chr4,110397655,110397895,240,25,164,20.8,68.3,0.9
CpG: 64,chr4,111414759,111415513,754,64,447,17,59.3,0.97
CpG: 42,chr4,111719931,111720309,378,42,283,22.2,74.9,0.83
CpG: 45,chr4,112979350,112979842,492,45,338,18.3,68.7,0.78
CpG: 64,chr4,114406300,114406926,626,64,474,20.4,75.7,0.74
CpG: 33,chr4,114821676,114822057,381,33,214,17.3,56.2,1.13
CpG: 51,chr4,114843180,114843722,542,51,366,18.8,67.5,0.83
CpG: 28,chr4,114902053,114902346,293,28,192,19.1,65.5,0.89
CpG: 19,chr4,114902695,114902897,202,19,118,18.8,58.4,1.14
CpG: 208,chr4,114907118,114909560,2442,208,1534,17,62.8,0.87
CpG: 142,chr4,114925021,114926090,1069,142,764,26.6,71.5,1.06
CpG: 58,chr4,114986697,114987141,444,58,315,26.1,70.9,1.04
CpG: 46,chr4,114999951,115000409,458,46,297,20.1,64.8,0.96
CpG: 129,chr4,115056381,115057895,1514,129,957,17,63.2,0.86
CpG: 56,chr4,115063134,115063623,489,56,343,22.9,70.1,0.93
CpG: 48,chr4,115737562,115738075,513,48,350,18.7,68.2,0.8
CpG: 65,chr4,115784823,115785381,558,65,404,23.3,72.4,0.9
CpG: 51,chr4,115827936,115828455,519,51,360,19.7,69.4,0.82
CpG: 36,chr4,115839033,115839425,392,36,258,18.4,65.8,0.85
CpG: 35,chr4,115890500,115890875,375,35,251,18.7,66.9,0.83
CpG: 49,chr4,115897966,115898555,589,49,388,16.6,65.9,0.77
CpG: 18,chr4,115936203,115936412,209,18,130,17.2,62.2,0.92
CpG: 103,chr4,115938918,115940209,1291,103,799,16,61.9,0.86
CpG: 29,chr4,115943985,115944303,318,29,193,18.2,60.7,1
CpG: 61,chr4,115962809,115963384,575,61,361,21.2,62.8,1.08
CpG: 29,chr4,115979470,115979774,304,29,177,19.1,58.2,1.13
CpG: 73,chr4,116017267,116017990,723,73,501,20.2,69.3,0.85
CpG: 24,chr4,116053699,116053959,260,24,161,18.5,61.9,0.97
CpG: 125,chr4,116075366,116076612,1246,125,867,20.1,69.6,0.86
CpG: 30,chr4,116144334,116144681,347,30,221,17.3,63.7,0.85
CpG: 79,chr4,116220843,116221838,995,79,632,15.9,63.5,0.79
CpG: 79,chr4,116463661,116464390,729,79,411,21.7,56.4,1.38
CpG: 52,chr4,116507428,116507968,540,52,353,19.3,65.4,0.9
CpG: 87,chr4,116557032,116558118,1086,87,654,16,60.2,0.89
CpG: 30,chr4,116597307,116597651,344,30,221,17.4,64.2,0.85
CpG: 48,chr4,116626810,116627370,560,48,362,17.1,64.6,0.83
CpG: 21,chr4,116651418,116651698,280,21,182,15,65,0.71
CpG: 60,chr4,116685464,116686097,633,60,398,19,62.9,0.96
CpG: 43,chr4,116720755,116721309,554,43,368,15.5,66.4,0.71
CpG: 41,chr4,116807460,116807882,422,41,262,19.4,62.1,1.02
CpG: 46,chr4,116820953,116821538,585,46,368,15.7,62.9,0.8
CpG: 24,chr4,116824686,116824953,267,24,167,18,62.5,0.95
CpG: 33,chr4,116840052,116840353,301,33,211,21.9,70.1,0.89
CpG: 113,chr4,116877004,116878087,1083,113,627,20.9,57.9,1.25
CpG: 51,chr4,116995354,116995781,427,51,313,23.9,73.3,0.89
CpG: 47,chr4,117019269,117019674,405,47,278,23.2,68.6,0.99
CpG: 41,chr4,117095858,117096337,479,41,326,17.1,68.1,0.74
CpG: 19,chr4,117109395,117109611,216,19,149,17.6,69,0.74
CpG: 63,chr4,117120599,117121347,748,63,484,16.8,64.7,0.81
CpG: 61,chr4,117133399,117134038,639,61,379,19.1,59.3,1.09
CpG: 22,chr4,117148866,117149079,213,22,141,20.7,66.2,0.94
CpG: 79,chr4,117155509,117156234,725,79,506,21.8,69.8,0.9
CpG: 35,chr4,117251857,117252288,431,35,277,16.2,64.3,0.79
CpG: 54,chr4,117288987,117289472,485,54,332,22.3,68.5,0.96
CpG: 41,chr4,117304189,117304546,357,41,239,23,66.9,1.05
CpG: 62,chr4,117484423,117484961,538,62,375,23,69.7,0.95
CpG: 174,chr4,117494359,117496709,2350,174,1391,14.8,59.2,0.85
CpG: 45,chr4,117550215,117550636,421,45,303,21.4,72,0.85
CpG: 36,chr4,117681897,117682403,506,36,311,14.2,61.5,0.76
CpG: 24,chr4,117729384,117729589,205,24,119,23.4,58,1.4
CpG: 128,chr4,117835339,117836733,1394,128,938,18.4,67.3,0.82
CpG: 21,chr4,117867952,117868245,293,21,183,14.3,62.5,0.74
CpG: 64,chr4,117882948,117883469,521,64,409,24.6,78.5,0.8
CpG: 64,chr4,117886857,117887462,605,64,427,21.2,70.6,0.85
CpG: 24,chr4,117891595,117891862,267,24,167,18,62.5,0.97
CpG: 51,chr4,117914815,117915305,490,51,328,20.8,66.9,0.93
CpG: 68,chr4,117926606,117927224,618,68,438,22,70.9,0.9
CpG: 32,chr4,117929412,117929815,403,32,279,15.9,69.2,0.66
CpG: 84,chr4,118134376,118135144,768,84,558,21.9,72.7,0.83
CpG: 17,chr4,118212042,118212247,205,17,121,16.6,59,0.96
CpG: 24,chr4,118260835,118261067,232,24,165,20.7,71.1,0.82
CpG: 79,chr4,118290455,118291235,780,79,443,20.3,56.8,1.28
CpG: 43,chr4,118359956,118360289,333,43,250,25.8,75.1,0.92
CpG: 48,chr4,118409119,118409651,532,48,358,18,67.3,0.83
CpG: 62,chr4,118436948,118437578,630,62,401,19.7,63.7,0.98
CpG: 19,chr4,118486405,118486632,227,19,150,16.7,66.1,0.77
CpG: 20,chr4,118541901,118542148,247,20,163,16.2,66,0.75
CpG: 43,chr4,118620740,118621282,542,43,328,15.9,60.5,0.9
CpG: 76,chr4,119108685,119109270,585,76,426,26,72.8,0.98
CpG: 31,chr4,119173964,119174255,291,31,195,21.3,67,0.95
CpG: 33,chr4,119195285,119195634,349,33,217,18.9,62.2,0.99
CpG: 100,chr4,119232367,119233464,1097,100,736,18.2,67.1,0.81
CpG: 17,chr4,119282188,119282389,201,17,113,16.9,56.2,1.07
CpG: 111,chr4,119293683,119294994,1311,111,691,16.9,52.7,1.22
CpG: 40,chr4,119320182,119320593,411,40,261,19.5,63.5,0.98
CpG: 40,chr4,119415183,119415588,405,40,274,19.8,67.7,0.86
CpG: 83,chr4,119421975,119422972,997,83,624,16.6,62.6,0.85
CpG: 70,chr4,119492218,119492766,548,70,376,25.5,68.6,1.09
CpG: 23,chr4,119521076,119521318,242,23,150,19,62,0.99
CpG: 142,chr4,119539229,119540283,1054,142,780,26.9,74,0.99
CpG: 95,chr4,119733555,119734333,778,95,559,24.4,71.9,0.95
CpG: 22,chr4,119814814,119815045,231,22,149,19,64.5,0.92
CpG: 47,chr4,120032845,120033243,398,47,245,23.6,61.6,1.25
CpG: 37,chr4,120148735,120149024,289,37,203,25.6,70.2,1.05
CpG: 119,chr4,120267946,120269173,1227,119,760,19.4,61.9,1.01
CpG: 51,chr4,120282476,120282998,522,51,365,19.5,69.9,0.8
CpG: 136,chr4,120286819,120288121,1302,136,875,20.9,67.2,0.93
CpG: 104,chr4,120404992,120405976,984,104,646,21.1,65.7,0.98
CpG: 116,chr4,120569531,120570704,1173,116,796,19.8,67.9,0.86
CpG: 43,chr4,120649755,120650114,359,43,264,24,73.5,0.89
CpG: 89,chr4,120666519,120667457,938,89,598,19,63.8,0.94
CpG: 26,chr4,120697918,120698262,344,26,219,15.1,63.7,0.82
CpG: 34,chr4,120731011,120731409,398,34,252,17.1,63.3,0.86
CpG: 100,chr4,120746776,120747625,849,100,548,23.6,64.5,1.13
CpG: 95,chr4,120825099,120825889,790,95,558,24.1,70.6,0.97
CpG: 53,chr4,120854718,120855294,576,53,385,18.4,66.8,0.82
CpG: 66,chr4,120951370,120951904,534,66,397,24.7,74.3,0.93
CpG: 55,chr4,121016809,121017403,594,55,436,18.5,73.4,0.7
CpG: 22,chr4,121039609,121039816,207,22,140,21.3,67.6,0.97
CpG: 58,chr4,121214641,121215273,632,58,390,18.4,61.7,1
CpG: 29,chr4,122885824,122886128,304,29,202,19.1,66.4,0.87
CpG: 45,chr4,122960877,122961321,444,45,303,20.3,68.2,0.91
CpG: 127,chr4,122995640,122997012,1372,127,926,18.5,67.5,0.81
CpG: 32,chr4,123016524,123016892,368,32,243,17.4,66,0.81
CpG: 99,chr4,123104618,123105643,1025,99,688,19.3,67.1,0.86
CpG: 110,chr4,123116259,123117456,1197,110,747,18.4,62.4,0.95
CpG: 34,chr4,123183309,123183668,359,34,233,18.9,64.9,0.9
CpG: 19,chr4,123189041,123189245,204,19,121,18.6,59.3,1.06
CpG: 33,chr4,123201322,123201625,303,33,224,21.8,73.9,0.82
CpG: 41,chr4,123233608,123234080,472,41,303,17.4,64.2,0.86
CpG: 86,chr4,123282607,123283763,1156,86,677,14.9,58.6,0.87
CpG: 112,chr4,123322418,123323615,1197,112,755,18.7,63.1,0.94
CpG: 87,chr4,123342303,123343090,787,87,541,22.1,68.7,0.94
CpG: 97,chr4,123411410,123412441,1031,97,743,18.8,72.1,0.73
CpG: 99,chr4,123663954,123665073,1119,99,614,17.7,54.9,1.2
CpG: 88,chr4,123686502,123687331,829,88,554,21.2,66.8,0.96
CpG: 24,chr4,123718149,123718385,236,24,148,20.3,62.7,1.05
CpG: 91,chr4,123749736,123750601,865,91,627,21,72.5,0.8
CpG: 87,chr4,123904770,123905531,761,87,517,22.9,67.9,0.99
CpG: 79,chr4,123917134,123918111,977,79,577,16.2,59.1,0.93
CpG: 21,chr4,123990724,123990945,221,21,154,19,69.7,0.79
CpG: 41,chr4,124178528,124178921,393,41,246,20.9,62.6,1.07
CpG: 39,chr4,124277515,124277995,480,39,311,16.2,64.8,0.8
CpG: 64,chr4,124575210,124575876,666,64,423,19.2,63.5,0.96
CpG: 233,chr4,124656782,124659760,2978,233,1620,15.6,54.4,1.06
CpG: 24,chr4,124659908,124660197,289,24,177,16.6,61.2,0.92
CpG: 22,chr4,124693360,124693603,243,22,162,18.1,66.7,0.82
CpG: 55,chr4,124700479,124700998,519,55,361,21.2,69.6,0.88
CpG: 22,chr4,124708987,124709243,256,22,168,17.2,65.6,0.81
CpG: 54,chr4,124714653,124715359,706,54,424,15.3,60.1,0.85
CpG: 70,chr4,124751315,124752080,765,70,497,18.3,65,0.93
CpG: 49,chr4,124802118,124802725,607,49,407,16.1,67.1,0.72
CpG: 163,chr4,124850233,124851474,1241,163,892,26.3,71.9,1.02
CpG: 84,chr4,124861667,124862445,778,84,489,21.6,62.9,1.09
CpG: 40,chr4,124881460,124881974,514,40,342,15.6,66.5,0.72
CpG: 38,chr4,124882321,124882774,453,38,289,16.8,63.8,0.84
CpG: 48,chr4,124885550,124886143,593,48,383,16.2,64.6,0.78
CpG: 73,chr4,124894556,124895082,526,73,397,27.8,75.5,0.99
CpG: 55,chr4,124936500,124937161,661,55,384,16.6,58.1,0.99
CpG: 89,chr4,124986260,124987148,888,89,577,20,65,0.98
CpG: 16,chr4,124990059,124990261,202,16,130,15.8,64.4,0.77
CpG: 47,chr4,125029875,125030275,400,47,269,23.5,67.2,1.07
CpG: 71,chr4,125066550,125067151,601,71,413,23.6,68.7,1
CpG: 85,chr4,125085003,125085719,716,85,496,23.7,69.3,1
CpG: 64,chr4,125127466,125128145,679,64,445,18.9,65.5,0.89
CpG: 182,chr4,125489950,125491912,1962,182,1265,18.6,64.5,0.9
CpG: 33,chr4,125504134,125504514,380,33,231,17.4,60.8,0.95
CpG: 19,chr4,125729578,125729806,228,19,122,16.7,53.5,1.16
CpG: 35,chr4,126046915,126047210,295,35,206,23.7,69.8,0.97
CpG: 44,chr4,126058281,126058808,527,44,312,16.7,59.2,0.96
CpG: 32,chr4,126096536,126096846,310,32,210,20.6,67.7,0.91
CpG: 53,chr4,126103917,126104425,508,53,346,20.9,68.1,0.91
CpG: 97,chr4,126148497,126149680,1183,97,814,16.4,68.8,0.69
CpG: 62,chr4,126162671,126163337,666,62,453,18.6,68,0.81
CpG: 75,chr4,126202284,126203023,739,75,503,20.3,68.1,0.88
CpG: 37,chr4,126233941,126234488,547,37,353,13.5,64.5,0.68
CpG: 44,chr4,126236895,126237234,339,44,263,26,77.6,0.88
CpG: 16,chr4,126255351,126255559,208,16,144,15.4,69.2,0.65
CpG: 94,chr4,126255759,126256617,858,94,606,21.9,70.6,0.88
CpG: 33,chr4,126262229,126262575,346,33,228,19.1,65.9,0.92
CpG: 49,chr4,126286602,126287116,514,49,331,19.1,64.4,0.93
CpG: 42,chr4,126301039,126301549,510,42,337,16.5,66.1,0.75
CpG: 50,chr4,126321141,126321606,465,50,317,21.5,68.2,0.93
CpG: 63,chr4,126429224,126429822,598,63,419,21.1,70.1,0.86
CpG: 42,chr4,126468403,126468848,445,42,293,18.9,65.8,0.88
CpG: 81,chr4,126532839,126533596,757,81,496,21.4,65.5,1
CpG: 58,chr4,126556699,126557422,723,58,449,16,62.1,0.83
CpG: 48,chr4,126609607,126610142,535,48,367,17.9,68.6,0.76
CpG: 30,chr4,126677552,126677898,346,30,229,17.3,66.2,0.79
CpG: 24,chr4,126732421,126732729,308,24,166,15.6,53.9,1.07
CpG: 118,chr4,126735186,126736306,1120,118,784,21.1,70,0.88
CpG: 93,chr4,126752960,126754112,1152,93,746,16.1,64.8,0.78
CpG: 73,chr4,126967536,126968277,741,73,484,19.7,65.3,0.94
CpG: 98,chr4,127021311,127022504,1193,98,669,16.4,56.1,1.05
CpG: 26,chr4,127060999,127061246,247,26,169,21.1,68.4,0.9
CpG: 47,chr4,127077035,127077578,543,47,336,17.3,61.9,0.92
CpG: 32,chr4,127125892,127126264,372,32,240,17.2,64.5,0.85
CpG: 94,chr4,127168784,127169662,878,94,605,21.4,68.9,0.91
CpG: 29,chr4,127214657,127214981,324,29,230,17.9,71,0.74
CpG: 26,chr4,127233648,127233920,272,26,198,19.1,72.8,0.75
CpG: 88,chr4,127235896,127236812,916,88,617,19.2,67.4,0.85
CpG: 27,chr4,127243827,127244105,278,27,193,19.4,69.4,0.81
CpG: 22,chr4,127313822,127314034,212,22,150,20.8,70.8,0.83
CpG: 22,chr4,127326191,127326489,298,22,175,14.8,58.7,0.86
CpG: 25,chr4,127971539,127971785,246,25,168,20.3,68.3,0.89
CpG: 55,chr4,127987754,127988323,569,55,322,19.3,56.6,1.21
CpG: 37,chr4,127988646,127989156,510,37,344,14.5,67.5,0.64
CpG: 30,chr4,128585609,128586039,430,30,255,14,59.3,0.8
CpG: 25,chr4,128630228,128630484,256,25,166,19.5,64.8,1.12
CpG: 59,chr4,128654527,128655199,672,59,416,17.6,61.9,0.92
CpG: 83,chr4,128727376,128728270,894,83,481,18.6,53.8,1.28
CpG: 37,chr4,128767041,128767520,479,37,301,15.4,62.8,0.79
CpG: 105,chr4,128883566,128884595,1029,105,702,20.4,68.2,0.89
CpG: 20,chr4,128924994,128925215,221,20,137,18.1,62,0.95
CpG: 30,chr4,128962006,128962362,356,30,245,16.9,68.8,0.71
CpG: 46,chr4,128993046,128993583,537,46,342,17.1,63.7,0.86
CpG: 48,chr4,129048635,129049248,613,48,370,15.7,60.4,0.88
CpG: 105,chr4,129057957,129058940,983,105,639,21.4,65,1.01
CpG: 38,chr4,129105356,129105707,351,38,254,21.7,72.4,0.84
CpG: 64,chr4,129120944,129121645,701,64,507,18.3,72.3,0.7
CpG: 123,chr4,129188870,129190193,1323,123,910,18.6,68.8,0.79
CpG: 20,chr4,129223399,129223662,263,20,183,15.2,69.6,0.64
CpG: 49,chr4,129223783,129224458,675,49,448,14.5,66.4,0.66
CpG: 30,chr4,129238825,129239132,307,30,221,19.5,72,0.75
CpG: 47,chr4,129287560,129287925,365,47,272,25.8,74.5,0.93
CpG: 138,chr4,129334605,129335995,1390,138,885,19.9,63.7,0.98
CpG: 24,chr4,129377046,129377316,270,24,162,17.8,60,1.01
CpG: 19,chr4,129377790,129378041,251,19,154,15.1,61.4,0.81
CpG: 40,chr4,129461335,129461918,583,40,366,13.7,62.8,0.75
CpG: 62,chr4,129491179,129491882,703,62,497,17.6,70.7,0.72
CpG: 26,chr4,129500643,129500944,301,26,205,17.3,68.1,0.78
CpG: 112,chr4,129513515,129514562,1047,112,703,21.4,67.1,0.95
CpG: 50,chr4,129542297,129542952,655,50,405,15.3,61.8,0.84
CpG: 21,chr4,129585157,129585410,253,21,156,16.6,61.7,0.87
CpG: 64,chr4,129600326,129601187,861,64,536,14.9,62.3,0.77
CpG: 30,chr4,129618893,129619217,324,30,202,18.5,62.3,0.96
CpG: 65,chr4,129640532,129641195,663,65,432,19.6,65.2,0.94
CpG: 54,chr4,129672292,129672826,534,54,366,20.2,68.5,0.87
CpG: 48,chr4,129696537,129697004,467,48,304,20.6,65.1,0.98
CpG: 168,chr4,129741279,129742829,1550,168,1042,21.7,67.2,0.97
CpG: 20,chr4,129810838,129811070,232,20,152,17.2,65.5,0.8
CpG: 91,chr4,129819767,129820920,1153,91,585,15.8,50.7,1.26
CpG: 110,chr4,129985134,129986439,1305,110,897,16.9,68.7,0.76
CpG: 52,chr4,129987764,129988373,609,52,399,17.1,65.5,0.8
CpG: 27,chr4,130006650,130006973,323,27,226,16.7,70,0.7
CpG: 33,chr4,130047548,130047915,367,33,275,18,74.9,0.65
CpG: 19,chr4,130107808,130108064,256,19,136,14.8,53.1,1.05
CpG: 71,chr4,130138440,130139405,965,71,643,14.7,66.6,0.66
CpG: 69,chr4,130274890,130275645,755,69,503,18.3,66.6,0.82
CpG: 22,chr4,130307788,130308064,276,22,170,15.9,61.6,0.88
CpG: 37,chr4,130308413,130308909,496,37,304,14.9,61.3,0.81
CpG: 51,chr4,130359877,130360421,544,51,348,18.8,64,0.92
CpG: 90,chr4,130573618,130574244,626,90,465,28.8,74.3,1.04
CpG: 83,chr4,130663077,130663996,919,83,542,18.1,59,1.04
CpG: 66,chr4,130792351,130792951,600,66,344,22,57.3,1.34
CpG: 23,chr4,130861695,130861922,227,23,149,20.3,65.6,0.94
CpG: 25,chr4,130949972,130950198,226,25,147,22.1,65,1.1
CpG: 17,chr4,131173993,131174213,220,17,113,15.5,51.4,1.19
CpG: 18,chr4,131819469,131819678,209,18,137,17.2,65.6,0.81
CpG: 196,chr4,131836379,131838503,2124,196,1311,18.5,61.7,0.98
CpG: 45,chr4,131843386,131843868,482,45,324,18.7,67.2,0.84
CpG: 121,chr4,131873391,131874383,992,121,704,24.4,71,0.97
CpG: 235,chr4,131920199,131922352,2153,235,1473,21.8,68.4,0.93
CpG: 74,chr4,132048398,132049107,709,74,434,20.9,61.2,1.15
CpG: 64,chr4,132074675,132075472,797,64,538,16.1,67.5,0.71
CpG: 49,chr4,132113502,132113980,478,49,318,20.5,66.5,0.94
CpG: 81,chr4,132144135,132144728,593,81,448,27.3,75.5,0.96
CpG: 137,chr4,132211214,132212374,1160,137,762,23.6,65.7,1.1
CpG: 19,chr4,132260988,132261190,202,19,150,18.8,74.3,0.73
CpG: 35,chr4,132274104,132274433,329,35,214,21.3,65,1.02
CpG: 21,chr4,132303102,132303330,228,21,133,18.4,58.3,1.09
CpG: 26,chr4,132308598,132308908,310,26,185,16.8,59.7,0.95
CpG: 44,chr4,132329338,132329830,492,44,322,17.9,65.4,0.84
CpG: 77,chr4,132345093,132345800,707,77,460,21.8,65.1,1.03
CpG: 35,chr4,132353409,132353725,316,35,205,22.2,64.9,1.06
CpG: 72,chr4,132422003,132422738,735,72,514,19.6,69.9,0.8
CpG: 29,chr4,132463732,132464034,302,29,186,19.2,61.6,1.03
CpG: 68,chr4,132509977,132510628,651,68,446,20.9,68.5,0.89
CpG: 41,chr4,132533295,132533691,396,41,246,20.7,62.1,1.07
CpG: 52,chr4,132535499,132535959,460,52,327,22.6,71.1,0.95
CpG: 51,chr4,132638827,132639348,521,51,340,19.6,65.3,0.92
CpG: 56,chr4,132768321,132768850,529,56,344,21.2,65,1.05
CpG: 19,chr4,132796274,132796477,203,19,137,18.7,67.5,0.82
CpG: 30,chr4,132843061,132843386,325,30,214,18.5,65.8,0.88
CpG: 71,chr4,132884076,132884786,710,71,478,20,67.3,0.89
CpG: 85,chr4,132922102,132922982,880,85,527,19.3,59.9,1.08
CpG: 137,chr4,133010953,133012611,1658,137,924,16.5,55.7,1.06
CpG: 142,chr4,133038498,133039640,1142,142,838,24.9,73.4,0.92
CpG: 25,chr4,133061632,133061994,362,25,241,13.8,66.6,0.64
CpG: 46,chr4,133085210,133085645,435,46,318,21.1,73.1,0.8
CpG: 52,chr4,133130364,133130866,502,52,336,20.7,66.9,0.96
CpG: 22,chr4,133200291,133200619,328,22,216,13.4,65.9,0.63
CpG: 44,chr4,133212347,133212751,404,44,258,21.8,63.9,1.07
CpG: 24,chr4,133220775,133221025,250,24,176,19.2,70.4,0.81
CpG: 56,chr4,133240978,133241501,523,56,361,21.4,69,0.9
CpG: 24,chr4,133250810,133251146,336,24,203,14.3,60.4,0.78
CpG: 22,chr4,133251356,133251577,221,22,131,19.9,59.3,1.15
CpG: 57,chr4,133277477,133277965,488,57,324,23.4,66.4,1.07
CpG: 90,chr4,133338826,133339662,836,90,604,21.5,72.2,0.84
CpG: 29,chr4,133369668,133370011,343,29,232,16.9,67.6,0.74
CpG: 19,chr4,133468184,133468388,204,19,142,18.6,69.6,0.77
CpG: 17,chr4,133479733,133479960,227,17,134,15,59,0.86
CpG: 38,chr4,133480087,133480540,453,38,300,16.8,66.2,0.77
CpG: 38,chr4,133486288,133486835,547,38,331,13.9,60.5,0.76
CpG: 86,chr4,133497674,133498596,922,86,548,18.7,59.4,1.06
CpG: 63,chr4,133518939,133519569,630,63,396,20,62.9,1.03
CpG: 66,chr4,133545659,133546166,507,66,366,26,72.2,1.01
CpG: 58,chr4,133574704,133575240,536,58,369,21.6,68.8,0.91
CpG: 57,chr4,133584165,133584832,667,57,428,17.1,64.2,0.83
CpG: 45,chr4,133599677,133600068,391,45,279,23,71.4,0.9
CpG: 26,chr4,133601326,133601686,360,26,217,14.4,60.3,0.82
CpG: 33,chr4,133632934,133633193,259,33,191,25.5,73.7,1.04
CpG: 63,chr4,133672331,133672949,618,63,413,20.4,66.8,0.91
CpG: 217,chr4,133752369,133754678,2309,217,1413,18.8,61.2,1
CpG: 30,chr4,133756586,133756944,358,30,229,16.8,64,0.82
CpG: 167,chr4,133813201,133814600,1399,167,983,23.9,70.3,0.97
CpG: 61,chr4,133887572,133888035,463,61,355,26.3,76.7,0.92
CpG: 53,chr4,133910569,133911216,647,53,427,16.4,66,0.75
CpG: 146,chr4,133967153,133968425,1272,146,887,23,69.7,0.95
CpG: 33,chr4,134000825,134001142,317,33,203,20.8,64,1.02
CpG: 20,chr4,134072901,134073113,212,20,138,18.9,65.1,0.9
CpG: 30,chr4,134081829,134082143,314,30,217,19.1,69.1,0.8
CpG: 33,chr4,134102576,134102911,335,33,223,19.7,66.6,0.89
CpG: 35,chr4,134128535,134128863,328,35,234,21.3,71.3,0.84
CpG: 82,chr4,134186471,134187365,894,82,575,18.3,64.3,0.89
CpG: 55,chr4,134245232,134245791,559,55,379,19.7,67.8,0.86
CpG: 27,chr4,134249746,134249967,221,27,162,24.4,73.3,0.91
CpG: 91,chr4,134251303,134252137,834,91,574,21.8,68.8,0.92
CpG: 148,chr4,134286686,134288017,1331,148,965,22.2,72.5,0.85
CpG: 47,chr4,134343011,134343491,480,47,329,19.6,68.5,0.85
CpG: 94,chr4,134468273,134469158,885,94,642,21.2,72.5,0.83
CpG: 16,chr4,134506932,134507142,210,16,132,15.2,62.9,0.77
CpG: 39,chr4,134510936,134511296,360,39,245,21.7,68.1,1.03
CpG: 120,chr4,134534401,134535494,1093,120,760,22,69.5,0.92
CpG: 40,chr4,134551932,134552144,212,40,181,37.7,85.4,1.06
CpG: 175,chr4,134703019,134704721,1702,175,1169,20.6,68.7,0.87
CpG: 60,chr4,134767495,134768123,628,60,399,19.1,63.5,0.95
CpG: 182,chr4,134852470,134854198,1728,182,1071,21.1,62,1.1
CpG: 51,chr4,134914679,134915086,407,51,283,25.1,69.5,1.04
CpG: 123,chr4,134923416,134924408,992,123,659,24.8,66.4,1.12
CpG: 58,chr4,134930835,134931469,634,58,427,18.3,67.4,0.82
CpG: 99,chr4,135152075,135153102,1027,99,588,19.3,57.3,1.18
CpG: 41,chr4,135175324,135175822,498,41,350,16.5,70.3,0.7
CpG: 40,chr4,135206126,135206553,427,40,284,18.7,66.5,0.85
CpG: 23,chr4,135218472,135218798,326,23,191,14.1,58.6,0.82
CpG: 117,chr4,135272183,135273228,1045,117,747,22.4,71.5,0.88
CpG: 123,chr4,135352376,135353707,1331,123,819,18.5,61.5,0.98
CpG: 26,chr4,135398084,135398364,280,26,206,18.6,73.6,0.78
CpG: 77,chr4,135433567,135434340,773,77,533,19.9,69,0.84
CpG: 45,chr4,135494611,135495199,588,45,376,15.3,63.9,0.76
CpG: 20,chr4,135570216,135570449,233,20,134,17.2,57.5,1.18
CpG: 22,chr4,135573297,135573601,304,22,184,14.5,60.5,0.79
CpG: 112,chr4,135855591,135856608,1017,112,674,22,66.3,1.01
CpG: 18,chr4,135856857,135857077,220,18,115,16.4,52.3,1.25
CpG: 60,chr4,135873511,135874137,626,60,420,19.2,67.1,0.85
CpG: 15,chr4,135916713,135916922,209,15,128,14.4,61.2,0.77
CpG: 49,chr4,135920687,135921263,576,49,363,17,63,0.87
CpG: 31,chr4,135946396,135946782,386,31,253,16.1,65.5,0.76
CpG: 57,chr4,135963545,135964223,678,57,445,16.8,65.6,0.78
CpG: 35,chr4,135972388,135972692,304,35,219,23,72,0.96
CpG: 82,chr4,135986908,135987482,574,82,422,28.6,73.5,1.06
CpG: 20,chr4,135997443,135997666,223,20,138,17.9,61.9,0.94
CpG: 87,chr4,136021145,136021965,820,87,548,21.2,66.8,0.97
CpG: 22,chr4,136081948,136082171,223,22,155,19.7,69.5,0.84
CpG: 31,chr4,136135119,136135476,357,31,245,17.4,68.6,0.74
CpG: 93,chr4,136143591,136144904,1313,93,800,14.2,60.9,0.77
CpG: 27,chr4,136147800,136148080,280,27,166,19.3,59.3,1.1
CpG: 21,chr4,136148411,136148656,245,21,168,17.1,68.6,0.79
CpG: 95,chr4,136172265,136173217,952,95,603,20,63.3,1
CpG: 44,chr4,136206183,136206663,480,44,333,18.3,69.4,0.82
CpG: 60,chr4,136247921,136248706,785,60,518,15.3,66,0.73
CpG: 75,chr4,136290193,136290992,799,75,514,18.8,64.3,0.91
CpG: 133,chr4,136310469,136311737,1268,133,890,21,70.2,0.85
CpG: 66,chr4,136424467,136425144,677,66,496,19.5,73.3,0.74
CpG: 20,chr4,136442896,136443175,279,20,159,14.3,57,0.94
CpG: 49,chr4,136462358,136462763,405,49,296,24.2,73.1,0.91
CpG: 109,chr4,136469699,136470753,1054,109,680,20.7,64.5,1.04
CpG: 106,chr4,136602045,136602906,861,106,603,24.6,70,1.03
CpG: 95,chr4,136637247,136638059,812,95,539,23.4,66.4,1.06
CpG: 23,chr4,136693800,136694036,236,23,151,19.5,64,0.95
CpG: 31,chr4,136755556,136755848,292,31,198,21.2,67.8,0.92
CpG: 42,chr4,136770937,136771547,610,42,363,13.8,59.5,0.78
CpG: 133,chr4,136834922,136836385,1463,133,949,18.2,64.9,0.87
CpG: 20,chr4,136880487,136880738,251,20,146,15.9,58.2,0.95
CpG: 48,chr4,136945665,136946301,636,48,393,15.1,61.8,0.79
CpG: 74,chr4,137048119,137048880,761,74,487,19.4,64,0.95
CpG: 129,chr4,137276782,137278126,1344,129,832,19.2,61.9,1.01
CpG: 37,chr4,137296349,137296787,438,37,280,16.9,63.9,0.83
CpG: 96,chr4,137356935,137357836,901,96,590,21.3,65.5,1
CpG: 40,chr4,137388147,137388569,422,40,264,19,62.6,0.97
CpG: 74,chr4,137468338,137469230,892,74,563,16.6,63.1,0.86
CpG: 26,chr4,137518397,137518737,340,26,229,15.3,67.4,0.68
CpG: 32,chr4,137578342,137578703,361,32,235,17.7,65.1,0.87
CpG: 105,chr4,137593666,137594789,1123,105,681,18.7,60.6,1.04
CpG: 35,chr4,137664610,137664959,349,35,239,20.1,68.5,0.86
CpG: 46,chr4,137681527,137681896,369,46,271,24.9,73.4,0.95
CpG: 39,chr4,137707348,137707652,304,39,228,25.7,75,0.91
CpG: 60,chr4,137795866,137796483,617,60,402,19.4,65.2,0.92
CpG: 59,chr4,137861990,137862614,624,59,431,18.9,69.1,0.8
CpG: 48,chr4,137913447,137913936,489,48,338,19.6,69.1,0.83
CpG: 19,chr4,137957986,137958194,208,19,127,18.3,61.1,0.99
CpG: 90,chr4,137992964,137993729,765,90,513,23.5,67.1,1.05
CpG: 32,chr4,137993957,137994345,388,32,235,16.5,60.6,0.91
CpG: 153,chr4,138216399,138217685,1286,153,838,23.8,65.2,1.13
CpG: 62,chr4,138250166,138250804,638,62,420,19.4,65.8,0.9
CpG: 59,chr4,138262131,138262776,645,59,351,18.3,54.4,1.24
CpG: 62,chr4,138304654,138305288,634,62,428,19.6,67.5,0.86
CpG: 67,chr4,138325750,138326357,607,67,430,22.1,70.8,0.89
CpG: 163,chr4,138394887,138396561,1674,163,1140,19.5,68.1,0.84
CpG: 49,chr4,138434522,138435002,480,49,325,20.4,67.7,0.89
CpG: 145,chr4,138453999,138455589,1590,145,932,18.2,58.6,1.07
CpG: 79,chr4,138913422,138914024,602,79,449,26.2,74.6,0.96
CpG: 43,chr4,138973021,138973444,423,43,310,20.3,73.3,0.76
CpG: 122,chr4,139074068,139075732,1664,122,1037,14.7,62.3,0.78
CpG: 87,chr4,139092483,139093242,759,87,513,22.9,67.6,1.01
CpG: 104,chr4,139130154,139131155,1001,104,639,20.8,63.8,1.05
CpG: 72,chr4,139192422,139193198,776,72,514,18.6,66.2,0.85
CpG: 86,chr4,139310306,139311145,839,86,593,20.5,70.7,0.82
CpG: 24,chr4,139346058,139346304,246,24,167,19.5,67.9,0.86
CpG: 58,chr4,139352178,139352749,571,58,393,20.3,68.8,0.86
CpG: 70,chr4,139380374,139380991,617,70,401,22.7,65,1.08
CpG: 153,chr4,139574215,139575731,1516,153,994,20.2,65.6,0.94
CpG: 17,chr4,139604975,139605198,223,17,127,15.2,57,0.94
CpG: 24,chr4,139642009,139642236,227,24,150,21.1,66.1,0.99
CpG: 23,chr4,139669053,139669338,285,23,181,16.1,63.5,0.81
CpG: 78,chr4,139821149,139821893,744,78,488,21,65.6,0.99
CpG: 53,chr4,139823597,139824241,644,53,393,16.5,61,0.9
CpG: 21,chr4,139828451,139828698,247,21,138,17,55.9,1.1
CpG: 150,chr4,139831505,139833545,2040,150,1175,14.7,57.6,0.89
CpG: 21,chr4,139965565,139965837,272,21,171,15.4,62.9,0.79
CpG: 21,chr4,140034425,140034657,232,21,160,18.1,69,0.78
CpG: 23,chr4,140109300,140109581,281,23,167,16.4,59.4,0.94
CpG: 29,chr4,140244413,140244774,361,29,240,16.1,66.5,0.75
CpG: 52,chr4,140246229,140246774,545,52,354,19.1,65,0.91
CpG: 29,chr4,140515036,140515425,389,29,260,14.9,66.8,0.67
CpG: 148,chr4,140701256,140703082,1826,148,924,16.2,50.6,1.3
CpG: 29,chr4,140906255,140906539,284,29,194,20.4,68.3,0.88
CpG: 45,chr4,140961221,140961669,448,45,305,20.1,68.1,0.88
CpG: 57,chr4,140986757,140987245,488,57,352,23.4,72.1,0.9
CpG: 24,chr4,141010538,141010775,237,24,172,20.3,72.6,0.8
CpG: 32,chr4,141025205,141025506,301,32,229,21.3,76.1,0.76
CpG: 90,chr4,141060105,141061133,1028,90,654,17.5,63.6,0.88
CpG: 61,chr4,141077834,141078468,634,61,420,19.2,66.2,0.88
CpG: 58,chr4,141139220,141139895,675,58,467,17.2,69.2,0.74
CpG: 91,chr4,141147759,141148594,835,91,560,21.8,67.1,0.97
CpG: 21,chr4,141247387,141247681,294,21,184,14.3,62.6,0.74
CpG: 38,chr4,141247827,141248092,265,38,200,28.7,75.5,1.01
CpG: 41,chr4,141291605,141291950,345,41,248,23.8,71.9,0.93
CpG: 59,chr4,141301278,141301859,581,59,393,20.3,67.6,0.9
CpG: 44,chr4,141308453,141309078,625,44,381,14.1,61,0.76
CpG: 50,chr4,141368138,141368541,403,50,291,24.8,72.2,0.95
CpG: 25,chr4,141382365,141382627,262,25,177,19.1,67.6,0.86
CpG: 17,chr4,141425841,141426053,212,17,141,16,66.5,0.73
CpG: 87,chr4,141444595,141445324,729,87,501,23.9,68.7,1.01
CpG: 16,chr4,141464412,141464619,207,16,136,15.5,65.7,0.72
CpG: 19,chr4,141472906,141473177,271,19,178,14,65.7,0.65
CpG: 22,chr4,141477452,141477770,318,22,179,13.8,56.3,0.88
CpG: 60,chr4,141478340,141479142,802,60,494,15,61.6,0.79
CpG: 210,chr4,141536261,141538862,2601,210,1472,16.1,56.6,1.01
CpG: 141,chr4,141545530,141547131,1601,141,953,17.6,59.5,1
CpG: 65,chr4,141663589,141664374,785,65,426,16.6,54.3,1.13
CpG: 75,chr4,141722774,141723537,763,75,444,19.7,58.2,1.16
CpG: 65,chr4,141790323,141790964,641,65,416,20.3,64.9,0.96
CpG: 68,chr4,141793389,141794029,640,68,419,21.2,65.5,1.08
CpG: 52,chr4,141874632,141875032,400,52,287,26,71.8,1.03
CpG: 69,chr4,142083833,142084692,859,69,574,16.1,66.8,0.72
CpG: 17,chr4,142141536,142141740,204,17,125,16.7,61.3,0.89
CpG: 85,chr4,142238827,142239522,695,85,486,24.5,69.9,1.03
CpG: 73,chr4,143161707,143162392,685,73,405,21.3,59.1,1.22
CpG: 114,chr4,143211874,143212914,1040,114,651,21.9,62.6,1.13
CpG: 66,chr4,143349995,143350733,738,66,493,17.9,66.8,0.81
CpG: 36,chr4,143389371,143389623,252,36,192,28.6,76.2,1.02
CpG: 40,chr4,143394306,143394853,547,40,312,14.6,57,0.91
CpG: 50,chr4,144892255,144892878,623,50,369,16.1,59.2,0.93
CpG: 30,chr4,144893496,144893847,351,30,230,17.1,65.5,0.83
CpG: 53,chr4,145194633,145195129,496,53,342,21.4,69,0.9
CpG: 30,chr4,145246400,145246821,421,30,270,14.3,64.1,0.7
CpG: 98,chr4,145463541,145464437,896,98,616,21.9,68.8,0.93
CpG: 20,chr4,145577090,145577327,237,20,136,16.9,57.4,1.03
CpG: 108,chr4,145640284,145641297,1013,108,677,21.3,66.8,0.96
CpG: 24,chr4,145730095,145730360,265,24,157,18.1,59.2,1.04
CpG: 99,chr4,145745012,145745849,837,99,559,23.7,66.8,1.06
CpG: 41,chr4,145774281,145774712,431,41,293,19,68,0.82
CpG: 95,chr4,145836641,145837464,823,95,591,23.1,71.8,0.9
CpG: 98,chr4,146067084,146067925,841,98,595,23.3,70.7,0.93
CpG: 24,chr4,146224546,146224811,265,24,157,18.1,59.2,1.04
CpG: 98,chr4,146239293,146240087,794,98,529,24.7,66.6,1.11
CpG: 41,chr4,146263186,146263624,438,41,298,18.7,68,0.81
CpG: 94,chr4,146474751,146475577,826,94,592,22.8,71.7,0.89
CpG: 23,chr4,146564970,146565235,265,23,157,17.4,59.2,1
CpG: 100,chr4,146579894,146580732,838,100,560,23.9,66.8,1.07
CpG: 40,chr4,146603767,146604205,438,40,297,18.3,67.8,0.8
CpG: 19,chr4,146750402,146750605,203,19,124,18.7,61.1,1.01
CpG: 74,chr4,146932301,146932990,689,74,466,21.5,67.6,0.94
CpG: 104,chr4,146941727,146942646,919,104,640,22.6,69.6,0.93
CpG: 22,chr4,147086869,147087134,265,22,159,16.6,60,0.93
CpG: 90,chr4,147101712,147102460,748,90,489,24.1,65.4,1.13
CpG: 40,chr4,147124818,147125246,428,40,303,18.7,70.8,0.75
CpG: 72,chr4,147187275,147187953,678,72,475,21.2,70.1,0.87
CpG: 109,chr4,147275137,147276116,979,109,661,22.3,67.5,0.98
CpG: 77,chr4,147406905,147407548,643,77,440,24,68.4,1.03
CpG: 47,chr4,147443039,147443461,422,47,318,22.3,75.4,0.79
CpG: 86,chr4,147738466,147739154,688,86,492,25,71.5,0.98
CpG: 25,chr4,147868367,147868668,301,25,193,16.6,64.1,0.81
CpG: 50,chr4,147904465,147904988,523,50,361,19.1,69,0.81
CpG: 38,chr4,147936464,147936810,346,38,248,22,71.7,0.87
CpG: 99,chr4,147940780,147941675,895,99,635,22.1,70.9,0.88
CpG: 73,chr4,148038364,148039241,877,73,580,16.6,66.1,0.77
CpG: 18,chr4,148068299,148068522,223,18,153,16.1,68.6,0.69
CpG: 38,chr4,148087727,148088104,377,38,251,20.2,66.6,0.92
CpG: 83,chr4,148130562,148131294,732,83,542,22.7,74,0.86
CpG: 58,chr4,148140075,148140811,736,58,458,15.8,62.2,0.82
CpG: 51,chr4,148151586,148151984,398,51,298,25.6,74.9,0.94
CpG: 76,chr4,148159635,148160791,1156,76,744,13.1,64.4,0.66
CpG: 23,chr4,148164192,148164518,326,23,219,14.1,67.2,0.63
CpG: 61,chr4,148271442,148272130,688,61,420,17.7,61,0.96
CpG: 70,chr4,148287455,148288257,802,70,522,17.5,65.1,0.83
CpG: 43,chr4,148444308,148444830,522,43,346,16.5,66.3,0.75
CpG: 58,chr4,148448197,148448868,671,58,431,17.3,64.2,0.84
CpG: 60,chr4,148558393,148558893,500,60,346,24,69.2,1
CpG: 79,chr4,148591174,148592060,886,79,574,17.8,64.8,0.86
CpG: 87,chr4,148626273,148627156,883,87,579,19.7,65.6,0.92
CpG: 31,chr4,148724379,148724585,206,31,158,30.1,76.7,1.04
CpG: 36,chr4,148742737,148742987,250,36,181,28.8,72.4,1.14
CpG: 195,chr4,148804156,148807112,2956,195,1777,13.2,60.1,0.75
CpG: 44,chr4,148890978,148891502,524,44,357,16.8,68.1,0.72
CpG: 161,chr4,148900324,148901765,1441,161,912,22.3,63.3,1.12
CpG: 22,chr4,148938649,148938905,256,22,176,17.2,68.8,0.75
CpG: 90,chr4,148951660,148952711,1051,90,636,17.1,60.5,0.94
CpG: 42,chr4,149099516,149099929,413,42,288,20.3,69.7,0.84
CpG: 29,chr4,149104062,149104416,354,29,226,16.4,63.8,0.81
CpG: 48,chr4,149137283,149137714,431,48,294,22.3,68.2,0.98
CpG: 65,chr4,149166255,149166979,724,65,482,18,66.6,0.81
CpG: 141,chr4,149307092,149308226,1134,141,814,24.9,71.8,0.97
CpG: 73,chr4,149426062,149426863,801,73,557,18.2,69.5,0.76
CpG: 27,chr4,149445252,149445609,357,27,223,15.1,62.5,0.79
CpG: 25,chr4,149457288,149457560,272,25,173,18.4,63.6,0.91
CpG: 51,chr4,149485048,149485581,533,51,364,19.1,68.3,0.82
CpG: 48,chr4,149518174,149518585,411,48,250,23.4,60.8,1.29
CpG: 132,chr4,149586212,149587546,1334,132,810,19.8,60.7,1.12
CpG: 17,chr4,149655381,149655616,235,17,154,14.5,65.5,0.71
CpG: 20,chr4,149698416,149698655,239,20,160,16.7,66.9,0.75
CpG: 72,chr4,149737666,149738240,574,72,390,25.1,67.9,1.09
CpG: 115,chr4,149773480,149774404,924,115,670,24.9,72.5,0.95
CpG: 85,chr4,149954151,149955085,934,85,623,18.2,66.7,0.82
CpG: 73,chr4,150008579,150009127,548,73,408,26.6,74.5,0.98
CpG: 42,chr4,150048613,150049082,469,42,307,17.9,65.5,0.84
CpG: 79,chr4,150087150,150088104,954,79,637,16.6,66.8,0.76
CpG: 22,chr4,150101486,150101760,274,22,173,16.1,63.1,0.81
CpG: 76,chr4,150236643,150237472,829,76,572,18.3,69,0.77
CpG: 58,chr4,150281120,150281719,599,58,370,19.4,61.8,1.03
CpG: 44,chr4,150371775,150372256,481,44,312,18.3,64.9,0.87
CpG: 56,chr4,150569249,150570024,775,56,434,14.5,56,0.93
CpG: 19,chr4,150651974,150652190,216,19,131,17.6,60.6,0.96
CpG: 104,chr4,150854863,150855682,819,104,548,25.4,66.9,1.14
CpG: 53,chr4,150909546,150910075,529,53,373,20,70.5,0.83
CpG: 53,chr4,150914248,150914733,485,53,323,21.9,66.6,0.99
CpG: 83,chr4,151044309,151045059,750,83,523,22.1,69.7,0.91
CpG: 111,chr4,151057443,151058213,770,111,570,28.8,74,1.05
CpG: 149,chr4,151107623,151108902,1279,149,822,23.3,64.3,1.17
CpG: 70,chr4,151128692,151129563,871,70,551,16.1,63.3,0.8
CpG: 20,chr4,151485834,151486067,233,20,129,17.2,55.4,1.13
CpG: 182,chr4,151861030,151862873,1843,182,1150,19.8,62.4,1.02
CpG: 105,chr4,151933579,151934566,987,105,684,21.3,69.3,0.89
CpG: 41,chr4,151988595,151989048,453,41,303,18.1,66.9,0.81
CpG: 267,chr4,151994656,151997010,2354,267,1610,22.7,68.4,0.98
CpG: 151,chr4,152008622,152009962,1340,151,911,22.5,68,0.98
CpG: 51,chr4,152027356,152027834,478,51,331,21.3,69.2,0.9
CpG: 25,chr4,152032342,152032661,319,25,202,15.7,63.3,0.78
CpG: 92,chr4,152039235,152040025,790,92,531,23.3,67.2,1.03
CpG: 67,chr4,152086473,152087152,679,67,420,19.7,61.9,1.03
CpG: 32,chr4,152115851,152116278,427,32,289,15,67.7,0.66
CpG: 27,chr4,152119528,152119836,308,27,206,17.5,66.9,0.79
CpG: 116,chr4,152125093,152126645,1552,116,982,14.9,63.3,0.75
CpG: 134,chr4,152130681,152132303,1622,134,1095,16.5,67.5,0.73
CpG: 39,chr4,152138441,152138880,439,39,295,17.8,67.2,0.79
CpG: 55,chr4,152151972,152152494,522,55,384,21.1,73.6,0.78
CpG: 22,chr4,152153751,152154043,292,22,172,15.1,58.9,0.88
CpG: 18,chr4,152158618,152158840,222,18,155,16.2,69.8,0.67
CpG: 61,chr4,152159694,152160507,813,61,509,15,62.6,0.77
CpG: 132,chr4,152177596,152178811,1215,132,844,21.7,69.5,0.91
CpG: 62,chr4,152273871,152274518,647,62,409,19.2,63.2,0.98
CpG: 22,chr4,152279912,152280168,256,22,171,17.2,66.8,0.77
CpG: 100,chr4,152282859,152283620,761,100,562,26.3,73.9,0.97
CpG: 68,chr4,152286224,152287219,995,68,642,13.7,64.5,0.67
CpG: 49,chr4,152290245,152290730,485,49,338,20.2,69.7,0.83
CpG: 90,chr4,152296943,152297584,641,90,468,28.1,73,1.06
CpG: 34,chr4,152313056,152313406,350,34,238,19.4,68,0.84
CpG: 32,chr4,152315762,152316101,339,32,214,18.9,63.1,0.95
CpG: 61,chr4,152325664,152326274,610,61,421,20,69,0.85
CpG: 74,chr4,152338344,152339114,770,74,489,19.2,63.5,0.96
CpG: 17,chr4,152363230,152363452,222,17,124,15.3,55.9,0.98
CpG: 85,chr4,152477339,152478334,995,85,644,17.1,64.7,0.82
CpG: 16,chr4,153373924,153374147,223,16,132,14.3,59.2,0.82
CpG: 20,chr4,153432583,153432840,257,20,172,15.6,66.9,0.71
CpG: 166,chr4,153481625,153483437,1812,166,1105,18.3,61,0.98
CpG: 80,chr4,153956902,153957585,683,80,501,23.4,73.4,0.87
CpG: 96,chr4,153974583,153975622,1039,96,685,18.5,65.9,0.85
CpG: 104,chr4,154011684,154012516,832,104,617,25,74.2,0.91
CpG: 24,chr4,154081269,154081526,257,24,176,18.7,68.5,0.83
CpG: 94,chr4,154139682,154140605,923,94,660,20.4,71.5,0.8
CpG: 20,chr4,154141473,154141729,256,20,153,15.6,59.8,0.87
CpG: 32,chr4,154142235,154142556,321,32,213,19.9,66.4,0.91
CpG: 87,chr4,154160330,154161094,764,87,492,22.8,64.4,1.1
CpG: 51,chr4,154170755,154171198,443,51,308,23,69.5,0.95
CpG: 60,chr4,154299702,154300236,534,60,393,22.5,73.6,0.83
CpG: 19,chr4,154341559,154341822,263,19,173,14.4,65.8,0.71
CpG: 272,chr4,154634782,154637997,3215,272,1935,16.9,60.2,0.93
CpG: 35,chr4,154802135,154802612,477,35,267,14.7,56,0.96
CpG: 115,chr4,154855650,154856464,814,115,607,28.3,74.6,1.02
CpG: 102,chr4,154960617,154961702,1085,102,705,18.8,65,0.9
CpG: 86,chr4,154964006,154964786,780,86,531,22.1,68.1,0.96
CpG: 19,chr4,154983836,154984038,202,19,140,18.8,69.3,0.78
CpG: 84,chr4,155042784,155043489,705,84,512,23.8,72.6,0.91
CpG: 38,chr4,155066907,155067202,295,38,210,25.8,71.2,1.02
CpG: 81,chr4,155086015,155086774,759,81,513,21.3,67.6,0.94
CpG: 66,chr4,155150506,155151103,597,66,426,22.1,71.4,0.87
CpG: 138,chr4,155221538,155223260,1722,138,890,16,51.7,1.2
CpG: 52,chr4,155249793,155250286,493,52,345,21.1,70,0.87
CpG: 109,chr4,155360977,155362087,1110,109,731,19.6,65.9,0.9
CpG: 52,chr4,155397650,155398245,595,52,389,17.5,65.4,0.82
CpG: 21,chr4,155409101,155409339,238,21,157,17.6,66,0.83
CpG: 142,chr4,155491035,155492522,1487,142,940,19.1,63.2,0.97
CpG: 63,chr4,155563727,155564293,566,63,400,22.3,70.7,0.9
CpG: 88,chr4,155601254,155602243,989,88,673,17.8,68,0.77
CpG: 76,chr4,155624524,155625149,625,76,416,24.3,66.6,1.1
CpG: 48,chr4,155652957,155653464,507,48,341,18.9,67.3,0.84
CpG: 24,chr4,155654727,155654959,232,24,156,20.7,67.2,0.93
CpG: 66,chr4,155668793,155669506,713,66,471,18.5,66.1,0.85
CpG: 119,chr4,155694128,155695188,1060,119,697,22.5,65.8,1.04
CpG: 84,chr4,155704961,155705774,813,84,519,20.7,63.8,1.02
CpG: 62,chr4,155734827,155735595,768,62,437,16.1,56.9,1.01
CpG: 28,chr4,155739722,155740068,346,28,240,16.2,69.4,0.67
CpG: 59,chr4,155760771,155761212,441,59,313,26.8,71,1.07
CpG: 61,chr4,155770102,155770791,689,61,461,17.7,66.9,0.79
CpG: 37,chr4,155774267,155774715,448,37,289,16.5,64.5,0.8
CpG: 44,chr4,155784197,155784518,321,44,230,27.4,71.7,1.08
CpG: 55,chr4,155803396,155803952,556,55,357,19.8,64.2,0.96
CpG: 93,chr4,155812156,155813036,880,93,562,21.1,63.9,1.04
CpG: 75,chr4,155831291,155832136,845,75,524,17.8,62,0.94
CpG: 69,chr4,155841024,155841974,950,69,538,14.5,56.6,0.91
CpG: 71,chr4,155847388,155848044,656,71,390,21.6,59.5,1.23
CpG: 68,chr4,155869286,155870053,767,68,484,17.7,63.1,0.89
CpG: 172,chr4,155891042,155892676,1634,172,1075,21.1,65.8,0.97
CpG: 89,chr4,155943775,155944477,702,89,486,25.4,69.2,1.08
CpG: 25,chr4,155962385,155962712,327,25,224,15.3,68.5,0.65
CpG: 215,chr4,155991822,155993517,1695,215,1171,25.4,69.1,1.06
CpG: 30,chr4,156034807,156035197,390,30,251,15.4,64.4,0.75
CpG: 43,chr4,156077750,156078203,453,43,319,19,70.4,0.77
CpG: 53,chr4,156109831,156110384,553,53,366,19.2,66.2,0.92
CpG: 145,chr4,156196679,156198055,1376,145,941,21.1,68.4,0.9
CpG: 72,chr4,156203061,156203844,783,72,489,18.4,62.5,0.94
CpG: 20,chr4,156214298,156214575,277,20,169,14.4,61,0.79
CpG: 50,chr4,156234628,156234991,363,50,273,27.5,75.2,1
CpG: 137,chr4,156235837,156237359,1522,137,913,18,60,1.14
CpG: 32,chr5,139460370,139460725,355,32,241,18,67.9,0.8
CpG: 22,chr5,8912765,8913010,245,22,162,18,66.1,0.83
CpG: 111,chr5,35388399,35389468,1069,111,687,20.8,64.3,1.01
CpG: 63,chr5,73006845,73007519,674,63,470,18.7,69.7,0.78
CpG: 59,chr5,123076180,123076770,590,59,415,20,70.3,0.81
CpG: 105,chr5,144965190,144966242,1052,105,613,20,58.3,1.19
CpG: 270,chr5,3340989,3344607,3618,270,2254,14.9,62.3,0.77
CpG: 70,chr5,3543730,3544210,480,70,358,29.2,74.6,1.05
CpG: 72,chr5,3595971,3596682,711,72,465,20.3,65.4,0.95
CpG: 64,chr5,3647295,3647986,691,64,423,18.5,61.2,0.99
CpG: 143,chr5,3802402,3803640,1238,143,852,23.1,68.8,0.98
CpG: 36,chr5,3893719,3894106,387,36,260,18.6,67.2,0.83
CpG: 49,chr5,3928043,3928527,484,49,290,20.2,59.9,1.13
CpG: 87,chr5,4104023,4104867,844,87,579,20.6,68.6,0.88
CpG: 36,chr5,4192186,4192573,387,36,260,18.6,67.2,0.83
CpG: 18,chr5,4755938,4756186,248,18,139,14.5,56,0.92
CpG: 181,chr5,4756413,4758245,1832,181,1249,19.8,68.2,0.85
CpG: 100,chr5,5379912,5380844,932,100,541,21.5,58,1.28
CpG: 74,chr5,5514307,5515012,705,74,480,21,68.1,0.93
CpG: 30,chr5,5559359,5559621,262,30,168,22.9,64.1,1.11
CpG: 40,chr5,5663898,5664351,453,40,295,17.7,65.1,0.83
CpG: 74,chr5,5693744,5694312,568,74,429,26.1,75.5,0.92
CpG: 68,chr5,5749058,5749639,581,68,420,23.4,72.3,0.9
CpG: 38,chr5,7344519,7344993,474,38,306,16,64.6,0.77
CpG: 39,chr5,8056390,8056751,361,39,242,21.6,67,1
CpG: 19,chr5,8367113,8367320,207,19,135,18.4,65.2,0.87
CpG: 50,chr5,8367751,8368260,509,50,348,19.6,68.4,0.84
CpG: 99,chr5,8422144,8423171,1027,99,636,19.3,61.9,1.01
CpG: 85,chr5,8622267,8623253,986,85,610,17.2,61.9,0.91
CpG: 23,chr5,8660244,8660528,284,23,195,16.2,68.7,0.69
CpG: 30,chr5,8798261,8798594,333,30,228,18,68.5,0.78
CpG: 44,chr5,8893613,8894015,402,44,261,21.9,64.9,1.07
CpG: 48,chr5,8996968,8997494,526,48,363,18.3,69,0.77
CpG: 106,chr5,9100472,9101453,981,106,634,21.6,64.6,1.04
CpG: 89,chr5,9161033,9162025,992,89,582,17.9,58.7,1.04
CpG: 39,chr5,9266123,9266516,393,39,279,19.8,71,0.79
CpG: 24,chr5,12383362,12383583,221,24,158,21.7,71.5,0.85
CpG: 20,chr5,14025265,14025475,210,20,131,19,62.4,0.99
CpG: 58,chr5,14514954,14515552,598,58,423,19.4,70.7,0.78
CpG: 119,chr5,15934342,15935336,994,119,666,23.9,67,1.07
CpG: 51,chr5,17574439,17574843,404,51,294,25.2,72.8,0.95
CpG: 119,chr5,18359732,18360748,1016,119,673,23.4,66.2,1.08
CpG: 42,chr5,19226500,19226953,453,42,301,18.5,66.4,0.92
CpG: 25,chr5,19227392,19227747,355,25,228,14.1,64.2,0.72
CpG: 108,chr5,20701875,20702802,927,108,677,23.3,73,0.88
CpG: 138,chr5,20881475,20882771,1296,138,792,21.3,61.1,1.14
CpG: 122,chr5,20950948,20952076,1128,122,720,21.6,63.8,1.06
CpG: 79,chr5,21055181,21056026,845,79,482,18.7,57,1.16
CpG: 28,chr5,21186153,21186505,352,28,242,15.9,68.8,0.71
CpG: 55,chr5,21425051,21425567,516,55,360,21.3,69.8,0.89
CpG: 25,chr5,21675772,21676020,248,25,150,20.2,60.5,1.11
CpG: 71,chr5,21701205,21701888,683,71,468,20.8,68.5,0.89
CpG: 34,chr5,21737170,21737408,238,34,181,28.6,76.1,0.99
CpG: 66,chr5,21784637,21785341,704,66,484,18.8,68.8,0.8
CpG: 43,chr5,21786620,21787054,434,43,282,19.8,65,0.94
CpG: 155,chr5,22344053,22345377,1324,155,880,23.4,66.5,1.06
CpG: 43,chr5,22745982,22746550,568,43,329,15.1,57.9,0.9
CpG: 27,chr5,23418355,23418582,227,27,150,23.8,66.1,1.09
CpG: 156,chr5,23432944,23434919,1975,156,1221,15.8,61.8,0.83
CpG: 175,chr5,23674896,23676464,1568,175,1044,22.3,66.6,1.01
CpG: 55,chr5,23712268,23712812,544,55,361,20.2,66.4,0.92
CpG: 66,chr5,23783245,23783767,522,66,348,25.3,66.7,1.15
CpG: 29,chr5,23787655,23788003,348,29,227,16.7,65.2,0.79
CpG: 52,chr5,23831090,23831552,462,52,296,22.5,64.1,1.1
CpG: 26,chr5,23844075,23844318,243,26,154,21.4,63.4,1.07
CpG: 59,chr5,23850425,23850978,553,59,380,21.3,68.7,0.91
CpG: 68,chr5,24029958,24030612,654,68,444,20.8,67.9,0.91
CpG: 74,chr5,24100444,24101202,758,74,473,19.5,62.4,1
CpG: 45,chr5,24164871,24165339,468,45,313,19.2,66.9,0.86
CpG: 28,chr5,24324955,24325266,311,28,201,18,64.6,0.87
CpG: 66,chr5,24348246,24348835,589,66,411,22.4,69.8,0.92
CpG: 81,chr5,24351224,24351884,660,81,435,24.5,65.9,1.14
CpG: 23,chr5,24383418,24383729,311,23,193,14.8,62.1,0.77
CpG: 76,chr5,24387710,24388430,720,76,504,21.1,70,0.87
CpG: 26,chr5,24423490,24423800,310,26,199,16.8,64.2,0.82
CpG: 62,chr5,24425082,24425798,716,62,446,17.3,62.3,0.94
CpG: 53,chr5,24444881,24445355,474,53,350,22.4,73.8,0.83
CpG: 24,chr5,24447721,24447978,257,24,175,18.7,68.1,0.82
CpG: 120,chr5,24474311,24475211,900,120,656,26.7,72.9,1
CpG: 23,chr5,24482373,24482638,265,23,190,17.4,71.7,0.68
CpG: 25,chr5,24485138,24485418,280,25,198,17.9,70.7,0.72
CpG: 128,chr5,24525995,24527269,1274,128,710,20.1,55.7,1.31
CpG: 69,chr5,24576845,24577573,728,69,479,19,65.8,0.96
CpG: 43,chr5,24586485,24587026,541,43,340,15.9,62.8,0.82
CpG: 44,chr5,24598539,24598982,443,44,334,19.9,75.4,0.71
CpG: 95,chr5,24601556,24602751,1195,95,740,15.9,61.9,0.83
CpG: 47,chr5,24604592,24604970,378,47,288,24.9,76.2,0.88
CpG: 38,chr5,24685599,24686046,447,38,271,17,60.6,1.04
CpG: 64,chr5,24730096,24730842,746,64,499,17.2,66.9,0.77
CpG: 34,chr5,24750762,24751161,399,34,268,17,67.2,0.76
CpG: 140,chr5,24841869,24843254,1385,140,856,20.2,61.8,1.06
CpG: 115,chr5,24907876,24909063,1187,115,793,19.4,66.8,0.87
CpG: 125,chr5,25099569,25101217,1648,125,1032,15.2,62.6,0.78
CpG: 56,chr5,25222801,25223111,310,56,243,36.1,78.4,1.2
CpG: 209,chr5,25497707,25500021,2314,209,1284,18.1,55.5,1.18
CpG: 89,chr5,25529347,25530391,1044,89,652,17,62.5,0.88
CpG: 42,chr5,25705557,25705902,345,42,237,24.3,68.7,1.05
CpG: 35,chr5,25759911,25760231,320,35,233,21.9,72.8,0.83
CpG: 43,chr5,25956754,25957214,460,43,304,18.7,66.1,0.86
CpG: 29,chr5,26070670,26071016,346,29,217,16.8,62.7,0.86
CpG: 29,chr5,26817538,26817886,348,29,240,16.7,69,0.7
CpG: 52,chr5,27049331,27049871,540,52,362,19.3,67,0.87
CpG: 102,chr5,27790888,27791823,935,102,611,21.8,65.3,1.02
CpG: 96,chr5,28070975,28071794,819,96,578,23.4,70.6,0.94
CpG: 36,chr5,28118167,28118674,507,36,278,14.2,54.8,0.98
CpG: 205,chr5,28165340,28167239,1899,205,1225,21.6,64.5,1.05
CpG: 79,chr5,28209589,28210387,798,79,526,19.8,65.9,0.92
CpG: 133,chr5,28316543,28317596,1053,133,715,25.3,67.9,1.1
CpG: 142,chr5,28457778,28459206,1428,142,912,19.9,63.9,0.98
CpG: 24,chr5,28459872,28460090,218,24,150,22,68.8,0.93
CpG: 97,chr5,28464442,28465440,998,97,678,19.4,67.9,0.85
CpG: 28,chr5,28466765,28467039,274,28,179,20.4,65.3,0.96
CpG: 78,chr5,29195493,29196293,800,78,491,19.5,61.4,1.05
CpG: 55,chr5,29378026,29378522,496,55,335,22.2,67.5,0.97
CpG: 78,chr5,29434643,29435395,752,78,500,20.7,66.5,0.94
CpG: 61,chr5,29467766,29468321,555,61,382,22,68.8,0.93
CpG: 29,chr5,29474028,29474397,369,29,228,15.7,61.8,0.86
CpG: 108,chr5,29477532,29478784,1252,108,798,17.3,63.7,0.86
CpG: 99,chr5,29568977,29569795,818,99,503,24.2,61.5,1.3
CpG: 68,chr5,29735701,29736457,756,68,452,18,59.8,1.01
CpG: 34,chr5,30073225,30073684,459,34,290,14.8,63.2,0.76
CpG: 36,chr5,30105151,30105459,308,36,228,23.4,74,0.87
CpG: 118,chr5,30113936,30114938,1002,118,687,23.6,68.6,1
CpG: 73,chr5,30154814,30155704,890,73,544,16.4,61.1,0.88
CpG: 59,chr5,30232464,30233020,556,59,346,21.2,62.2,1.12
CpG: 77,chr5,30588172,30589043,871,77,532,17.7,61.1,0.95
CpG: 90,chr5,30621902,30622831,929,90,608,19.4,65.4,0.91
CpG: 34,chr5,30647868,30648374,506,34,292,13.4,57.7,0.81
CpG: 33,chr5,30666879,30667215,336,33,230,19.6,68.5,0.84
CpG: 59,chr5,30711372,30711987,615,59,394,19.2,64.1,0.94
CpG: 59,chr5,30814502,30815049,547,59,391,21.6,71.5,0.86
CpG: 60,chr5,30869449,30869993,544,60,384,22.1,70.6,0.93
CpG: 27,chr5,30887640,30888006,366,27,214,14.8,58.5,0.87
CpG: 42,chr5,30888743,30889160,417,42,298,20.1,71.5,0.79
CpG: 59,chr5,30907377,30907958,581,59,369,20.3,63.5,1.01
CpG: 24,chr5,30921398,30921713,315,24,180,15.2,57.1,0.94
CpG: 34,chr5,30945306,30945586,280,34,214,24.3,76.4,0.85
CpG: 19,chr5,30949878,30950098,220,19,145,17.3,65.9,0.83
CpG: 55,chr5,30959961,30960423,462,55,308,23.8,66.7,1.11
CpG: 44,chr5,31048257,31048709,452,44,305,19.5,67.5,0.86
CpG: 48,chr5,31054724,31055202,478,48,329,20.1,68.8,0.86
CpG: 40,chr5,31068455,31069056,601,40,376,13.3,62.6,0.68
CpG: 106,chr5,31092576,31093652,1076,106,748,19.7,69.5,0.82
CpG: 17,chr5,31094256,31094492,236,17,129,14.4,54.7,0.97
CpG: 58,chr5,31094856,31095652,796,58,489,14.6,61.4,0.78
CpG: 23,chr5,31137309,31137593,284,23,188,16.2,66.2,0.75
CpG: 58,chr5,31138048,31138625,577,58,390,20.1,67.6,0.88
CpG: 66,chr5,31179574,31180265,691,66,416,19.1,60.2,1.06
CpG: 85,chr5,31192686,31193778,1092,85,696,15.6,63.7,0.77
CpG: 19,chr5,31200413,31200621,208,19,141,18.3,67.8,0.82
CpG: 38,chr5,31201998,31202356,358,38,251,21.2,70.1,0.91
CpG: 88,chr5,31220035,31221003,968,88,629,18.2,65,0.86
CpG: 65,chr5,31240746,31241282,536,65,401,24.3,74.8,0.88
CpG: 51,chr5,31251600,31252150,550,51,384,18.5,69.8,0.78
CpG: 31,chr5,31291014,31291324,310,31,182,20,58.7,1.17
CpG: 56,chr5,31295455,31295933,478,56,365,23.4,76.4,0.81
CpG: 17,chr5,31452362,31452578,216,17,131,15.7,60.6,0.89
CpG: 34,chr5,31494597,31494983,386,34,241,17.6,62.4,0.92
CpG: 50,chr5,31526954,31527650,696,50,424,14.4,60.9,0.77
CpG: 34,chr5,31613930,31614235,305,34,213,22.3,69.8,0.93
CpG: 83,chr5,31697439,31698239,800,83,544,20.8,68,0.91
CpG: 54,chr5,32133003,32133597,594,54,402,18.2,67.7,0.8
CpG: 194,chr5,32134922,32136838,1916,194,1176,20.3,61.4,1.08
CpG: 104,chr5,32458790,32459765,975,104,629,21.3,64.5,1.07
CpG: 118,chr5,32610859,32611847,988,118,716,23.9,72.5,0.91
CpG: 55,chr5,32713775,32714424,649,55,382,16.9,58.9,0.98
CpG: 46,chr5,32785381,32785803,422,46,293,21.8,69.4,0.92
CpG: 38,chr5,32854042,32854407,365,38,263,20.8,72.1,0.87
CpG: 46,chr5,32863393,32863942,549,46,345,16.8,62.8,0.88
CpG: 112,chr5,33018415,33019443,1028,112,646,21.8,62.8,1.1
CpG: 33,chr5,33104210,33104613,403,33,258,16.4,64,0.8
CpG: 112,chr5,33274113,33275369,1256,112,752,17.8,59.9,1
CpG: 112,chr5,33335099,33336258,1159,112,789,19.3,68.1,0.84
CpG: 54,chr5,33378451,33379000,549,54,353,19.7,64.3,0.95
CpG: 377,chr5,33430439,33435552,5113,377,3042,14.7,59.5,0.83
CpG: 49,chr5,33442909,33443471,562,49,371,17.4,66,0.81
CpG: 23,chr5,33540257,33540554,297,23,159,15.5,53.5,1.08
CpG: 117,chr5,33629015,33629950,935,117,661,25,70.7,1
CpG: 89,chr5,33651871,33652808,937,89,624,19,66.6,0.86
CpG: 97,chr5,33657577,33658835,1258,97,779,15.4,61.9,0.8
CpG: 20,chr5,33692518,33692773,255,20,161,15.7,63.1,0.79
CpG: 66,chr5,33695267,33695842,575,66,407,23,70.8,0.92
CpG: 208,chr5,33721592,33723909,2317,208,1527,18,65.9,0.84
CpG: 72,chr5,33782232,33782883,651,72,463,22.1,71.1,0.87
CpG: 195,chr5,33819886,33821714,1828,195,1080,21.3,59.1,1.23
CpG: 96,chr5,33935854,33936693,839,96,560,22.9,66.7,1.04
CpG: 107,chr5,33983124,33984139,1015,107,703,21.1,69.3,0.89
CpG: 193,chr5,33995739,33997686,1947,193,1197,19.8,61.5,1.05
CpG: 25,chr5,34000807,34001139,332,25,209,15.1,63,0.76
CpG: 50,chr5,34169152,34169708,556,50,353,18,63.5,0.93
CpG: 111,chr5,34187045,34188248,1203,111,754,18.5,62.7,0.94
CpG: 150,chr5,34287189,34288726,1537,150,1013,19.5,65.9,0.9
CpG: 26,chr5,34326947,34327301,354,26,233,14.7,65.8,0.68
CpG: 102,chr5,34336026,34337040,1014,102,648,20.1,63.9,1.01
CpG: 92,chr5,34369580,34370704,1124,92,568,16.4,50.5,1.3
CpG: 63,chr5,34513483,34514111,628,63,429,20.1,68.3,0.89
CpG: 31,chr5,34525706,34526133,427,31,294,14.5,68.9,0.65
CpG: 28,chr5,34549528,34549797,269,28,200,20.8,74.3,0.76
CpG: 18,chr5,34549910,34550139,229,18,156,15.7,68.1,0.68
CpG: 68,chr5,34573412,34574182,770,68,457,17.7,59.4,1
CpG: 15,chr5,34616675,34616881,206,15,118,14.6,57.3,0.89
CpG: 96,chr5,34659863,34661044,1181,96,664,16.3,56.2,1.03
CpG: 31,chr5,34761581,34761851,270,31,184,23,68.1,0.99
CpG: 69,chr5,34949304,34949913,609,69,423,22.7,69.5,0.94
CpG: 40,chr5,35056882,35057359,477,40,275,16.8,57.7,1.02
CpG: 33,chr5,35105423,35105823,400,33,264,16.5,66,0.81
CpG: 240,chr5,35278829,35281047,2218,240,1435,21.6,64.7,1.03
CpG: 109,chr5,35391593,35392640,1047,109,640,20.8,61.1,1.11
CpG: 91,chr5,35396989,35398130,1141,91,703,16,61.6,0.84
CpG: 49,chr5,35399680,35400094,414,49,289,23.7,69.8,0.98
CpG: 26,chr5,35525417,35525676,259,26,191,20.1,73.7,0.81
CpG: 53,chr5,35574601,35575186,585,53,388,18.1,66.3,0.82
CpG: 55,chr5,35678972,35679421,449,55,326,24.5,72.6,0.93
CpG: 72,chr5,35757708,35758530,822,72,557,17.5,67.8,0.76
CpG: 42,chr5,35893170,35893597,427,42,299,19.7,70,0.8
CpG: 90,chr5,36397418,36398231,813,90,558,22.1,68.6,0.95
CpG: 66,chr5,36464694,36465521,827,66,518,16,62.6,0.81
CpG: 118,chr5,36483675,36484944,1269,118,733,18.6,57.8,1.12
CpG: 23,chr5,36530293,36530599,306,23,204,15,66.7,0.68
CpG: 83,chr5,36581523,36582470,947,83,651,17.5,68.7,0.77
CpG: 101,chr5,36695475,36696339,864,101,596,23.4,69,0.99
CpG: 82,chr5,36747963,36748727,764,82,495,21.5,64.8,1.03
CpG: 92,chr5,36796080,36796903,823,92,514,22.4,62.5,1.19
CpG: 29,chr5,36830484,36830730,246,29,181,23.6,73.6,0.88
CpG: 145,chr5,36868375,36870197,1822,145,1139,15.9,62.5,0.82
CpG: 23,chr5,36966859,36967182,323,23,197,14.2,61,0.77
CpG: 73,chr5,36988535,36989424,889,73,585,16.4,65.8,0.76
CpG: 103,chr5,37028173,37029310,1137,103,696,18.1,61.2,0.97
CpG: 50,chr5,37091138,37091626,488,50,320,20.5,65.6,0.96
CpG: 45,chr5,37163077,37163496,419,45,297,21.5,70.9,0.89
CpG: 113,chr5,37241746,37242615,869,113,606,26,69.7,1.07
CpG: 67,chr5,37245656,37246424,768,67,508,17.4,66.1,0.81
CpG: 45,chr5,37336520,37336974,454,45,314,19.8,69.2,0.83
CpG: 26,chr5,37338373,37338645,272,26,190,19.1,69.9,0.79
CpG: 41,chr5,37817025,37817586,561,41,375,14.6,66.8,0.67
CpG: 27,chr5,37821292,37821605,313,27,200,17.3,63.9,0.85
CpG: 82,chr5,37823874,37824807,933,82,648,17.6,69.5,0.73
CpG: 65,chr5,37826575,37827554,979,65,575,13.3,58.7,0.77
CpG: 22,chr5,37893728,37893998,270,22,153,16.3,56.7,1.03
CpG: 51,chr5,38038963,38039555,592,51,365,17.2,61.7,0.92
CpG: 96,chr5,38159010,38159780,770,96,553,24.9,71.8,0.97
CpG: 87,chr5,38219988,38220808,820,87,553,21.2,67.4,0.93
CpG: 33,chr5,38260273,38260624,351,33,219,18.8,62.4,0.97
CpG: 68,chr5,38277082,38277824,742,68,524,18.3,70.6,0.75
CpG: 74,chr5,38319240,38319927,687,74,475,21.5,69.1,0.9
CpG: 102,chr5,38561014,38561886,872,102,594,23.4,68.1,1.01
CpG: 88,chr5,38684213,38684856,643,88,458,27.4,71.2,1.08
CpG: 45,chr5,39644402,39644902,500,45,314,18,62.8,0.92
CpG: 52,chr5,41707739,41708287,548,52,388,19,70.8,0.76
CpG: 56,chr5,41761658,41762189,531,56,354,21.1,66.7,0.95
CpG: 100,chr5,41763320,41764397,1077,100,749,18.6,69.5,0.78
CpG: 66,chr5,41843850,41844602,752,66,469,17.6,62.4,0.9
CpG: 215,chr5,43232664,43235198,2534,215,1351,17,53.3,1.21
CpG: 91,chr5,43781622,43782475,853,91,517,21.3,60.6,1.16
CpG: 38,chr5,43807962,43808306,344,38,236,22.1,68.6,0.94
CpG: 63,chr5,44100524,44101425,901,63,577,14,64,0.69
CpG: 150,chr5,44225959,44227450,1491,150,871,20.1,58.4,1.18
CpG: 69,chr5,45449899,45450647,748,69,485,18.4,64.8,0.9
CpG: 73,chr5,45493174,45493767,593,73,422,24.6,71.2,0.97
CpG: 43,chr5,45520218,45520734,516,43,319,16.7,61.8,0.87
CpG: 43,chr5,45639074,45639541,467,43,294,18.4,63,0.93
CpG: 90,chr5,45669419,45670322,903,90,594,19.9,65.8,0.93
CpG: 140,chr5,45856370,45858010,1640,140,971,17.1,59.2,0.98
CpG: 75,chr5,47982967,47983966,999,75,606,15,60.7,0.82
CpG: 31,chr5,47986121,47986390,269,31,180,23,66.9,1.03
CpG: 28,chr5,48372331,48372570,239,28,168,23.4,70.3,0.99
CpG: 38,chr5,49524532,49525033,501,38,306,15.2,61.1,0.81
CpG: 97,chr5,50058259,50059228,969,97,596,20,61.5,1.07
CpG: 233,chr5,52112978,52116256,3278,233,1898,14.2,57.9,0.85
CpG: 100,chr5,52189953,52190745,792,100,568,25.3,71.7,1
CpG: 55,chr5,52368322,52368941,619,55,415,17.8,67,0.8
CpG: 49,chr5,52471155,52471658,503,49,350,19.5,69.6,0.82
CpG: 20,chr5,52476411,52476656,245,20,159,16.3,64.9,0.81
CpG: 55,chr5,52565848,52566398,550,55,338,20,61.5,1.06
CpG: 25,chr5,52618568,52618779,211,25,143,23.7,67.8,1.04
CpG: 54,chr5,52669413,52669812,399,54,284,27.1,71.2,1.09
CpG: 68,chr5,52741531,52741995,464,68,350,29.3,75.4,1.05
CpG: 37,chr5,52782976,52783291,315,37,221,23.5,70.2,0.97
CpG: 30,chr5,52834033,52834278,245,30,171,24.5,69.8,1.01
CpG: 28,chr5,53049155,53049425,270,28,181,20.7,67,0.92
CpG: 71,chr5,53212932,53213691,759,71,471,18.7,62.1,0.99
CpG: 42,chr5,53266980,53267406,426,42,289,19.7,67.8,0.87
CpG: 129,chr5,53588995,53590544,1549,129,940,16.7,60.7,0.91
CpG: 24,chr5,53591023,53591228,205,24,149,23.4,72.7,0.94
CpG: 22,chr5,53809530,53809743,213,22,145,20.7,68.1,0.89
CpG: 33,chr5,53995373,53995621,248,33,175,26.6,70.6,1.07
CpG: 119,chr5,53998193,53999166,973,119,656,24.5,67.4,1.08
CpG: 15,chr5,54336003,54336215,212,15,128,14.2,60.4,0.79
CpG: 36,chr5,57715833,57716205,372,36,243,19.4,65.3,0.92
CpG: 260,chr5,57717239,57720500,3261,260,1924,15.9,59,0.92
CpG: 94,chr5,62765846,62766530,684,94,484,27.5,70.8,1.1
CpG: 106,chr5,63649242,63650458,1216,106,796,17.4,65.5,0.81
CpG: 52,chr5,63812229,63812661,432,52,301,24.1,69.7,0.99
CpG: 86,chr5,63968352,63969136,784,86,568,21.9,72.4,0.85
CpG: 45,chr5,64092849,64093336,487,45,336,18.5,69,0.78
CpG: 90,chr5,64159356,64160492,1136,90,761,15.8,67,0.71
CpG: 73,chr5,64230095,64230718,623,73,438,23.4,70.3,0.95
CpG: 21,chr5,64256738,64257008,270,21,168,15.6,62.2,0.8
CpG: 176,chr5,64802638,64804313,1675,176,1152,21,68.8,0.89
CpG: 22,chr5,64821980,64822270,290,22,191,15.2,65.9,0.72
CpG: 53,chr5,64969937,64970438,501,53,293,21.2,58.5,1.24
CpG: 71,chr5,65107353,65108122,769,71,505,18.5,65.7,0.86
CpG: 48,chr5,65335355,65335799,444,48,297,21.6,66.9,0.97
CpG: 25,chr5,65379604,65379952,348,25,203,14.4,58.3,0.85
CpG: 72,chr5,65391008,65391689,681,72,441,21.1,64.8,1.01
CpG: 79,chr5,65435303,65436067,764,79,516,20.7,67.5,0.91
CpG: 98,chr5,65492420,65493314,894,98,616,21.9,68.9,0.93
CpG: 100,chr5,65536932,65538004,1072,100,703,18.7,65.6,0.88
CpG: 185,chr5,65696736,65698656,1920,185,1112,19.3,57.9,1.16
CpG: 166,chr5,65763327,65764867,1540,166,1007,21.6,65.4,1.01
CpG: 52,chr5,66026483,66027191,708,52,421,14.7,59.5,0.84
CpG: 37,chr5,66259949,66260315,366,37,254,20.2,69.4,0.84
CpG: 94,chr5,66617847,66618746,899,94,635,20.9,70.6,0.84
CpG: 32,chr5,66620182,66620575,393,32,239,16.3,60.8,0.92
CpG: 48,chr5,66676455,66676989,534,48,360,18,67.4,0.82
CpG: 75,chr5,66745586,66746388,802,75,558,18.7,69.6,0.78
CpG: 21,chr5,67096405,67096607,202,21,140,20.8,69.3,0.87
CpG: 24,chr5,67097560,67097844,284,24,173,16.9,60.9,0.91
CpG: 28,chr5,67216474,67216709,235,28,178,23.8,75.7,0.86
CpG: 30,chr5,67230519,67230805,286,30,180,21,62.9,1.06
CpG: 72,chr5,67260479,67261345,866,72,531,16.6,61.3,0.89
CpG: 90,chr5,67306607,67307477,870,90,593,20.7,68.2,0.89
CpG: 22,chr5,67364612,67364861,249,22,145,17.7,58.2,1.28
CpG: 133,chr5,67426644,67428157,1513,133,881,17.6,58.2,1.04
CpG: 148,chr5,67607245,67608749,1504,148,1015,19.7,67.5,0.87
CpG: 56,chr5,67847119,67847628,509,56,342,22,67.2,0.97
CpG: 119,chr5,69340370,69341700,1330,119,857,17.9,64.4,0.86
CpG: 67,chr5,69556755,69557318,563,67,394,23.8,70,0.97
CpG: 32,chr5,69592010,69592361,351,32,233,18.2,66.4,0.83
CpG: 34,chr5,71095789,71096138,349,34,232,19.5,66.5,0.89
CpG: 39,chr5,71657754,71658075,321,39,225,24.3,70.1,1
CpG: 33,chr5,71700810,71701218,408,33,252,16.2,61.8,0.85
CpG: 30,chr5,72167822,72168213,391,30,241,15.3,61.6,0.84
CpG: 56,chr5,72503656,72504432,776,56,498,14.4,64.2,0.71
CpG: 83,chr5,72559030,72559923,893,83,575,18.6,64.4,0.9
CpG: 88,chr5,72580290,72581140,850,88,602,20.7,70.8,0.83
CpG: 53,chr5,72586974,72587608,634,53,433,16.7,68.3,0.72
CpG: 47,chr5,72868363,72868818,455,47,294,20.7,64.6,1.01
CpG: 121,chr5,72913953,72915179,1226,121,787,19.7,64.2,0.98
CpG: 78,chr5,73013442,73014143,701,78,503,22.3,71.8,0.86
CpG: 19,chr5,73133262,73133498,236,19,134,16.1,56.8,1
CpG: 183,chr5,73255404,73256844,1440,183,1031,25.4,71.6,1
CpG: 54,chr5,73292633,73293197,564,54,390,19.1,69.1,0.8
CpG: 38,chr5,73406172,73406586,414,38,285,18.4,68.8,0.79
CpG: 155,chr5,73490559,73492636,2077,155,1271,14.9,61.2,0.84
CpG: 41,chr5,73647341,73647887,546,41,301,15,55.1,1
CpG: 43,chr5,73651154,73651585,431,43,288,20,66.8,0.9
CpG: 69,chr5,74068022,74068767,745,69,474,18.5,63.6,0.92
CpG: 49,chr5,74092912,74093520,608,49,394,16.1,64.8,0.77
CpG: 93,chr5,74194856,74195756,900,93,624,20.7,69.3,0.86
CpG: 60,chr5,74531138,74531823,685,60,433,17.5,63.2,0.88
CpG: 73,chr5,74535393,74536032,639,73,436,22.8,68.2,0.98
CpG: 24,chr5,74620010,74620304,294,24,182,16.3,61.9,0.86
CpG: 87,chr5,75044036,75044955,919,87,538,18.9,58.5,1.11
CpG: 58,chr5,75075478,75076133,655,58,436,17.7,66.6,0.8
CpG: 18,chr5,75077075,75077280,205,18,116,17.6,56.6,1.1
CpG: 17,chr5,75151231,75151437,206,17,131,16.5,63.6,0.84
CpG: 55,chr5,75152823,75153393,570,55,347,19.3,60.9,1.13
CpG: 48,chr5,75156241,75156809,568,48,367,16.9,64.6,0.83
CpG: 109,chr5,75574820,75576005,1185,109,801,18.4,67.6,0.82
CpG: 19,chr5,75977659,75977915,256,19,171,14.8,66.8,0.67
CpG: 47,chr5,75978110,75978657,547,47,363,17.2,66.4,0.78
CpG: 56,chr5,76140189,76140635,446,56,316,25.1,70.9,1
CpG: 78,chr5,76183795,76184524,729,78,491,21.4,67.4,0.95
CpG: 160,chr5,76303712,76305104,1392,160,880,23,63.2,1.16
CpG: 29,chr5,76529305,76529652,347,29,229,16.7,66,0.77
CpG: 67,chr5,76588594,76589196,602,67,375,22.3,62.3,1.15
CpG: 101,chr5,76657534,76658400,866,101,611,23.3,70.6,0.94
CpG: 92,chr5,76857300,76858505,1205,92,763,15.3,63.3,0.76
CpG: 41,chr5,76905295,76905647,352,41,242,23.3,68.8,0.99
CpG: 86,chr5,76951056,76952022,966,86,633,17.8,65.5,0.83
CpG: 67,chr5,76974351,76975118,767,67,487,17.5,63.5,0.87
CpG: 31,chr5,77015850,77016234,384,31,206,16.1,53.6,1.12
CpG: 59,chr5,77094756,77095382,626,59,430,18.8,68.7,0.8
CpG: 150,chr5,77265271,77266971,1700,150,930,17.6,54.7,1.2
CpG: 161,chr5,77309037,77310856,1819,161,1082,17.7,59.5,1
CpG: 97,chr5,77407418,77408239,821,97,606,23.6,73.8,0.87
CpG: 104,chr5,81019583,81020622,1039,104,643,20,61.9,1.05
CpG: 39,chr5,81021330,81021843,513,39,310,15.2,60.4,0.84
CpG: 35,chr5,81794477,81794980,503,35,304,13.9,60.4,0.77
CpG: 29,chr5,84416163,84416502,339,29,224,17.1,66.1,0.78
CpG: 49,chr5,84417174,84417603,429,49,285,22.8,66.4,1.04
CpG: 60,chr5,86065168,86065829,661,60,416,18.2,62.9,1.02
CpG: 61,chr5,86172427,86173034,607,61,403,20.1,66.4,0.91
CpG: 97,chr5,86804031,86804928,897,97,555,21.6,61.9,1.14
CpG: 93,chr5,88553761,88554718,957,93,574,19.4,60,1.08
CpG: 22,chr5,88564675,88564909,234,22,159,18.8,67.9,0.81
CpG: 101,chr5,88565088,88565864,776,101,527,26,67.9,1.13
CpG: 144,chr5,88675095,88676468,1373,144,912,21,66.4,0.96
CpG: 64,chr5,88720695,88721251,556,64,398,23,71.6,0.91
CpG: 67,chr5,88764837,88765463,626,67,443,21.4,70.8,0.87
CpG: 110,chr5,88886564,88887750,1186,110,707,18.5,59.6,1.04
CpG: 16,chr5,89684366,89684585,219,16,144,14.6,65.8,0.68
CpG: 21,chr5,89882467,89882701,234,21,163,17.9,69.7,0.75
CpG: 63,chr5,89883148,89883700,552,63,393,22.8,71.2,0.9
CpG: 50,chr5,90223595,90224097,502,50,346,19.9,68.9,0.84
CpG: 29,chr5,90365241,90365646,405,29,268,14.3,66.2,0.75
CpG: 68,chr5,90366020,90366887,867,68,464,15.7,53.5,1.11
CpG: 45,chr5,90931120,90931445,325,45,235,27.7,72.3,1.06
CpG: 46,chr5,91139427,91139842,415,46,287,22.2,69.2,0.94
CpG: 33,chr5,91517613,91517984,371,33,249,17.8,67.1,0.79
CpG: 59,chr5,91962588,91963179,591,59,372,20,62.9,1.01
CpG: 49,chr5,92042389,92043089,700,49,414,14,59.1,0.8
CpG: 114,chr5,92082866,92083958,1092,114,723,20.9,66.2,0.97
CpG: 87,chr5,92137626,92138420,794,87,573,21.9,72.2,0.85
CpG: 19,chr5,92276906,92277156,250,19,142,15.2,56.8,0.95
CpG: 36,chr5,92277697,92278062,365,36,243,19.7,66.6,0.9
CpG: 50,chr5,92309554,92310118,564,50,361,17.7,64,0.87
CpG: 21,chr5,92392340,92392638,298,21,151,14.1,50.7,1.22
CpG: 65,chr5,92434543,92435309,766,65,500,17,65.3,0.8
CpG: 69,chr5,92505196,92505869,673,69,464,20.5,68.9,0.86
CpG: 46,chr5,92602977,92603574,597,46,407,15.4,68.2,0.67
CpG: 29,chr5,92675034,92675257,223,29,158,26,70.9,1.07
CpG: 31,chr5,92682796,92683211,415,31,240,14.9,57.8,0.91
CpG: 24,chr5,92683396,92683753,357,24,217,13.4,60.8,0.73
CpG: 71,chr5,92897735,92898328,593,71,391,23.9,65.9,1.11
CpG: 153,chr5,92941538,92942972,1434,153,1014,21.3,70.7,0.86
CpG: 152,chr5,93043785,93045616,1831,152,1241,16.6,67.8,0.72
CpG: 100,chr5,93092806,93094165,1359,100,863,14.7,63.5,0.74
CpG: 110,chr5,93205765,93206839,1074,110,645,20.5,60.1,1.15
CpG: 93,chr5,93267493,93268606,1113,93,736,16.7,66.1,0.76
CpG: 144,chr5,96160920,96162717,1797,144,909,16,50.6,1.26
CpG: 28,chr5,96209932,96210313,381,28,219,14.7,57.5,0.9
CpG: 83,chr5,96374035,96374857,822,83,576,20.2,70.1,0.82
CpG: 121,chr5,96997052,96998110,1058,121,644,22.9,60.9,1.23
CpG: 36,chr5,97391966,97392401,435,36,279,16.6,64.1,0.82
CpG: 36,chr5,97935377,97935758,381,36,243,18.9,63.8,0.97
CpG: 64,chr5,98030523,98031323,800,64,527,16,65.9,0.74
CpG: 50,chr5,98167187,98167777,590,50,413,16.9,70,0.7
CpG: 18,chr5,98181315,98181578,263,18,161,13.7,61.2,0.74
CpG: 137,chr5,98185131,98186715,1584,137,854,17.3,53.9,1.19
CpG: 75,chr5,98253874,98254670,796,75,520,18.8,65.3,0.88
CpG: 35,chr5,98329238,98329549,311,35,214,22.5,68.8,0.95
CpG: 68,chr5,98854747,98855419,672,68,466,20.2,69.3,0.84
CpG: 36,chr5,99037145,99037435,290,36,206,24.8,71,1.02
CpG: 86,chr5,99252452,99253233,781,86,549,22,70.3,0.9
CpG: 54,chr5,99728751,99729257,506,54,368,21.3,72.7,0.82
CpG: 41,chr5,99906243,99906613,370,41,262,22.2,70.8,0.88
CpG: 164,chr5,99977719,99979466,1747,164,1041,18.8,59.6,1.06
CpG: 216,chr5,100038372,100040322,1950,216,1342,22.2,68.8,0.94
CpG: 86,chr5,100158795,100159586,791,86,538,21.7,68,0.94
CpG: 79,chr5,100415936,100416571,635,79,452,24.9,71.2,0.98
CpG: 61,chr5,100429192,100429927,735,61,454,16.6,61.8,0.87
CpG: 48,chr5,100498315,100498862,547,48,360,17.6,65.8,0.83
CpG: 82,chr5,100499878,100500902,1024,82,537,16,52.4,1.17
CpG: 62,chr5,100518114,100518927,813,62,491,15.3,60.4,0.84
CpG: 68,chr5,100673804,100674321,517,68,390,26.3,75.4,0.92
CpG: 30,chr5,100719409,100719687,278,30,201,21.6,72.3,0.83
CpG: 73,chr5,100798177,100798914,737,73,489,19.8,66.4,0.91
CpG: 60,chr5,100820543,100821046,503,60,354,23.9,70.4,0.97
CpG: 65,chr5,100845961,100846892,931,65,578,14,62.1,0.73
CpG: 55,chr5,101647591,101648431,840,55,485,13.1,57.7,0.79
CpG: 66,chr5,101659013,101659837,824,66,461,16,55.9,1.02
CpG: 204,chr5,101663309,101665763,2454,204,1497,16.6,61,0.89
CpG: 112,chr5,101764795,101765669,874,112,599,25.6,68.5,1.09
CpG: 18,chr5,101882413,101882650,237,18,147,15.2,62,0.81
CpG: 18,chr5,101937338,101937555,217,18,128,16.6,59,0.96
CpG: 150,chr5,102069009,102070393,1384,150,978,21.7,70.7,0.88
CpG: 116,chr5,103424667,103425789,1122,116,758,20.7,67.6,0.91
CpG: 46,chr5,103655338,103655818,480,46,332,19.2,69.2,0.81
CpG: 70,chr5,103692195,103692992,797,70,534,17.6,67,0.78
CpG: 103,chr5,103753670,103754582,912,103,648,22.6,71.1,0.91
CpG: 66,chr5,103910761,103911364,603,66,364,21.9,60.4,1.21
CpG: 80,chr5,104046507,104047198,691,80,472,23.2,68.3,0.99
CpG: 116,chr5,104459460,104460421,961,116,692,24.1,72,0.94
CpG: 52,chr5,104508296,104508852,556,52,301,18.7,54.1,1.28
CpG: 86,chr5,105415441,105416302,861,86,569,20,66.1,0.92
CpG: 26,chr5,105480859,105481230,371,26,211,14,56.9,0.88
CpG: 58,chr5,105519378,105519941,563,58,401,20.6,71.2,0.81
CpG: 106,chr5,105699721,105700810,1089,106,666,19.5,61.2,1.04
CpG: 45,chr5,105731943,105732434,491,45,346,18.3,70.5,0.74
CpG: 97,chr5,105876371,105877209,838,97,545,23.2,65,1.1
CpG: 20,chr5,106181885,106182102,217,20,122,18.4,56.2,1.17
CpG: 40,chr5,106448235,106448646,411,40,268,19.5,65.2,0.92
CpG: 22,chr5,106451842,106452109,267,22,173,16.5,64.8,0.79
CpG: 188,chr5,106457148,106459518,2370,188,1427,15.9,60.2,0.88
CpG: 36,chr5,106561167,106561519,352,36,253,20.5,71.9,0.79
CpG: 82,chr5,106574317,106574945,628,82,474,26.1,75.5,0.93
CpG: 99,chr5,106695920,106696816,896,99,568,22.1,63.4,1.13
CpG: 36,chr5,106925741,106926046,305,36,200,23.6,65.6,1.11
CpG: 72,chr5,106964136,106964814,678,72,449,21.2,66.2,0.97
CpG: 96,chr5,107288822,107289663,841,96,594,22.8,70.6,0.92
CpG: 23,chr5,107331013,107331244,231,23,156,19.9,67.5,0.88
CpG: 53,chr5,107403288,107403902,614,53,334,17.3,54.4,1.17
CpG: 47,chr5,107437785,107438205,420,47,304,22.4,72.4,0.87
CpG: 24,chr5,107597300,107597558,258,24,171,18.6,66.3,0.85
CpG: 29,chr5,107687926,107688210,284,29,188,20.4,66.2,0.93
CpG: 88,chr5,107721093,107722006,913,88,626,19.3,68.6,0.82
CpG: 62,chr5,107723261,107724074,813,62,508,15.3,62.5,0.78
CpG: 148,chr5,107724685,107726871,2186,148,1333,13.5,61,0.73
CpG: 117,chr5,107868348,107869387,1039,117,682,22.5,65.6,1.05
CpG: 59,chr5,107900465,107901004,539,59,374,21.9,69.4,0.91
CpG: 92,chr5,107986728,107987456,728,92,475,25.3,65.2,1.2
CpG: 43,chr5,108065501,108065908,407,43,269,21.1,66.1,0.97
CpG: 84,chr5,108132085,108132989,904,84,586,18.6,64.8,0.88
CpG: 76,chr5,108268697,108269329,632,76,450,24.1,71.2,0.95
CpG: 52,chr5,108312549,108313112,563,52,373,18.5,66.3,0.85
CpG: 139,chr5,108366586,108367947,1361,139,855,20.4,62.8,1.04
CpG: 37,chr5,108433993,108434502,509,37,308,14.5,60.5,0.82
CpG: 22,chr5,108448630,108448906,276,22,170,15.9,61.6,0.86
CpG: 48,chr5,108460966,108461619,653,48,398,14.7,60.9,0.81
CpG: 56,chr5,108549441,108550102,661,56,420,16.9,63.5,0.86
CpG: 72,chr5,108629403,108630051,648,72,454,22.2,70.1,0.91
CpG: 44,chr5,108660567,108661067,500,44,328,17.6,65.6,0.82
CpG: 30,chr5,108669201,108669476,275,30,181,21.8,65.8,1.01
CpG: 19,chr5,108677592,108677836,244,19,156,15.6,63.9,0.89
CpG: 118,chr5,108693944,108695163,1219,118,734,19.4,60.2,1.08
CpG: 37,chr5,108774782,108775210,428,37,268,17.3,62.6,0.88
CpG: 46,chr5,108903226,108903715,489,46,284,18.8,58.1,1.12
CpG: 109,chr5,109555411,109557155,1744,109,1109,12.5,63.6,0.62
CpG: 60,chr5,109558579,109559201,622,60,371,19.3,59.6,1.08
CpG: 42,chr5,110101341,110101919,578,42,372,14.5,64.4,0.74
CpG: 117,chr5,110107012,110108376,1364,117,902,17.2,66.1,0.8
CpG: 45,chr5,110135714,110136199,485,45,323,18.6,66.6,0.84
CpG: 43,chr5,110176496,110177081,585,43,362,14.7,61.9,0.78
CpG: 69,chr5,110230850,110231495,645,69,385,21.4,59.7,1.2
CpG: 61,chr5,110269434,110269985,551,61,385,22.1,69.9,0.92
CpG: 65,chr5,110285938,110286525,587,65,390,22.1,66.4,1
CpG: 52,chr5,110342423,110343045,622,52,410,16.7,65.9,0.77
CpG: 97,chr5,110363028,110363862,834,97,600,23.3,71.9,0.9
CpG: 28,chr5,110378032,110378383,351,28,205,16,58.4,0.95
CpG: 88,chr5,110386444,110387322,878,88,597,20,68,0.87
CpG: 91,chr5,110447983,110448781,798,91,518,22.8,64.9,1.09
CpG: 41,chr5,110480656,110481179,523,41,321,15.7,61.4,0.85
CpG: 90,chr5,110544150,110544883,733,90,511,24.6,69.7,1.02
CpG: 134,chr5,110652809,110654098,1289,134,862,20.8,66.9,0.93
CpG: 136,chr5,110770051,110771137,1086,136,744,25,68.5,1.07
CpG: 48,chr5,110780224,110780666,442,48,308,21.7,69.7,0.91
CpG: 75,chr5,110809578,110810222,644,75,428,23.3,66.5,1.06
CpG: 36,chr5,110839442,110839856,414,36,263,17.4,63.5,0.86
CpG: 87,chr5,110879570,110880309,739,87,499,23.5,67.5,1.04
CpG: 85,chr5,110979127,110979831,704,85,486,24.1,69,1.02
CpG: 19,chr5,111182964,111183210,246,19,154,15.4,62.6,0.79
CpG: 18,chr5,111223315,111223544,229,18,150,15.7,65.5,0.75
CpG: 29,chr5,111277082,111277396,314,29,210,18.5,66.9,0.83
CpG: 16,chr5,111285108,111285316,208,16,133,15.4,63.9,0.76
CpG: 80,chr5,111330409,111331061,652,80,465,24.5,71.3,0.98
CpG: 354,chr5,111416539,111420529,3990,354,2578,17.7,64.6,0.85
CpG: 14,chr5,111752939,111753142,203,14,132,13.8,65,0.71
CpG: 23,chr5,111957837,111958080,243,23,150,18.9,61.7,0.99
CpG: 25,chr5,112153782,112153992,210,25,130,23.8,61.9,1.25
CpG: 33,chr5,112227390,112227803,413,33,271,16,65.6,0.74
CpG: 56,chr5,112228547,112229184,637,56,421,17.6,66.1,0.81
CpG: 96,chr5,112276156,112277100,944,96,646,20.3,68.4,0.88
CpG: 55,chr5,112307591,112308235,644,55,426,17.1,66.1,0.78
CpG: 53,chr5,112326118,112326567,449,53,301,23.6,67,1.06
CpG: 66,chr5,112342859,112343309,450,66,322,29.3,71.6,1.15
CpG: 42,chr5,112394577,112395032,455,42,231,18.5,50.8,1.44
CpG: 16,chr5,112565065,112565272,207,16,111,15.5,53.6,1.09
CpG: 87,chr5,112576531,112577480,949,87,609,18.3,64.2,0.91
CpG: 35,chr5,113015374,113015617,243,35,164,28.8,67.5,1.31
CpG: 70,chr5,113137765,113138844,1079,70,700,13,64.9,0.62
CpG: 93,chr5,113220579,113221436,857,93,551,21.7,64.3,1.05
CpG: 40,chr5,113287112,113287528,416,40,276,19.2,66.3,0.9
CpG: 53,chr5,113310378,113310993,615,53,418,17.2,68,0.77
CpG: 16,chr5,113373431,113373649,218,16,119,14.7,54.6,0.99
CpG: 45,chr5,113490503,113491106,603,45,357,14.9,59.2,0.85
CpG: 30,chr5,113587714,113588105,391,30,243,15.3,62.1,0.8
CpG: 23,chr5,113614192,113614536,344,23,208,13.4,60.5,0.8
CpG: 60,chr5,113735546,113736018,472,60,338,25.4,71.6,1
CpG: 20,chr5,113738811,113739076,265,20,154,15.1,58.1,0.9
CpG: 194,chr5,113771156,113773109,1953,194,1205,19.9,61.7,1.05
CpG: 95,chr5,113908093,113909163,1070,95,668,17.8,62.4,0.94
CpG: 69,chr5,113993147,113994023,876,69,522,15.8,59.6,0.89
CpG: 28,chr5,114091132,114091484,352,28,249,15.9,70.7,0.64
CpG: 69,chr5,114100110,114100730,620,69,418,22.3,67.4,0.98
CpG: 67,chr5,114127428,114128285,857,67,545,15.6,63.6,0.79
CpG: 140,chr5,114130344,114131638,1294,140,895,21.6,69.2,0.9
CpG: 65,chr5,114273644,114274422,778,65,528,16.7,67.9,0.73
CpG: 101,chr5,114380068,114381141,1073,101,710,18.8,66.2,0.87
CpG: 56,chr5,114443760,114444482,722,56,457,15.5,63.3,0.78
CpG: 151,chr5,114567126,114568434,1308,151,926,23.1,70.8,0.92
CpG: 25,chr5,114571568,114571810,242,25,152,20.7,62.8,1.05
CpG: 27,chr5,114610856,114611179,323,27,210,16.7,65,0.81
CpG: 56,chr5,114658048,114658620,572,56,370,19.6,64.7,0.97
CpG: 36,chr5,114667490,114667939,449,36,270,16,60.1,0.89
CpG: 56,chr5,114690800,114691170,370,56,285,30.3,77,1.03
CpG: 33,chr5,114707764,114708006,242,33,170,27.3,70.2,1.14
CpG: 28,chr5,114749275,114749593,318,28,201,17.6,63.2,0.88
CpG: 207,chr5,114772810,114775354,2544,207,1506,16.3,59.2,0.93
CpG: 47,chr5,114813704,114814150,446,47,311,21.1,69.7,0.87
CpG: 47,chr5,114823226,114823688,462,47,325,20.3,70.3,0.83
CpG: 18,chr5,114828996,114829241,245,18,151,14.7,61.6,0.78
CpG: 23,chr5,114942214,114942438,224,23,156,20.5,69.6,0.88
CpG: 119,chr5,115010685,115011944,1259,119,705,18.9,56,1.21
CpG: 22,chr5,115119007,115119262,255,22,180,17.3,70.6,0.69
CpG: 31,chr5,115126991,115127398,407,31,222,15.2,54.5,1.05
CpG: 66,chr5,115134440,115135067,627,66,449,21.1,71.6,0.82
CpG: 108,chr5,115157734,115158897,1163,108,794,18.6,68.3,0.8
CpG: 140,chr5,115193355,115194447,1092,140,818,25.6,74.9,0.92
CpG: 54,chr5,115235353,115235875,522,54,344,20.7,65.9,0.95
CpG: 72,chr5,115237925,115238420,495,72,349,29.1,70.5,1.18
CpG: 31,chr5,115272661,115272883,222,31,173,27.9,77.9,0.95
CpG: 36,chr5,115279608,115279892,284,36,196,25.4,69,1.07
CpG: 79,chr5,115300386,115301209,823,79,517,19.2,62.8,0.98
CpG: 91,chr5,115326995,115327957,962,91,534,18.9,55.5,1.25
CpG: 70,chr5,115340818,115341476,658,70,436,21.3,66.3,0.97
CpG: 91,chr5,115348504,115349379,875,91,569,20.8,65,0.99
CpG: 21,chr5,115374023,115374261,238,21,159,17.6,66.8,0.79
CpG: 36,chr5,115398434,115398745,311,36,217,23.2,69.8,0.95
CpG: 146,chr5,115429295,115430967,1672,146,1038,17.5,62.1,0.91
CpG: 38,chr5,115436494,115436905,411,38,287,18.5,69.8,0.76
CpG: 17,chr5,115440408,115440634,226,17,133,15,58.8,0.95
CpG: 16,chr5,115447001,115447225,224,16,144,14.3,64.3,0.73
CpG: 23,chr5,115482797,115483106,309,23,183,14.9,59.2,0.86
CpG: 31,chr5,115489926,115490251,325,31,195,19.1,60,1.07
CpG: 25,chr5,115491932,115492304,372,25,226,13.4,60.8,0.73
CpG: 52,chr5,115506563,115507056,493,52,315,21.1,63.9,1.06
CpG: 78,chr5,115559263,115560078,815,78,533,19.1,65.4,0.9
CpG: 58,chr5,115565123,115565739,616,58,332,18.8,53.9,1.3
CpG: 44,chr5,115631431,115631827,396,44,249,22.2,62.9,1.12
CpG: 20,chr5,115662656,115662861,205,20,134,19.5,65.4,0.92
CpG: 172,chr5,115730913,115732860,1947,172,1096,17.7,56.3,1.11
CpG: 65,chr5,116024167,116024726,559,65,374,23.3,66.9,1.04
CpG: 22,chr5,116444534,116444762,228,22,159,19.3,69.7,0.8
CpG: 23,chr5,116446558,116446866,308,23,191,14.9,62,0.81
CpG: 47,chr5,116591341,116591890,549,47,350,17.1,63.8,0.87
CpG: 90,chr5,117115539,117116157,618,90,463,29.1,74.9,1.04
CpG: 91,chr5,117119755,117120797,1042,91,668,17.5,64.1,0.89
CpG: 49,chr5,117287306,117287722,416,49,290,23.6,69.7,0.97
CpG: 91,chr5,117318902,117319808,906,91,612,20.1,67.5,0.88
CpG: 33,chr5,117357468,117357759,291,33,217,22.7,74.6,0.82
CpG: 58,chr5,117388600,117389246,646,58,404,18,62.5,0.92
CpG: 78,chr5,117413599,117414352,753,78,479,20.7,63.6,1.03
CpG: 49,chr5,117841793,117842411,618,49,403,15.9,65.2,0.75
CpG: 71,chr5,117976668,117977352,684,71,457,20.8,66.8,0.94
CpG: 159,chr5,118027500,118029094,1594,159,1027,19.9,64.4,0.96
CpG: 64,chr5,118154984,118155525,541,64,390,23.7,72.1,0.92
CpG: 111,chr5,118169181,118170218,1037,111,682,21.4,65.8,0.99
CpG: 36,chr5,118171710,118171989,279,36,204,25.8,73.1,0.98
CpG: 16,chr5,118237222,118237438,216,16,152,14.8,70.4,0.6
CpG: 59,chr5,118244853,118245425,572,59,392,20.6,68.5,0.88
CpG: 17,chr5,118328086,118328318,232,17,122,14.7,52.6,1.06
CpG: 23,chr5,118380802,118381003,201,23,130,22.9,64.7,1.16
CpG: 181,chr5,118559671,118561458,1787,181,985,20.3,55.1,1.34
CpG: 27,chr5,119006032,119006424,392,27,250,13.8,63.8,0.68
CpG: 109,chr5,119670093,119671401,1308,109,783,16.7,59.9,0.93
CpG: 62,chr5,119680407,119681017,610,62,426,20.3,69.8,0.84
CpG: 22,chr5,119682707,119682954,247,22,165,17.8,66.8,0.82
CpG: 26,chr5,119796510,119796843,333,26,219,15.6,65.8,0.72
CpG: 73,chr5,119803306,119804205,899,73,513,16.2,57.1,1
CpG: 24,chr5,119804731,119805074,343,24,205,14,59.8,0.8
CpG: 19,chr5,119844997,119845222,225,19,124,16.9,55.1,1.12
CpG: 17,chr5,119866908,119867127,219,17,124,15.5,56.6,0.97
CpG: 32,chr5,120116381,120116676,295,32,195,21.7,66.1,1.01
CpG: 47,chr5,120302302,120302682,380,47,267,24.7,70.3,1.01
CpG: 32,chr5,120427609,120427961,352,32,206,18.2,58.5,1.06
CpG: 59,chr5,120431811,120432471,660,59,398,17.9,60.3,0.98
CpG: 85,chr5,120435345,120436513,1168,85,722,14.6,61.8,0.76
CpG: 32,chr5,120438068,120438364,296,32,199,21.6,67.2,0.96
CpG: 62,chr5,120439850,120440476,626,62,422,19.8,67.4,0.9
CpG: 53,chr5,120503253,120503720,467,53,347,22.7,74.3,0.83
CpG: 31,chr5,120511086,120511469,383,31,248,16.2,64.8,0.77
CpG: 85,chr5,120612520,120613473,953,85,605,17.8,63.5,0.9
CpG: 25,chr5,120631230,120631441,211,25,140,23.7,66.4,1.09
CpG: 61,chr5,120648698,120649545,847,61,575,14.4,67.9,0.63
CpG: 77,chr5,120694414,120695104,690,77,478,22.3,69.3,0.97
CpG: 92,chr5,120710737,120711788,1051,92,716,17.5,68.1,0.76
CpG: 57,chr5,121190852,121191351,499,57,333,22.8,66.7,1.03
CpG: 42,chr5,121204496,121205002,506,42,320,16.6,63.2,0.85
CpG: 85,chr5,121220133,121221235,1102,85,582,15.4,52.8,1.11
CpG: 50,chr5,121385287,121385695,408,50,290,24.5,71.1,0.98
CpG: 67,chr5,121397859,121398427,568,67,360,23.6,63.4,1.18
CpG: 83,chr5,121452104,121452795,691,83,474,24,68.6,1.03
CpG: 19,chr5,121501927,121502132,205,19,133,18.5,64.9,0.88
CpG: 19,chr5,121520079,121520284,205,19,133,18.5,64.9,0.88
CpG: 85,chr5,121545106,121546048,942,85,546,18,58,1.08
CpG: 55,chr5,121593162,121593688,526,55,342,20.9,65,1.01
CpG: 36,chr5,121618892,121619156,264,36,197,27.3,74.6,0.99
CpG: 75,chr5,121660346,121661160,814,75,461,18.4,56.6,1.15
CpG: 170,chr5,121711303,121713176,1873,170,1133,18.2,60.5,1.01
CpG: 82,chr5,121828407,121829074,667,82,486,24.6,72.9,0.94
CpG: 134,chr5,121836316,121837557,1241,134,866,21.6,69.8,0.89
CpG: 29,chr5,121842779,121843078,299,29,203,19.4,67.9,0.85
CpG: 64,chr5,121848794,121849285,491,64,356,26.1,72.5,0.99
CpG: 58,chr5,121852543,121853169,626,58,429,18.5,68.5,0.79
CpG: 41,chr5,121869065,121869600,535,41,352,15.3,65.8,0.71
CpG: 39,chr5,121948370,121948923,553,39,324,14.1,58.6,0.82
CpG: 89,chr5,122049865,122050525,660,89,417,27,63.2,1.38
CpG: 71,chr5,122158006,122158736,730,71,407,19.5,55.8,1.27
CpG: 97,chr5,122284451,122285425,974,97,580,19.9,59.5,1.13
CpG: 98,chr5,122354004,122354918,914,98,611,21.4,66.8,0.97
CpG: 96,chr5,122371712,122372698,986,96,634,19.5,64.3,0.95
CpG: 39,chr5,122391780,122392145,365,39,239,21.4,65.5,1
CpG: 72,chr5,122422125,122422933,808,72,517,17.8,64,0.87
CpG: 167,chr5,122501250,122502749,1499,167,902,22.3,60.2,1.23
CpG: 57,chr5,122614100,122614598,498,57,348,22.9,69.9,0.94
CpG: 47,chr5,122707517,122707940,423,47,302,22.2,71.4,0.87
CpG: 19,chr5,122763760,122764027,267,19,175,14.2,65.5,0.69
CpG: 89,chr5,122778881,122779715,834,89,543,21.3,65.1,1.01
CpG: 45,chr5,122820915,122821336,421,45,290,21.4,68.9,0.91
CpG: 67,chr5,122849906,122850625,719,67,452,18.6,62.9,0.94
CpG: 18,chr5,122880318,122880520,202,18,135,17.8,66.8,0.83
CpG: 133,chr5,122899494,122900752,1258,133,757,21.1,60.2,1.17
CpG: 16,chr5,122951781,122951984,203,16,133,15.8,65.5,0.74
CpG: 49,chr5,122952170,122952606,436,49,315,22.5,72.2,0.87
CpG: 24,chr5,122987533,122987811,278,24,171,17.3,61.5,0.92
CpG: 38,chr5,122988148,122988642,494,38,326,15.4,66,0.72
CpG: 30,chr5,122989112,122989387,275,30,184,21.8,66.9,1.03
CpG: 105,chr5,123014843,123015805,962,105,660,21.8,68.6,0.93
CpG: 19,chr5,123029214,123029476,262,19,162,14.5,61.8,0.77
CpG: 41,chr5,123057852,123058245,393,41,245,20.9,62.3,1.08
CpG: 22,chr5,123132273,123132486,213,22,153,20.7,71.8,0.8
CpG: 19,chr5,123135435,123135716,281,19,180,13.5,64.1,0.66
CpG: 56,chr5,123138697,123139321,624,56,426,17.9,68.3,0.77
CpG: 25,chr5,123141136,123141393,257,25,160,19.5,62.3,1.03
CpG: 111,chr5,123141680,123143197,1517,111,850,14.6,56,0.94
CpG: 20,chr5,123160828,123161067,239,20,152,16.7,63.6,0.83
CpG: 33,chr5,123228198,123228485,287,33,189,23,65.9,1.09
CpG: 161,chr5,123344072,123345695,1623,161,975,19.8,60.1,1.1
CpG: 18,chr5,123371090,123371300,210,18,115,17.1,54.8,1.14
CpG: 21,chr5,123373215,123373442,227,21,137,18.5,60.4,1.02
CpG: 80,chr5,123394466,123395387,921,80,553,17.4,60,0.97
CpG: 19,chr5,123489273,123489478,205,19,132,18.5,64.4,0.91
CpG: 62,chr5,123508235,123508934,699,62,475,17.7,68,0.77
CpG: 102,chr5,123523573,123524428,855,102,590,23.9,69,1
CpG: 43,chr5,123572714,123573079,365,43,252,23.6,69,0.99
CpG: 109,chr5,123683511,123684372,861,109,637,25.3,74,0.93
CpG: 70,chr5,123720173,123720926,753,70,443,18.6,58.8,1.08
CpG: 44,chr5,123749145,123749713,568,44,318,15.5,56,0.99
CpG: 53,chr5,123907065,123907486,421,53,305,25.2,72.4,0.96
CpG: 56,chr5,123930494,123930954,460,56,311,24.3,67.6,1.07
CpG: 101,chr5,123973591,123974311,720,101,524,28.1,72.8,1.06
CpG: 58,chr5,124031925,124032424,499,58,352,23.2,70.5,0.97
CpG: 20,chr5,124089911,124090160,249,20,161,16.1,64.7,0.77
CpG: 49,chr5,124095478,124096072,594,49,404,16.5,68,0.72
CpG: 57,chr5,124111929,124112476,547,57,354,20.8,64.7,1
CpG: 71,chr5,124115908,124116699,791,71,517,18,65.4,0.84
CpG: 22,chr5,124121333,124121579,246,22,166,17.9,67.5,0.8
CpG: 16,chr5,124123524,124123735,211,16,142,15.2,67.3,0.67
CpG: 117,chr5,124249215,124250237,1022,117,620,22.9,60.7,1.25
CpG: 64,chr5,124327601,124328227,626,64,410,20.4,65.5,0.95
CpG: 116,chr5,124353479,124354650,1171,116,693,19.8,59.2,1.15
CpG: 122,chr5,124424855,124426162,1307,122,804,18.7,61.5,0.99
CpG: 40,chr5,124439821,124440388,567,40,359,14.1,63.3,0.71
CpG: 79,chr5,124445291,124446190,899,79,498,17.6,55.4,1.15
CpG: 49,chr5,124477856,124478432,576,49,375,17,65.1,0.8
CpG: 42,chr5,124483109,124483613,504,42,270,16.7,53.6,1.2
CpG: 98,chr5,124530598,124531482,884,98,621,22.2,70.2,0.9
CpG: 113,chr5,124540548,124541540,992,113,610,22.8,61.5,1.21
CpG: 65,chr5,124552549,124553190,641,65,420,20.3,65.5,0.95
CpG: 45,chr5,124578923,124579237,314,45,218,28.7,69.4,1.19
CpG: 25,chr5,124629132,124629371,239,25,171,20.9,71.5,0.84
CpG: 28,chr5,124725052,124725342,290,28,186,19.3,64.1,0.95
CpG: 236,chr5,124861633,124863714,2081,236,1465,22.7,70.4,0.92
CpG: 22,chr5,125011311,125011579,268,22,184,16.4,68.7,0.72
CpG: 36,chr5,125026667,125027084,417,36,271,17.3,65,0.87
CpG: 141,chr5,125177790,125179676,1886,141,1101,15,58.4,0.88
CpG: 17,chr5,125245762,125245994,232,17,142,14.7,61.2,0.78
CpG: 33,chr5,125340806,125341178,372,33,264,17.7,71,0.71
CpG: 98,chr5,125389228,125390100,872,98,591,22.5,67.8,0.99
CpG: 46,chr5,125433816,125434258,442,46,303,20.8,68.6,0.89
CpG: 85,chr5,125441306,125442101,795,85,509,21.4,64,1.05
CpG: 24,chr5,125465691,125465973,282,24,181,17,64.2,0.83
CpG: 53,chr5,125475677,125476161,484,53,332,21.9,68.6,0.93
CpG: 68,chr5,125532374,125532819,445,68,336,30.6,75.5,1.08
CpG: 120,chr5,127241442,127242848,1406,120,915,17.1,65.1,0.81
CpG: 106,chr5,127616676,127617504,828,106,602,25.6,72.7,0.97
CpG: 48,chr5,127632192,127632757,565,48,385,17,68.1,0.74
CpG: 69,chr5,128432489,128433057,568,69,390,24.3,68.7,1.03
CpG: 157,chr5,128599949,128602095,2146,157,1292,14.6,60.2,0.81
CpG: 23,chr5,128736036,128736348,312,23,214,14.7,68.6,0.63
CpG: 27,chr5,128781722,128782109,387,27,249,14,64.3,0.67
CpG: 42,chr5,129008339,129008639,300,42,235,28,78.3,0.95
CpG: 183,chr5,129019673,129020973,1300,183,954,28.2,73.4,1.05
CpG: 22,chr5,129225844,129226135,291,22,175,15.1,60.1,0.85
CpG: 109,chr5,129500935,129502170,1235,109,763,17.7,61.8,0.92
CpG: 139,chr5,129583825,129585325,1500,139,1010,18.5,67.3,0.82
CpG: 35,chr5,129669870,129670194,324,35,218,21.6,67.3,0.96
CpG: 25,chr5,129715385,129715713,328,25,204,15.2,62.2,0.79
CpG: 63,chr5,129724924,129725505,581,63,376,21.7,64.7,1.04
CpG: 62,chr5,129787027,129787719,692,62,444,17.9,64.2,0.87
CpG: 27,chr5,129887072,129887305,233,27,155,23.2,66.5,1.09
CpG: 37,chr5,129895581,129896007,426,37,265,17.4,62.2,0.9
CpG: 59,chr5,129908427,129908934,507,59,349,23.3,68.8,0.98
CpG: 101,chr5,129941528,129942624,1096,101,666,18.4,60.8,1.01
CpG: 24,chr5,130002585,130002797,212,24,147,22.6,69.3,0.95
CpG: 33,chr5,130029254,130029515,261,33,184,25.3,70.5,1.03
CpG: 79,chr5,130079269,130079856,587,79,434,26.9,73.9,0.99
CpG: 74,chr5,130144210,130145203,993,74,591,14.9,59.5,0.84
CpG: 82,chr5,130171447,130172252,805,82,473,20.4,58.8,1.18
CpG: 71,chr5,130222122,130222665,543,71,352,26.2,64.8,1.25
CpG: 48,chr5,130255113,130255631,518,48,313,18.5,60.4,1.02
CpG: 76,chr5,130448994,130449857,863,76,591,17.6,68.5,0.76
CpG: 133,chr5,131306332,131307963,1631,133,1044,16.3,64,0.8
CpG: 35,chr5,131439468,131439909,441,35,270,15.9,61.2,0.86
CpG: 26,chr5,131440286,131440645,359,26,219,14.5,61,0.78
CpG: 158,chr5,131537191,131538947,1756,158,1155,18,65.8,0.83
CpG: 29,chr5,131616397,131616748,351,29,213,16.5,60.7,0.9
CpG: 176,chr5,132541593,132544113,2520,176,1348,14,53.5,0.98
CpG: 24,chr5,133475087,133475334,247,24,145,19.4,58.7,1.13
CpG: 50,chr5,134099625,134100114,489,50,327,20.4,66.9,0.92
CpG: 68,chr5,134176308,134176826,518,68,362,26.3,69.9,1.08
CpG: 86,chr5,134183946,134184651,705,86,464,24.4,65.8,1.13
CpG: 43,chr5,134221730,134222230,500,43,326,17.2,65.2,0.81
CpG: 150,chr5,134313443,134315050,1607,150,1020,18.7,63.5,0.93
CpG: 18,chr5,134456731,134456947,216,18,139,16.7,64.4,0.84
CpG: 22,chr5,134522700,134522953,253,22,173,17.4,68.4,0.75
CpG: 48,chr5,134551870,134552261,391,48,274,24.6,70.1,1.02
CpG: 34,chr5,134582578,134582934,356,34,236,19.1,66.3,0.87
CpG: 106,chr5,134638518,134639429,911,106,623,23.3,68.4,1.01
CpG: 78,chr5,134688222,134689139,917,78,558,17,60.9,0.92
CpG: 17,chr5,134747082,134747295,213,17,144,16,67.6,0.7
CpG: 21,chr5,134932313,134932576,263,21,176,16,66.9,0.72
CpG: 24,chr5,134946129,134946416,287,24,182,16.7,63.4,0.84
CpG: 81,chr5,134986286,134987183,897,81,585,18.1,65.2,0.85
CpG: 64,chr5,135008866,135009832,966,64,584,13.3,60.5,0.74
CpG: 57,chr5,135023385,135024062,677,57,448,16.8,66.2,0.77
CpG: 17,chr5,135041968,135042194,226,17,140,15,61.9,0.79
CpG: 103,chr5,135063814,135064913,1099,103,677,18.7,61.6,1
CpG: 67,chr5,135077776,135078576,800,67,486,16.8,60.8,0.93
CpG: 38,chr5,135089688,135090050,362,38,261,21,72.1,0.81
CpG: 52,chr5,135106863,135107353,490,52,324,21.2,66.1,0.97
CpG: 75,chr5,135149131,135149947,816,75,550,18.4,67.4,0.82
CpG: 92,chr5,135168201,135169013,812,92,552,22.7,68,1
CpG: 158,chr5,135186688,135188188,1500,158,1005,21.1,67,0.94
CpG: 135,chr5,135250228,135251487,1259,135,836,21.4,66.4,0.97
CpG: 33,chr5,135276569,135276860,291,33,203,22.7,69.8,0.93
CpG: 34,chr5,135349851,135350155,304,34,202,22.4,66.4,1.02
CpG: 50,chr5,135369859,135370345,486,50,323,20.6,66.5,0.96
CpG: 102,chr5,135393883,135394619,736,102,541,27.7,73.5,1.03
CpG: 48,chr5,135488854,135489439,585,48,361,16.4,61.7,0.87
CpG: 31,chr5,135544926,135545300,374,31,245,16.6,65.5,0.81
CpG: 33,chr5,135632668,135632971,303,33,220,21.8,72.6,0.83
CpG: 71,chr5,135688655,135689466,811,71,536,17.5,66.1,0.82
CpG: 73,chr5,135733582,135734607,1025,73,682,14.2,66.5,0.65
CpG: 50,chr5,135743837,135744365,528,50,360,18.9,68.2,0.81
CpG: 103,chr5,135777890,135779152,1262,103,798,16.3,63.2,0.82
CpG: 26,chr5,135852152,135852385,233,26,167,22.3,71.7,0.87
CpG: 27,chr5,135856998,135857220,222,27,163,24.3,73.4,0.9
CpG: 107,chr5,135868182,135869314,1132,107,730,18.9,64.5,0.93
CpG: 42,chr5,135888063,135888388,325,42,230,25.8,70.8,1.04
CpG: 16,chr5,135903608,135903809,201,16,129,15.9,64.2,0.8
CpG: 52,chr5,135911011,135911681,670,52,404,15.5,60.3,0.85
CpG: 61,chr5,135934098,135934708,610,61,407,20,66.7,0.9
CpG: 61,chr5,135962579,135963253,674,61,460,18.1,68.2,0.83
CpG: 24,chr5,135965522,135965871,349,24,233,13.8,66.8,0.64
CpG: 36,chr5,135994792,135995197,405,36,282,17.8,69.6,0.77
CpG: 28,chr5,136083808,136084146,338,28,236,16.6,69.8,0.7
CpG: 32,chr5,136102293,136102647,354,32,225,18.1,63.6,0.93
CpG: 53,chr5,136116465,136116989,524,53,344,20.2,65.6,0.96
CpG: 58,chr5,136135638,136136273,635,58,396,18.3,62.4,0.94
CpG: 23,chr5,136170510,136170738,228,23,147,20.2,64.5,1
CpG: 51,chr5,136198480,136199051,571,51,363,17.9,63.6,0.88
CpG: 63,chr5,136231647,136232338,691,63,456,18.2,66,0.84
CpG: 23,chr5,136243853,136244139,286,23,193,16.1,67.5,0.71
CpG: 59,chr5,136244404,136244936,532,59,349,22.2,65.6,1.03
CpG: 57,chr5,136274862,136275397,535,57,381,21.3,71.2,0.84
CpG: 303,chr5,136565439,136569059,3620,303,2244,16.7,62,0.87
CpG: 25,chr5,136623234,136623482,248,25,159,20.2,64.1,1.01
CpG: 24,chr5,136858962,136859277,315,24,213,15.2,67.6,0.7
CpG: 122,chr5,136881531,136883242,1711,122,1080,14.3,63.1,0.72
CpG: 25,chr5,136919192,136919482,290,25,171,17.2,59,1
CpG: 75,chr5,136986864,136987844,980,75,572,15.3,58.4,0.91
CpG: 206,chr5,137030025,137032778,2753,206,1608,15,58.4,0.88
CpG: 35,chr5,137189323,137189646,323,35,232,21.7,71.8,0.85
CpG: 15,chr5,137289060,137289264,204,15,127,14.7,62.3,0.77
CpG: 19,chr5,137294415,137294641,226,19,153,16.8,67.7,0.74
CpG: 76,chr5,137306997,137307762,765,76,471,19.9,61.6,1.05
CpG: 48,chr5,137333468,137334090,622,48,395,15.4,63.5,0.77
CpG: 56,chr5,137350062,137350612,550,56,395,20.4,71.8,0.81
CpG: 17,chr5,137354317,137354541,224,17,138,15.2,61.6,0.8
CpG: 18,chr5,137357753,137357957,204,18,135,17.6,66.2,0.81
CpG: 19,chr5,137432961,137433215,254,19,155,15,61,0.8
CpG: 72,chr5,137502245,137503014,769,72,496,18.7,64.5,0.9
CpG: 95,chr5,137510398,137511356,958,95,624,19.8,65.1,0.95
CpG: 86,chr5,137530753,137531997,1244,86,835,13.8,67.1,0.61
CpG: 31,chr5,137553400,137553723,323,31,199,19.2,61.6,1.01
CpG: 20,chr5,137574643,137574846,203,20,136,19.7,67,0.88
CpG: 56,chr5,137600255,137601078,823,56,516,13.6,62.7,0.7
CpG: 51,chr5,137628930,137629572,642,51,422,15.9,65.7,0.74
CpG: 41,chr5,137645108,137645485,377,41,255,21.8,67.6,0.95
CpG: 69,chr5,137684161,137685031,870,69,561,15.9,64.5,0.84
CpG: 57,chr5,137741237,137741874,637,57,444,17.9,69.7,0.74
CpG: 100,chr5,137778761,137779753,992,100,658,20.2,66.3,0.93
CpG: 129,chr5,137785605,137786950,1345,129,894,19.2,66.5,0.9
CpG: 60,chr5,137787640,137788510,870,60,496,13.8,57,0.88
CpG: 29,chr5,138116834,138117154,320,29,206,18.1,64.4,0.89
CpG: 22,chr5,138155377,138155611,234,22,150,18.8,64.1,0.92
CpG: 101,chr5,138170878,138172188,1310,101,785,15.4,59.9,0.88
CpG: 58,chr5,138194368,138195076,708,58,472,16.4,66.7,0.74
CpG: 27,chr5,138255541,138255861,320,27,191,16.9,59.7,0.95
CpG: 69,chr5,138263421,138264110,689,69,496,20,72,0.77
CpG: 38,chr5,138275485,138276046,561,38,356,13.5,63.5,0.69
CpG: 67,chr5,138279870,138280582,712,67,448,18.8,62.9,0.97
CpG: 35,chr5,138441448,138441854,406,35,267,17.2,65.8,0.8
CpG: 31,chr5,138619444,138619770,326,31,224,19,68.7,0.84
CpG: 173,chr5,138754435,138756097,1662,173,1138,20.8,68.5,0.89
CpG: 52,chr5,138820882,138821434,552,52,368,18.8,66.7,0.87
CpG: 261,chr5,138992920,138996221,3301,261,2050,15.8,62.1,0.82
CpG: 46,chr5,138997216,138997731,515,46,321,17.9,62.3,0.92
CpG: 16,chr5,139051456,139051663,207,16,114,15.5,55.1,1.02
CpG: 25,chr5,139129492,139129720,228,25,168,21.9,73.7,0.83
CpG: 113,chr5,139149880,139150851,971,113,675,23.3,69.5,0.98
CpG: 95,chr5,139200371,139201276,905,95,616,21,68.1,0.91
CpG: 44,chr5,139324992,139325322,330,44,255,26.7,77.3,0.9
CpG: 30,chr5,139345029,139345328,299,30,201,20.1,67.2,0.89
CpG: 33,chr5,139372055,139372320,265,33,189,24.9,71.3,0.98
CpG: 57,chr5,139380426,139381018,592,57,386,19.3,65.2,0.93
CpG: 14,chr5,139392827,139393030,203,14,123,13.8,60.6,0.75
CpG: 35,chr5,139484186,139484613,427,35,266,16.4,62.3,0.87
CpG: 69,chr5,139540305,139541293,988,69,567,14,57.4,0.85
CpG: 103,chr5,139543775,139544941,1166,103,742,17.7,63.6,0.88
CpG: 124,chr5,139546513,139547812,1299,124,878,19.1,67.6,0.84
CpG: 16,chr5,139548854,139549076,222,16,118,14.4,53.2,1.06
CpG: 26,chr5,139553163,139553452,289,26,199,18,68.9,0.76
CpG: 31,chr5,139619368,139619694,326,31,186,19,57.1,1.19
CpG: 39,chr5,139735930,139736374,444,39,299,17.6,67.3,0.78
CpG: 46,chr5,139775300,139775737,437,46,294,21.1,67.3,0.93
CpG: 83,chr5,139791366,139792185,819,83,530,20.3,64.7,1
CpG: 17,chr5,139800198,139800416,218,17,136,15.6,62.4,0.81
CpG: 36,chr5,139826573,139827023,450,36,280,16,62.2,0.83
CpG: 111,chr5,139907926,139909268,1342,111,829,16.5,61.8,0.87
CpG: 56,chr5,139912375,139913098,723,56,399,15.5,55.2,1.02
CpG: 19,chr5,139971427,139971645,218,19,137,17.4,62.8,0.89
CpG: 20,chr5,139972034,139972308,274,20,168,14.6,61.3,0.8
CpG: 28,chr5,139973139,139973495,356,28,239,15.7,67.1,0.74
CpG: 49,chr5,140321303,140321772,469,49,312,20.9,66.5,0.94
CpG: 28,chr5,140331706,140332010,304,28,193,18.4,63.5,0.92
CpG: 52,chr5,140388972,140389469,497,52,356,20.9,71.6,0.83
CpG: 29,chr5,140418509,140418824,315,29,186,18.4,59,1.06
CpG: 87,chr5,140419201,140419877,676,87,484,25.7,71.6,1.03
CpG: 28,chr5,140505491,140505760,269,28,185,20.8,68.8,0.96
CpG: 47,chr5,140524063,140524679,616,47,369,15.3,59.9,0.86
CpG: 19,chr5,140606404,140606620,216,19,156,17.6,72.2,0.68
CpG: 95,chr5,140606977,140607859,882,95,603,21.5,68.4,0.92
CpG: 32,chr5,140648667,140648930,263,32,202,24.3,76.8,0.83
CpG: 56,chr5,140701898,140702429,531,56,369,21.1,69.5,0.87
CpG: 68,chr5,140704432,140705237,805,68,515,16.9,64,0.84
CpG: 26,chr5,140735511,140735799,288,26,200,18.1,69.4,0.76
CpG: 87,chr5,140829898,140830634,736,87,461,23.6,62.6,1.21
CpG: 68,chr5,142367314,142367870,556,68,387,24.5,69.6,1.01
CpG: 47,chr5,142463813,142464276,463,47,322,20.3,69.5,0.87
CpG: 52,chr5,142529774,142530207,433,52,306,24,70.7,0.97
CpG: 94,chr5,142550478,142551390,912,94,634,20.6,69.5,0.85
CpG: 20,chr5,142608607,142608864,257,20,157,15.6,61.1,0.83
CpG: 110,chr5,142629193,142630089,896,110,609,24.6,68,1.06
CpG: 66,chr5,142701967,142702542,575,66,426,23,74.1,0.86
CpG: 24,chr5,142718493,142718833,340,24,210,14.1,61.8,0.74
CpG: 19,chr5,142773846,142774094,248,19,168,15.3,67.7,0.67
CpG: 259,chr5,142815002,142818661,3659,259,2111,14.2,57.7,0.85
CpG: 21,chr5,142820242,142820465,223,21,148,18.8,66.4,0.86
CpG: 18,chr5,142820897,142821160,263,18,163,13.7,62,0.71
CpG: 19,chr5,142886677,142886922,245,19,163,15.5,66.5,0.7
CpG: 129,chr5,142905576,142906846,1270,129,820,20.3,64.6,0.98
CpG: 25,chr5,142929159,142929409,250,25,145,20,58,1.19
CpG: 121,chr5,142960234,142961275,1041,121,704,23.2,67.6,1.02
CpG: 45,chr5,142961823,142962370,547,45,382,16.5,69.8,0.68
CpG: 80,chr5,143112265,143113080,815,80,480,19.6,58.9,1.15
CpG: 39,chr5,143157225,143157624,399,39,266,19.5,66.7,0.89
CpG: 53,chr5,143180372,143180917,545,53,372,19.4,68.3,0.85
CpG: 50,chr5,143235128,143235548,420,50,300,23.8,71.4,0.95
CpG: 279,chr5,143253002,143255255,2253,279,1575,24.8,69.9,1.02
CpG: 58,chr5,143269472,143270105,633,58,403,18.3,63.7,0.91
CpG: 49,chr5,143287753,143288281,528,49,358,18.6,67.8,0.81
CpG: 34,chr5,143293313,143293710,397,34,235,17.1,59.2,0.98
CpG: 66,chr5,143315113,143315587,474,66,348,27.8,73.4,1.04
CpG: 44,chr5,143328953,143329354,401,44,265,21.9,66.1,1.01
CpG: 25,chr5,143357576,143357873,297,25,208,16.8,70,0.69
CpG: 25,chr5,143364173,143364513,340,25,218,14.7,64.1,0.72
CpG: 31,chr5,143369995,143370257,262,31,190,23.7,72.5,0.9
CpG: 35,chr5,143373015,143373258,243,35,178,28.8,73.3,1.08
CpG: 80,chr5,143403644,143404330,686,80,455,23.3,66.3,1.07
CpG: 40,chr5,143464527,143464867,340,40,232,23.5,68.2,1.04
CpG: 83,chr5,143527491,143528307,816,83,523,20.3,64.1,0.99
CpG: 58,chr5,143548675,143549179,504,58,357,23,70.8,0.92
CpG: 77,chr5,143622380,143623022,642,77,465,24,72.4,0.93
CpG: 111,chr5,143731505,143732774,1269,111,720,17.5,56.7,1.09
CpG: 20,chr5,143758160,143758364,204,20,135,19.6,66.2,0.9
CpG: 58,chr5,143817633,143818289,656,58,411,17.7,62.7,0.9
CpG: 69,chr5,143909446,143910295,849,69,527,16.3,62.1,0.85
CpG: 31,chr5,144014581,144014919,338,31,203,18.3,60.1,1.02
CpG: 82,chr5,144100246,144101008,762,82,495,21.5,65,1.07
CpG: 15,chr5,144173656,144173858,202,15,127,14.9,62.9,0.75
CpG: 23,chr5,144191197,144191482,285,23,177,16.1,62.1,0.84
CpG: 52,chr5,144223435,144223928,493,52,324,21.1,65.7,0.99
CpG: 55,chr5,144255404,144255963,559,55,369,19.7,66,0.91
CpG: 88,chr5,144357603,144358599,996,88,670,17.7,67.3,0.79
CpG: 154,chr5,144545394,144546764,1370,154,926,22.5,67.6,0.98
CpG: 21,chr5,144761460,144761662,202,21,140,20.8,69.3,0.87
CpG: 87,chr5,144768035,144768827,792,87,565,22,71.3,0.88
CpG: 17,chr5,144851022,144851257,235,17,146,14.5,62.1,0.76
CpG: 39,chr5,145083701,145084075,374,39,250,20.9,66.8,0.95
CpG: 78,chr5,145114095,145114900,805,78,571,19.4,70.9,0.77
CpG: 96,chr5,145139590,145140829,1239,96,733,15.5,59.2,0.89
CpG: 66,chr5,145166959,145167700,741,66,459,17.8,61.9,0.93
CpG: 33,chr5,145201449,145201941,492,33,286,13.4,58.1,0.8
CpG: 89,chr5,145231440,145232275,835,89,584,21.3,69.9,0.87
CpG: 21,chr5,145280597,145280869,272,21,172,15.4,63.2,0.79
CpG: 56,chr5,146221068,146221568,500,56,339,22.4,67.8,0.98
CpG: 112,chr5,146230887,146231884,997,112,630,22.5,63.2,1.14
CpG: 56,chr5,146385135,146385593,458,56,319,24.5,69.7,1.02
CpG: 53,chr5,146584687,146585123,436,53,312,24.3,71.6,0.95
CpG: 38,chr5,146794925,146795244,319,38,235,23.8,73.7,0.88
CpG: 64,chr5,146832829,146833472,643,64,423,19.9,65.8,0.92
CpG: 54,chr5,146844947,146845583,636,54,409,17,64.3,0.82
CpG: 57,chr5,146948492,146949023,531,57,346,21.5,65.2,1.01
CpG: 26,chr5,146963517,146963807,290,26,187,17.9,64.5,0.86
CpG: 21,chr5,147029220,147029432,212,21,141,19.8,66.5,0.9
CpG: 125,chr5,147076210,147077788,1578,125,1029,15.8,65.2,0.75
CpG: 59,chr5,147112661,147113348,687,59,417,17.2,60.7,1.02
CpG: 84,chr5,147188611,147189451,840,84,572,20,68.1,0.86
CpG: 33,chr5,147189815,147190269,454,33,260,14.5,57.3,0.9
CpG: 37,chr5,147270137,147270628,491,37,327,15.1,66.6,0.7
CpG: 22,chr5,147274597,147274821,224,22,161,19.6,71.9,0.76
CpG: 48,chr5,147304490,147305161,671,48,405,14.3,60.4,0.79
CpG: 98,chr5,147306136,147307352,1216,98,713,16.1,58.6,0.94
CpG: 60,chr5,147399906,147400553,647,60,452,18.5,69.9,0.78
CpG: 134,chr5,147429884,147431236,1352,134,821,19.8,60.7,1.08
CpG: 149,chr5,147724979,147726632,1653,149,1132,18,68.5,0.78
CpG: 22,chr5,147751677,147751938,261,22,181,16.9,69.3,0.7
CpG: 70,chr5,147860377,147861083,706,70,473,19.8,67,0.88
CpG: 21,chr5,147862417,147862696,279,21,162,15.1,58.1,0.9
CpG: 48,chr5,147894523,147895104,581,48,358,16.5,61.6,0.87
CpG: 80,chr5,147957187,147958006,819,80,570,19.5,69.6,0.81
CpG: 89,chr5,148399218,148400010,792,89,549,22.5,69.3,0.94
CpG: 85,chr5,148552180,148552982,802,85,533,21.2,66.5,0.97
CpG: 79,chr5,148928382,148929226,844,79,572,18.7,67.8,0.82
CpG: 24,chr5,149015495,149015859,364,24,224,13.2,61.5,0.7
CpG: 25,chr5,149031298,149031612,314,25,203,15.9,64.6,0.76
CpG: 77,chr5,149184113,149185115,1002,77,607,15.4,60.6,0.84
CpG: 36,chr5,149229087,149229447,360,36,238,20,66.1,0.92
CpG: 26,chr5,149287463,149287797,334,26,182,15.6,54.5,1.07
CpG: 79,chr5,149635836,149636811,975,79,619,16.2,63.5,0.81
CpG: 100,chr5,149678134,149678892,758,100,553,26.4,73,1
CpG: 51,chr5,150118539,150119147,608,51,381,16.8,62.7,0.86
CpG: 52,chr5,150522553,150522908,355,52,259,29.3,73,1.11
CpG: 122,chr5,150593653,150594699,1046,122,766,23.3,73.2,0.87
CpG: 45,chr5,150665130,150665692,562,45,343,16,61,0.88
CpG: 96,chr5,150673582,150674505,923,96,533,20.8,57.7,1.26
CpG: 97,chr5,150952564,150953491,927,97,622,20.9,67.1,0.93
CpG: 39,chr5,151233486,151233844,358,39,252,21.8,70.4,0.89
CpG: 68,chr5,151368422,151369010,588,68,401,23.1,68.2,1
CpG: 106,chr6,17693885,17694907,1022,106,612,20.7,59.9,1.16
CpG: 30,chr6,25689798,25690221,423,30,270,14.2,63.8,0.7
CpG: 29,chr6,3763576,3763862,286,29,202,20.3,70.6,0.82
CpG: 63,chr6,4600767,4601299,532,63,397,23.7,74.6,0.85
CpG: 100,chr6,4747291,4748412,1121,100,612,17.8,54.6,1.2
CpG: 88,chr6,4902881,4903874,993,88,613,17.7,61.7,0.93
CpG: 47,chr6,5298135,5298518,383,47,279,24.5,72.8,0.97
CpG: 24,chr6,5496015,5496279,264,24,180,18.2,68.2,0.79
CpG: 28,chr6,5725672,5725924,252,28,185,22.2,73.4,0.83
CpG: 42,chr6,6005797,6006428,631,42,371,13.3,58.8,0.77
CpG: 45,chr6,6216759,6217226,467,45,331,19.3,70.9,0.77
CpG: 51,chr6,6578294,6578726,432,51,276,23.6,63.9,1.16
CpG: 15,chr6,6598145,6598347,202,15,140,14.9,69.3,0.62
CpG: 18,chr6,6860760,6860979,219,18,117,16.4,53.4,1.18
CpG: 21,chr6,6862725,6862995,270,21,164,15.6,60.7,0.84
CpG: 37,chr6,6863683,6864073,390,37,248,19,63.6,1.04
CpG: 25,chr6,6879318,6879580,262,25,164,19.1,62.6,0.98
CpG: 19,chr6,6880043,6880255,212,19,135,17.9,63.7,0.88
CpG: 51,chr6,6881412,6881925,513,51,337,19.9,65.7,0.94
CpG: 37,chr6,6955842,6956234,392,37,244,18.9,62.2,0.97
CpG: 31,chr6,7554903,7555232,329,31,205,18.8,62.3,0.97
CpG: 38,chr6,7692982,7693332,350,38,244,21.7,69.7,0.89
CpG: 79,chr6,7844531,7845147,616,79,441,25.6,71.6,1.01
CpG: 76,chr6,8209077,8209710,633,76,436,24,68.9,1.03
CpG: 72,chr6,8258938,8259647,709,72,466,20.3,65.7,0.94
CpG: 145,chr6,8509075,8510376,1301,145,822,22.3,63.2,1.13
CpG: 53,chr6,8777792,8778320,528,53,365,20.1,69.1,0.84
CpG: 65,chr6,8948489,8949356,867,65,492,15,56.7,0.93
CpG: 36,chr6,8951048,8951510,462,36,264,15.6,57.1,0.98
CpG: 31,chr6,11907682,11907955,273,31,172,22.7,63,1.15
CpG: 57,chr6,11925808,11926508,700,57,437,16.3,62.4,0.84
CpG: 49,chr6,12748826,12749436,610,49,378,16.1,62,0.84
CpG: 46,chr6,13069762,13070109,347,46,263,26.5,75.8,0.92
CpG: 68,chr6,13607563,13608141,578,68,413,23.5,71.5,0.92
CpG: 65,chr6,13677459,13678170,711,65,475,18.3,66.8,0.82
CpG: 32,chr6,13838658,13839075,417,32,257,15.3,61.6,0.84
CpG: 61,chr6,14901455,14901980,525,61,364,23.2,69.3,0.98
CpG: 65,chr6,15720722,15721404,682,65,472,19.1,69.2,0.8
CpG: 58,chr6,17065000,17065543,543,58,377,21.4,69.4,0.89
CpG: 80,chr6,17463387,17464161,774,80,552,20.7,71.3,0.82
CpG: 52,chr6,17636840,17637325,485,52,318,21.4,65.6,1.05
CpG: 27,chr6,17840455,17840718,263,27,174,20.5,66.2,0.94
CpG: 36,chr6,18030271,18030637,366,36,229,19.7,62.6,1.01
CpG: 16,chr6,18514212,18514425,213,16,141,15,66.2,0.69
CpG: 61,chr6,18514614,18515058,444,61,320,27.5,72.1,1.07
CpG: 37,chr6,18848477,18848790,313,37,208,23.6,66.5,1.08
CpG: 97,chr6,21214451,21215805,1354,97,760,14.3,56.1,0.91
CpG: 57,chr6,21851581,21852160,579,57,393,19.7,67.9,0.86
CpG: 78,chr6,21949379,21950307,928,78,486,16.8,52.4,1.23
CpG: 84,chr6,22355660,22356335,675,84,475,24.9,70.4,1.02
CpG: 57,chr6,22875317,22875918,601,57,383,19,63.7,0.95
CpG: 21,chr6,23158861,23159126,265,21,144,15.8,54.3,1.09
CpG: 21,chr6,23166213,23166478,265,21,145,15.8,54.7,1.08
CpG: 156,chr6,23247534,23249805,2271,156,1344,13.7,59.2,0.79
CpG: 28,chr6,23253713,23254096,383,28,234,14.6,61.1,0.78
CpG: 104,chr6,23838726,23839661,935,104,558,22.2,59.7,1.25
CpG: 55,chr6,24527063,24527824,761,55,447,14.5,58.7,0.85
CpG: 100,chr6,24664466,24665433,967,100,644,20.7,66.6,0.93
CpG: 120,chr6,24955038,24956261,1223,120,799,19.6,65.3,0.92
CpG: 20,chr6,28133666,28133918,252,20,180,15.9,71.4,0.67
CpG: 56,chr6,28134948,28135508,560,56,365,20,65.2,0.94
CpG: 79,chr6,28215244,28215799,555,79,389,28.5,70.1,1.17
CpG: 190,chr6,28260940,28262310,1370,190,960,27.7,70.1,1.13
CpG: 26,chr6,28397695,28398016,321,26,194,16.2,60.4,0.89
CpG: 28,chr6,28421427,28421798,371,28,247,15.1,66.6,0.68
CpG: 72,chr6,28479815,28480665,850,72,545,16.9,64.1,0.83
CpG: 143,chr6,28832067,28833707,1640,143,950,17.4,57.9,1.04
CpG: 60,chr6,28980917,28981694,777,60,465,15.4,59.8,0.86
CpG: 17,chr6,29059954,29060170,216,17,140,15.7,64.8,0.75
CpG: 28,chr6,29164556,29164852,296,28,182,18.9,61.5,1.03
CpG: 99,chr6,29170251,29171278,1027,99,729,19.3,71,0.77
CpG: 71,chr6,29178973,29179665,692,71,472,20.5,68.2,0.91
CpG: 46,chr6,29211959,29212553,594,46,308,15.5,51.9,1.16
CpG: 47,chr6,29215984,29216355,371,47,277,25.3,74.7,0.91
CpG: 37,chr6,29272506,29272924,418,37,267,17.7,63.9,0.87
CpG: 55,chr6,29347829,29348444,615,55,401,17.9,65.2,0.84
CpG: 24,chr6,29396379,29396656,277,24,192,17.3,69.3,0.72
CpG: 32,chr6,29402791,29403103,312,32,222,20.5,71.2,0.82
CpG: 59,chr6,29433165,29433739,574,59,376,20.6,65.5,0.97
CpG: 29,chr6,29473991,29474402,411,29,283,14.1,68.9,0.61
CpG: 19,chr6,29496440,29496642,202,19,135,18.8,66.8,0.84
CpG: 39,chr6,29507708,29508070,362,39,259,21.5,71.5,0.84
CpG: 70,chr6,29526398,29527188,790,70,476,17.7,60.3,0.98
CpG: 66,chr6,29609123,29609957,834,66,526,15.8,63.1,0.82
CpG: 41,chr6,29694117,29694502,385,41,235,21.3,61,1.15
CpG: 103,chr6,29735416,29736541,1125,103,732,18.3,65.1,0.89
CpG: 23,chr6,29768095,29768366,271,23,165,17,60.9,0.92
CpG: 59,chr6,29768611,29769235,624,59,386,18.9,61.9,0.99
CpG: 58,chr6,29916912,29917528,616,58,394,18.8,64,0.94
CpG: 42,chr6,29985114,29985527,413,42,266,20.3,64.4,0.99
CpG: 132,chr6,30047621,30048887,1266,132,801,20.9,63.3,1.04
CpG: 101,chr6,30173225,30174428,1203,101,795,16.8,66.1,0.77
CpG: 52,chr6,30175631,30176220,589,52,386,17.7,65.5,0.83
CpG: 22,chr6,30205724,30205932,208,22,149,21.2,71.6,0.83
CpG: 67,chr6,30303905,30304610,705,67,441,19,62.6,0.97
CpG: 64,chr6,30401585,30402419,834,64,495,15.3,59.4,0.87
CpG: 27,chr6,30459849,30460176,327,27,214,16.5,65.4,0.77
CpG: 50,chr6,30693408,30693968,560,50,386,17.9,68.9,0.76
CpG: 58,chr6,30737907,30738499,592,58,398,19.6,67.2,0.87
CpG: 60,chr6,30896366,30896954,588,60,374,20.4,63.6,1.01
CpG: 145,chr6,30957813,30959263,1450,145,957,20,66,0.92
CpG: 97,chr6,31216144,31216980,836,97,564,23.2,67.5,1.03
CpG: 18,chr6,31217780,31217986,206,18,134,17.5,65,0.83
CpG: 19,chr6,31218145,31218355,210,19,135,18.1,64.3,0.88
CpG: 19,chr6,31220369,31220605,236,19,171,16.1,72.5,0.67
CpG: 71,chr6,31398706,31399395,689,71,430,20.6,62.4,1.06
CpG: 17,chr6,31551053,31551257,204,17,116,16.7,56.9,1.1
CpG: 77,chr6,31563377,31564076,699,77,479,22,68.5,0.94
CpG: 106,chr6,32587247,32588222,975,106,709,21.7,72.7,0.82
CpG: 38,chr6,33059887,33060308,421,38,275,18.1,65.3,0.85
CpG: 45,chr6,34176681,34177168,487,45,312,18.5,64.1,0.9
CpG: 47,chr6,34317156,34317652,496,47,328,19,66.1,0.87
CpG: 90,chr6,34780395,34781021,626,90,437,28.8,69.8,1.18
CpG: 49,chr6,34877803,34878253,450,49,319,21.8,70.9,0.87
CpG: 40,chr6,34910614,34910925,311,40,227,25.7,73,0.98
CpG: 34,chr6,34921371,34921757,386,34,256,17.6,66.3,0.81
CpG: 61,chr6,35133373,35134122,749,61,459,16.3,61.3,0.87
CpG: 80,chr6,35177410,35178159,749,80,492,21.4,65.7,1
CpG: 35,chr6,35252564,35252894,330,35,216,21.2,65.5,0.99
CpG: 71,chr6,35539177,35539991,814,71,529,17.4,65,0.83
CpG: 17,chr6,36388526,36388735,209,17,135,16.3,64.6,0.82
CpG: 30,chr6,37299800,37300061,261,30,193,23,73.9,0.85
CpG: 54,chr6,37441666,37442372,706,54,448,15.3,63.5,0.76
CpG: 22,chr6,37805977,37806209,232,22,142,19,61.2,1.05
CpG: 116,chr6,37870514,37871689,1175,116,697,19.7,59.3,1.12
CpG: 93,chr6,38253804,38254565,761,93,505,24.4,66.4,1.11
CpG: 64,chr6,38298725,38299328,603,64,411,21.2,68.2,0.92
CpG: 95,chr6,38353832,38354843,1011,95,637,18.8,63,0.95
CpG: 132,chr6,38433598,38434970,1372,132,826,19.2,60.2,1.06
CpG: 39,chr6,38534663,38535073,410,39,280,19,68.3,0.83
CpG: 111,chr6,38551042,38552133,1091,111,710,20.3,65.1,0.97
CpG: 111,chr6,38636348,38637221,873,111,631,25.4,72.3,0.97
CpG: 59,chr6,38662933,38663383,450,59,297,26.2,66,1.21
CpG: 29,chr6,38875743,38875963,220,29,163,26.4,74.1,0.96
CpG: 43,chr6,38876444,38876762,318,43,227,27,71.4,1.08
CpG: 148,chr6,39117719,39118857,1138,148,809,26,71.1,1.03
CpG: 218,chr6,39205445,39207371,1926,218,1217,22.6,63.2,1.13
CpG: 30,chr6,39256728,39257003,275,30,201,21.8,73.1,0.84
CpG: 39,chr6,39377419,39377777,358,39,263,21.8,73.5,0.82
CpG: 102,chr6,39419579,39420548,969,102,598,21.1,61.7,1.11
CpG: 89,chr6,39557241,39558084,843,89,539,21.1,63.9,1.07
CpG: 51,chr6,39573728,39574238,510,51,343,20,67.3,0.89
CpG: 37,chr6,39592525,39592828,303,37,210,24.4,69.3,1.04
CpG: 67,chr6,39724926,39725645,719,67,390,18.6,54.2,1.27
CpG: 31,chr6,39810804,39811079,275,31,196,22.5,71.3,0.9
CpG: 173,chr6,39871426,39873478,2052,173,1342,16.9,65.4,0.79
CpG: 41,chr6,40325363,40325763,400,41,279,20.5,69.8,0.89
CpG: 97,chr6,40435325,40436341,1016,97,706,19.1,69.5,0.79
CpG: 45,chr6,40471323,40471715,392,45,258,23,65.8,1.07
CpG: 70,chr6,41605163,41605844,681,70,488,20.6,71.7,0.8
CpG: 50,chr6,42264830,42265350,520,50,352,19.2,67.7,0.86
CpG: 19,chr6,42323651,42323926,275,19,186,13.8,67.6,0.62
CpG: 76,chr6,42324107,42324860,753,76,533,20.2,70.8,0.81
CpG: 91,chr6,42349550,42350532,982,91,693,18.5,70.6,0.75
CpG: 19,chr6,43265286,43265518,232,19,155,16.4,66.8,0.74
CpG: 43,chr6,47044621,47045050,429,43,264,20,61.5,1.06
CpG: 170,chr6,47453877,47455201,1324,170,933,25.7,70.5,1.05
CpG: 140,chr6,47594209,47595636,1427,140,925,19.6,64.8,0.94
CpG: 40,chr6,47651181,47651625,444,40,290,18,65.3,0.91
CpG: 63,chr6,47655096,47655872,776,63,408,16.2,52.6,1.36
CpG: 63,chr6,47659417,47660178,761,63,409,16.6,53.7,1.32
CpG: 63,chr6,47663757,47664539,782,63,409,16.1,52.3,1.36
CpG: 63,chr6,47668093,47668869,776,63,408,16.2,52.6,1.36
CpG: 63,chr6,47672401,47673195,794,63,408,15.9,51.4,1.38
CpG: 63,chr6,47676739,47677521,782,63,409,16.1,52.3,1.36
CpG: 63,chr6,47681060,47681839,779,63,408,16.2,52.4,1.36
CpG: 63,chr6,47685378,47686154,776,63,408,16.2,52.6,1.36
CpG: 61,chr6,47739973,47740697,724,61,393,16.9,54.3,1.32
CpG: 61,chr6,47748593,47749373,780,61,393,15.6,50.4,1.41
CpG: 96,chr6,47752927,47754228,1301,96,723,14.8,55.6,1.07
CpG: 66,chr6,47757761,47758538,777,66,420,17,54.1,1.33
CpG: 69,chr6,47763359,47764105,746,69,419,18.5,56.2,1.32
CpG: 57,chr6,47772100,47772843,743,57,375,15.3,50.5,1.4
CpG: 27,chr6,47778345,47778649,304,27,171,17.8,56.2,1.45
CpG: 48,chr6,47813181,47813657,476,48,323,20.2,67.9,0.89
CpG: 55,chr6,47830173,47830632,459,55,319,24,69.5,1.01
CpG: 95,chr6,47835579,47836375,796,95,566,23.9,71.1,0.95
CpG: 17,chr6,47866538,47866783,245,17,146,13.9,59.6,0.79
CpG: 64,chr6,47877366,47878156,790,64,498,16.2,63,0.82
CpG: 57,chr6,47904639,47905350,711,57,439,16,61.7,0.84
CpG: 40,chr6,47920658,47920987,329,40,232,24.3,70.5,0.98
CpG: 59,chr6,47942970,47943596,626,59,419,18.8,66.9,0.84
CpG: 29,chr6,47953268,47953639,371,29,228,15.6,61.5,0.84
CpG: 61,chr6,48024605,48025400,795,61,494,15.3,62.1,0.81
CpG: 171,chr6,48047436,48048984,1548,171,941,22.1,60.8,1.2
CpG: 18,chr6,48063944,48064147,203,18,132,17.7,65,0.88
CpG: 126,chr6,48085916,48086847,931,126,713,27.1,76.6,0.93
CpG: 48,chr6,48395584,48396016,432,48,298,22.2,69,0.94
CpG: 110,chr6,48438015,48439276,1261,110,826,17.4,65.5,0.84
CpG: 39,chr6,48445275,48445645,370,39,261,21.1,70.5,0.89
CpG: 24,chr6,48554714,48554977,263,24,160,18.3,60.8,1
CpG: 58,chr6,48593726,48594311,585,58,397,19.8,67.9,0.91
CpG: 69,chr6,48596933,48597805,872,69,571,15.8,65.5,0.75
CpG: 52,chr6,48601670,48602284,614,52,405,16.9,66,0.78
CpG: 58,chr6,48619637,48620402,765,58,493,15.2,64.4,0.74
CpG: 34,chr6,48626968,48627338,370,34,241,18.4,65.1,0.88
CpG: 60,chr6,48629246,48629757,511,60,361,23.5,70.6,0.95
CpG: 44,chr6,48742702,48743152,450,44,304,19.6,67.6,0.87
CpG: 59,chr6,49073757,49074325,568,59,379,20.8,66.7,0.93
CpG: 165,chr6,49213759,49215544,1785,165,1110,18.5,62.2,0.96
CpG: 68,chr6,49217622,49218373,751,68,469,18.1,62.5,0.93
CpG: 106,chr6,49263180,49264200,1020,106,680,20.8,66.7,0.94
CpG: 42,chr6,49319178,49319609,431,42,285,19.5,66.1,0.9
CpG: 24,chr6,49367862,49368094,232,24,151,20.7,65.1,0.99
CpG: 40,chr6,49395411,49395824,413,40,287,19.4,69.5,0.83
CpG: 53,chr6,49822266,49822869,603,53,407,17.6,67.5,0.78
CpG: 82,chr6,50109967,50110570,603,82,411,27.2,68.2,1.19
CpG: 23,chr6,50196936,50197226,290,23,193,15.9,66.6,0.79
CpG: 51,chr6,50455486,50456118,632,51,416,16.1,65.8,0.75
CpG: 72,chr6,50566267,50566888,621,72,420,23.2,67.6,1.02
CpG: 35,chr6,50596371,50596701,330,35,233,21.2,70.6,0.86
CpG: 21,chr6,50609571,50609836,265,21,144,15.8,54.3,1.09
CpG: 21,chr6,50620685,50620950,265,21,144,15.8,54.3,1.09
CpG: 21,chr6,51168827,51169063,236,21,166,17.8,70.3,0.72
CpG: 25,chr6,51178616,51178862,246,25,157,20.3,63.8,1.01
CpG: 84,chr6,51270352,51271202,850,84,593,19.8,69.8,0.82
CpG: 23,chr6,51379738,51379944,206,23,126,22.3,61.2,1.2
CpG: 80,chr6,51432616,51433450,834,80,575,19.2,68.9,0.81
CpG: 239,chr6,51468854,51471252,2398,239,1501,19.9,62.6,1.02
CpG: 32,chr6,51523921,51524167,246,32,176,26,71.5,1.02
CpG: 36,chr6,51592542,51592962,420,36,276,17.1,65.7,0.79
CpG: 32,chr6,51612599,51612978,379,32,200,16.9,52.8,1.21
CpG: 52,chr6,52012222,52012799,577,52,377,18,65.3,0.85
CpG: 55,chr6,52158323,52158942,619,55,422,17.8,68.2,0.77
CpG: 34,chr6,52168677,52169061,384,34,260,17.7,67.7,0.77
CpG: 34,chr6,52172474,52172811,337,34,214,20.2,63.5,1.02
CpG: 60,chr6,52175601,52176167,566,60,372,21.2,65.7,0.99
CpG: 34,chr6,52177163,52177666,503,34,299,13.5,59.4,0.77
CpG: 106,chr6,52191053,52192226,1173,106,644,18.1,54.9,1.2
CpG: 106,chr6,52203745,52204843,1098,106,677,19.3,61.7,1.02
CpG: 21,chr6,52206446,52206654,208,21,125,20.2,60.1,1.13
CpG: 24,chr6,52211661,52211870,209,24,144,23,68.9,0.97
CpG: 82,chr6,52216854,52217758,904,82,578,18.1,63.9,0.89
CpG: 44,chr6,52221352,52221915,563,44,349,15.6,62,0.81
CpG: 82,chr6,52225256,52226313,1057,82,670,15.5,63.4,0.77
CpG: 24,chr6,52229018,52229288,270,24,162,17.8,60,0.99
CpG: 30,chr6,52229855,52230272,417,30,265,14.4,63.5,0.71
CpG: 31,chr6,52230497,52230833,336,31,239,18.5,71.1,0.74
CpG: 16,chr6,52233394,52233615,221,16,118,14.5,53.4,1.05
CpG: 106,chr6,52234022,52235088,1066,106,682,19.9,64,0.97
CpG: 37,chr6,52240323,52240829,506,37,284,14.6,56.1,0.93
CpG: 94,chr6,52245220,52246577,1357,94,807,13.9,59.5,0.78
CpG: 20,chr6,52249281,52249560,279,20,160,14.3,57.3,0.87
CpG: 96,chr6,52252739,52254111,1372,96,811,14,59.1,0.81
CpG: 99,chr6,52259986,52261198,1212,99,634,16.3,52.3,1.21
CpG: 21,chr6,52306029,52306293,264,21,166,15.9,62.9,0.82
CpG: 27,chr6,52310426,52310794,368,27,221,14.7,60.1,0.83
CpG: 59,chr6,52313447,52314303,856,59,542,13.8,63.3,0.69
CpG: 19,chr6,52314580,52314803,223,19,135,17,60.5,0.95
CpG: 44,chr6,52316547,52316860,313,44,235,28.1,75.1,1.07
CpG: 44,chr6,52640053,52640488,435,44,294,20.2,67.6,0.9
CpG: 64,chr6,52713669,52714158,489,64,348,26.2,71.2,1.07
CpG: 95,chr6,53287052,53288348,1296,95,743,14.7,57.3,0.89
CpG: 262,chr6,53817864,53821098,3234,262,2096,16.2,64.8,0.78
CpG: 101,chr6,54039433,54040338,905,101,638,22.3,70.5,0.9
CpG: 31,chr6,54326915,54327286,371,31,235,16.7,63.3,0.83
CpG: 23,chr6,54327754,54327961,207,23,138,22.2,66.7,1
CpG: 55,chr6,54429510,54430095,585,55,372,18.8,63.6,0.93
CpG: 54,chr6,54565792,54566443,651,54,427,16.6,65.6,0.77
CpG: 76,chr6,54595059,54595806,747,76,500,20.3,66.9,0.91
CpG: 84,chr6,54681430,54682378,948,84,579,17.7,61.1,0.95
CpG: 107,chr6,54816484,54817543,1059,107,622,20.2,58.7,1.17
CpG: 31,chr6,54943914,54944335,421,31,274,14.7,65.1,0.7
CpG: 41,chr6,54972329,54972715,386,41,280,21.2,72.5,0.81
CpG: 51,chr6,54992613,54993161,548,51,355,18.6,64.8,0.89
CpG: 78,chr6,55037878,55038424,546,78,403,28.6,73.8,1.07
CpG: 70,chr6,55117390,55118156,766,70,526,18.3,68.7,0.78
CpG: 73,chr6,55451841,55452596,755,73,534,19.3,70.7,0.79
CpG: 19,chr6,55676991,55677213,222,19,155,17.1,69.8,0.71
CpG: 34,chr6,56568618,56569026,408,34,268,16.7,65.7,0.78
CpG: 30,chr6,56652156,56652438,282,30,189,21.3,67,0.95
CpG: 29,chr6,56704409,56704725,316,29,198,18.4,62.7,0.94
CpG: 75,chr6,56714832,56715544,712,75,478,21.1,67.1,0.94
CpG: 94,chr6,56797254,56797875,621,94,453,30.3,72.9,1.15
CpG: 50,chr6,56831909,56832501,592,50,374,16.9,63.2,0.85
CpG: 61,chr6,56923588,56924058,470,61,333,26,70.9,1.04
CpG: 33,chr6,57691673,57692067,394,33,269,16.8,68.3,0.72
CpG: 57,chr6,57702753,57703381,628,57,414,18.2,65.9,0.84
CpG: 85,chr6,57824468,57825228,760,85,532,22.4,70,0.92
CpG: 46,chr6,58640332,58640723,391,46,289,23.5,73.9,0.87
CpG: 35,chr6,58831481,58831768,287,35,212,24.4,73.9,0.9
CpG: 43,chr6,58906723,58907147,424,43,274,20.3,64.6,0.97
CpG: 57,chr6,59208734,59209157,423,57,312,27,73.8,1
CpG: 24,chr6,59426131,59426440,309,24,210,15.5,68,0.67
CpG: 107,chr6,61180109,61181080,971,107,585,22,60.2,1.23
CpG: 154,chr6,63255997,63257723,1726,154,1125,17.8,65.2,0.84
CpG: 90,chr6,64728991,64730262,1271,90,803,14.2,63.2,0.71
CpG: 43,chr6,64734532,64735014,482,43,330,17.8,68.5,0.77
CpG: 80,chr6,65042536,65043113,577,80,409,27.7,70.9,1.11
CpG: 38,chr6,65381245,65381614,369,38,243,20.6,65.9,0.98
CpG: 118,chr6,65671473,65673037,1564,118,970,15.1,62,0.79
CpG: 50,chr6,65778882,65779338,456,50,336,21.9,73.7,0.81
CpG: 51,chr6,66535129,66535719,590,51,370,17.3,62.7,0.9
CpG: 91,chr6,66896221,66896972,751,91,535,24.2,71.2,0.98
CpG: 85,chr6,67036551,67037372,821,85,557,20.7,67.8,0.9
CpG: 110,chr6,67266766,67267745,979,110,671,22.5,68.5,0.96
CpG: 20,chr6,67375984,67376221,237,20,160,16.9,67.5,0.75
CpG: 75,chr6,67534863,67535660,797,75,495,18.8,62.1,0.98
CpG: 56,chr6,70791757,70792385,628,56,387,17.8,61.6,0.96
CpG: 82,chr6,70844459,70845096,637,82,432,25.7,67.8,1.14
CpG: 111,chr6,70956191,70957293,1102,111,750,20.1,68.1,0.87
CpG: 45,chr6,71012835,71013554,719,45,453,12.5,63,0.63
CpG: 36,chr6,71143854,71144338,484,36,310,14.9,64,0.73
CpG: 59,chr6,71271482,71272173,691,59,430,17.1,62.2,0.88
CpG: 151,chr6,71439807,71441301,1494,151,908,20.2,60.8,1.1
CpG: 107,chr6,71493748,71494659,911,107,640,23.5,70.3,0.97
CpG: 56,chr6,71543831,71544415,584,56,403,19.2,69,0.81
CpG: 138,chr6,71632075,71633576,1501,138,967,18.4,64.4,0.89
CpG: 80,chr6,71707650,71708424,774,80,517,20.7,66.8,0.93
CpG: 70,chr6,71831186,71831868,682,70,460,20.5,67.4,0.9
CpG: 26,chr6,71908647,71908894,247,26,159,21.1,64.4,1.02
CpG: 22,chr6,71909035,71909346,311,22,178,14.1,57.2,0.89
CpG: 73,chr6,72097333,72098050,717,73,486,20.4,67.8,0.89
CpG: 17,chr6,72189130,72189353,223,17,158,15.2,70.9,0.68
CpG: 136,chr6,72234374,72235599,1225,136,831,22.2,67.8,0.97
CpG: 55,chr6,72344886,72345318,432,55,286,25.5,66.2,1.17
CpG: 51,chr6,72347217,72347722,505,51,298,20.2,59,1.16
CpG: 67,chr6,72355133,72355938,805,67,510,16.6,63.4,0.83
CpG: 29,chr6,72362092,72362448,356,29,211,16.3,59.3,0.99
CpG: 39,chr6,72380221,72380604,383,39,272,20.4,71,0.82
CpG: 128,chr6,72438918,72440046,1128,128,768,22.7,68.1,0.98
CpG: 73,chr6,72616154,72617110,956,73,559,15.3,58.5,0.89
CpG: 125,chr6,72788139,72789661,1522,125,947,16.4,62.2,0.85
CpG: 180,chr6,72898699,72900420,1721,180,1031,20.9,59.9,1.17
CpG: 76,chr6,72958077,72958838,761,76,521,20,68.5,0.86
CpG: 32,chr6,73248712,73249000,288,32,200,22.2,69.4,0.92
CpG: 24,chr6,76497806,76498103,297,24,156,16.2,52.5,1.2
CpG: 45,chr6,77242604,77243130,526,45,331,17.1,62.9,0.86
CpG: 77,chr6,77243659,77244825,1166,77,696,13.2,59.7,0.74
CpG: 37,chr6,77979429,77979749,320,37,234,23.1,73.1,0.87
CpG: 21,chr6,78215864,78216077,213,21,132,19.7,62,1.04
CpG: 44,chr6,81923609,81924028,419,44,260,21,62.1,1.1
CpG: 30,chr6,81965597,81965896,299,30,193,20.1,64.5,0.96
CpG: 20,chr6,82041726,82041935,209,20,144,19.1,68.9,0.82
CpG: 22,chr6,82091889,82092091,202,22,131,21.8,64.9,1.05
CpG: 72,chr6,82652529,82653217,688,72,475,20.9,69,0.89
CpG: 118,chr6,82773252,82774818,1566,118,971,15.1,62,0.78
CpG: 25,chr6,82939460,82939736,276,25,153,18.1,55.4,1.18
CpG: 58,chr6,83032766,83033557,791,58,479,14.7,60.6,0.81
CpG: 97,chr6,83054373,83055311,938,97,615,20.7,65.6,0.97
CpG: 237,chr6,83068670,83071455,2785,237,1841,17,66.1,0.78
CpG: 89,chr6,83077883,83078793,910,89,599,19.6,65.8,0.92
CpG: 30,chr6,83086319,83086720,401,30,220,15,54.9,1
CpG: 39,chr6,83087532,83087946,414,39,265,18.8,64,0.92
CpG: 90,chr6,83101552,83102491,939,90,647,19.2,68.9,0.81
CpG: 72,chr6,83109003,83109669,666,72,439,21.6,65.9,1
CpG: 66,chr6,83115395,83115903,508,66,359,26,70.7,1.05
CpG: 40,chr6,83121851,83122345,494,40,325,16.2,65.8,0.75
CpG: 25,chr6,83124902,83125204,302,25,187,16.6,61.9,0.88
CpG: 31,chr6,83135740,83136072,332,31,224,18.7,67.5,0.85
CpG: 34,chr6,83142284,83142535,251,34,183,27.1,72.9,1.02
CpG: 28,chr6,83156318,83156590,272,28,176,20.6,64.7,0.98
CpG: 56,chr6,83161761,83162535,774,56,489,14.5,63.2,0.74
CpG: 38,chr6,83165651,83166066,415,38,243,18.3,58.6,1.07
CpG: 44,chr6,83317279,83317640,361,44,258,24.4,71.5,0.96
CpG: 53,chr6,83325886,83326393,507,53,337,20.9,66.5,0.95
CpG: 41,chr6,83349338,83349632,294,41,231,27.9,78.6,0.94
CpG: 32,chr6,83368001,83368474,473,32,311,13.5,65.8,0.63
CpG: 20,chr6,83404465,83404724,259,20,169,15.4,65.3,0.73
CpG: 32,chr6,83441466,83441729,263,32,203,24.3,77.2,0.84
CpG: 138,chr6,83455856,83457263,1407,138,955,19.6,67.9,0.86
CpG: 39,chr6,83506706,83507080,374,39,244,20.9,65.2,0.98
CpG: 21,chr6,83572297,83572498,201,21,136,20.9,67.7,0.99
CpG: 48,chr6,83702197,83702908,711,48,427,13.5,60.1,0.76
CpG: 18,chr6,83710517,83710773,256,18,167,14.1,65.2,0.68
CpG: 84,chr6,83711102,83712235,1133,84,678,14.8,59.8,0.84
CpG: 34,chr6,83758091,83758487,396,34,248,17.2,62.6,0.88
CpG: 37,chr6,83762851,83763289,438,37,272,16.9,62.1,0.88
CpG: 52,chr6,83775506,83775920,414,52,280,25.1,67.6,1.1
CpG: 49,chr6,83794935,83795394,459,49,313,21.4,68.2,0.92
CpG: 44,chr6,83831493,83831795,302,44,228,29.1,75.5,1.04
CpG: 48,chr6,83867007,83867590,583,48,398,16.5,68.3,0.71
CpG: 83,chr6,83914265,83915013,748,83,526,22.2,70.3,0.91
CpG: 23,chr6,84008734,84009014,280,23,183,16.4,65.4,0.78
CpG: 37,chr6,84105596,84105971,375,37,240,19.7,64,0.97
CpG: 15,chr6,84134929,84135137,208,15,114,14.4,54.8,1.02
CpG: 21,chr6,84135481,84135753,272,21,182,15.4,66.9,0.69
CpG: 121,chr6,84584238,84585962,1724,121,1021,14,59.2,0.8
CpG: 44,chr6,84587610,84588092,482,44,335,18.3,69.5,0.77
CpG: 36,chr6,84588986,84589351,365,36,192,19.7,52.6,1.43
CpG: 60,chr6,85069047,85069571,524,60,376,22.9,71.8,0.92
CpG: 22,chr6,85076195,85076474,279,22,173,15.8,62,0.84
CpG: 23,chr6,85125992,85126193,201,23,138,22.9,68.7,0.97
CpG: 44,chr6,85137409,85137931,522,44,348,16.9,66.7,0.76
CpG: 28,chr6,85155024,85155360,336,28,228,16.7,67.9,0.72
CpG: 89,chr6,85187497,85188423,926,89,648,19.2,70,0.79
CpG: 58,chr6,85190026,85190668,642,58,389,18.1,60.6,0.99
CpG: 79,chr6,85332553,85333522,969,79,631,16.3,65.1,0.77
CpG: 65,chr6,85374017,85374652,635,65,447,20.5,70.4,0.83
CpG: 17,chr6,85374879,85375126,247,17,150,13.8,60.7,0.76
CpG: 29,chr6,85409138,85409386,248,29,173,23.4,69.8,0.96
CpG: 38,chr6,85431902,85432290,388,38,274,19.6,70.6,0.82
CpG: 125,chr6,85450982,85452285,1303,125,843,19.2,64.7,0.92
CpG: 90,chr6,85483892,85484820,928,90,580,19.4,62.5,0.99
CpG: 41,chr6,85502724,85503112,388,41,295,21.1,76,0.75
CpG: 258,chr6,85511434,85513948,2514,258,1755,20.5,69.8,0.84
CpG: 39,chr6,85587420,85587883,463,39,238,16.8,51.4,1.29
CpG: 47,chr6,85915672,85916086,414,47,284,22.7,68.6,0.97
CpG: 43,chr6,85936857,85937227,370,43,259,23.2,70,0.96
CpG: 62,chr6,85961083,85961710,627,62,418,19.8,66.7,0.89
CpG: 55,chr6,86028638,86029254,616,55,416,17.9,67.5,0.79
CpG: 91,chr6,86195043,86195934,891,91,602,20.4,67.6,0.9
CpG: 75,chr6,86365396,86366076,680,75,471,22.1,69.3,0.96
CpG: 41,chr6,86371352,86371713,361,41,231,22.7,64,1.11
CpG: 16,chr6,86388668,86388878,210,16,122,15.2,58.1,0.91
CpG: 39,chr6,86396825,86397232,407,39,285,19.2,70,0.84
CpG: 55,chr6,86404166,86404743,577,55,386,19.1,66.9,0.86
CpG: 55,chr6,86438328,86439022,694,55,402,15.9,57.9,0.96
CpG: 43,chr6,86472180,86472487,307,43,218,28,71,1.11
CpG: 195,chr6,86525287,86527366,2079,195,1247,18.8,60,1.05
CpG: 84,chr6,86668692,86669612,920,84,567,18.3,61.6,0.97
CpG: 25,chr6,86684350,86684602,252,25,164,19.8,65.1,0.95
CpG: 102,chr6,86732757,86733594,837,102,593,24.4,70.8,0.98
CpG: 42,chr6,86849544,86849940,396,42,268,21.2,67.7,0.93
CpG: 33,chr6,87009802,87010228,426,33,278,15.5,65.3,0.74
CpG: 67,chr6,87042262,87043087,825,67,510,16.2,61.8,0.86
CpG: 48,chr6,87335213,87335720,507,48,341,18.9,67.3,0.84
CpG: 21,chr6,87590534,87590802,268,21,175,15.7,65.3,0.74
CpG: 92,chr6,87730712,87731583,871,92,577,21.1,66.2,0.96
CpG: 44,chr6,87732664,87733065,401,44,280,21.9,69.8,0.94
CpG: 123,chr6,87810995,87812372,1377,123,896,17.9,65.1,0.88
CpG: 40,chr6,87838577,87838982,405,40,251,19.8,62,1.04
CpG: 111,chr6,87850403,87851334,931,111,668,23.8,71.8,0.94
CpG: 69,chr6,87913903,87914618,715,69,427,19.3,59.7,1.11
CpG: 151,chr6,87980363,87981988,1625,151,993,18.6,61.1,1
CpG: 57,chr6,88044805,88045331,526,57,333,21.7,63.3,1.09
CpG: 71,chr6,88084338,88085119,781,71,524,18.2,67.1,0.81
CpG: 101,chr6,88189579,88190968,1389,101,825,14.5,59.4,0.83
CpG: 101,chr6,88193561,88194598,1037,101,712,19.5,68.7,0.83
CpG: 79,chr6,88196376,88197401,1025,79,651,15.4,63.5,0.76
CpG: 106,chr6,88198416,88199830,1414,106,896,15,63.4,0.75
CpG: 73,chr6,88446045,88446698,653,73,455,22.4,69.7,0.93
CpG: 40,chr6,88465321,88465823,502,40,302,15.9,60.2,0.89
CpG: 66,chr6,88499946,88500391,445,66,311,29.7,69.9,1.22
CpG: 70,chr6,88518505,88519156,651,70,418,21.5,64.2,1.04
CpG: 28,chr6,88577883,88578241,358,28,227,15.6,63.4,0.78
CpG: 51,chr6,88627316,88627759,443,51,317,23,71.6,0.9
CpG: 83,chr6,88724239,88725142,903,83,534,18.4,59.1,1.05
CpG: 131,chr6,88841538,88843023,1485,131,992,17.6,66.8,0.81
CpG: 84,chr6,88874241,88875232,991,84,523,17,52.8,1.26
CpG: 26,chr6,88898586,88898835,249,26,162,20.9,65.1,1.02
CpG: 65,chr6,88901958,88902760,802,65,500,16.2,62.3,0.83
CpG: 18,chr6,89356691,89356901,210,18,129,17.1,61.4,0.91
CpG: 148,chr6,89361672,89363166,1494,148,904,19.8,60.5,1.08
CpG: 49,chr6,89595241,89595684,443,49,307,22.1,69.3,0.93
CpG: 83,chr6,89643931,89644742,811,83,570,20.5,70.3,0.85
CpG: 33,chr6,89835235,89835685,450,33,289,14.7,64.2,0.72
CpG: 89,chr6,90309076,90309823,747,89,509,23.8,68.1,1.03
CpG: 22,chr6,90325047,90325311,264,22,178,16.7,67.4,0.73
CpG: 134,chr6,90369447,90370686,1239,134,838,21.6,67.6,0.95
CpG: 128,chr6,90462276,90463253,977,128,693,26.2,70.9,1.05
CpG: 19,chr6,90463529,90463796,267,19,174,14.2,65.2,0.67
CpG: 24,chr6,90604871,90605087,216,24,160,22.2,74.1,0.81
CpG: 42,chr6,90716274,90716611,337,42,256,24.9,76,0.86
CpG: 121,chr6,90736183,90737219,1036,121,738,23.4,71.2,0.92
CpG: 18,chr6,90810022,90810275,253,18,168,14.2,66.4,0.66
CpG: 37,chr6,90905567,90905844,277,37,205,26.7,74,0.98
CpG: 133,chr6,90987727,90988765,1038,133,727,25.6,70,1.05
CpG: 85,chr6,91116402,91117010,608,85,455,28,74.8,1
CpG: 37,chr6,91156622,91157055,433,37,310,17.1,71.6,0.67
CpG: 26,chr6,91212723,91212972,249,26,163,20.9,65.5,0.98
CpG: 49,chr6,91285181,91285721,540,49,371,18.1,68.7,0.77
CpG: 20,chr6,91394412,91394653,241,20,151,16.6,62.7,0.85
CpG: 20,chr6,91409724,91409960,236,20,134,16.9,56.8,1.06
CpG: 67,chr6,91410967,91411539,572,67,365,23.4,63.8,1.16
CpG: 91,chr6,91472979,91474077,1098,91,681,16.6,62,0.87
CpG: 70,chr6,91515592,91516352,760,70,447,18.4,58.8,1.07
CpG: 34,chr6,91684131,91684399,268,34,200,25.4,74.6,0.94
CpG: 72,chr6,91843353,91843917,564,72,390,25.5,69.1,1.07
CpG: 44,chr6,91877944,91878509,565,44,349,15.6,61.8,0.82
CpG: 40,chr6,91978786,91979172,386,40,251,20.7,65,0.98
CpG: 108,chr6,92091214,92092551,1337,108,739,16.2,55.3,1.06
CpG: 41,chr6,92183653,92184109,456,41,296,18,64.9,0.86
CpG: 55,chr6,92214564,92214984,420,55,289,26.2,68.8,1.13
CpG: 50,chr6,92705942,92706356,414,50,314,24.2,75.8,0.84
CpG: 64,chr6,92943066,92943760,694,64,457,18.4,65.9,0.85
CpG: 45,chr6,93678356,93679022,666,45,403,13.5,60.5,0.74
CpG: 167,chr6,94282825,94284758,1933,167,1212,17.3,62.7,0.9
CpG: 32,chr6,94500122,94500556,434,32,272,14.7,62.7,0.75
CpG: 129,chr6,94699249,94700447,1198,129,785,21.5,65.5,1.01
CpG: 101,chr6,95117642,95118490,848,101,581,23.8,68.5,1.02
CpG: 57,chr6,95718298,95718771,473,57,344,24.1,72.7,0.91
CpG: 48,chr6,97148453,97148996,543,48,385,17.7,70.9,0.7
CpG: 52,chr6,97178802,97179375,573,52,347,18.2,60.6,0.99
CpG: 24,chr6,97205398,97205611,213,24,153,22.5,71.8,0.88
CpG: 23,chr6,97210680,97210892,212,23,132,21.7,62.3,1.15
CpG: 40,chr6,97487529,97488031,502,40,348,15.9,69.3,0.67
CpG: 80,chr6,97616867,97617761,894,80,608,17.9,68,0.78
CpG: 37,chr6,99028420,99028824,404,37,269,18.3,66.6,0.85
CpG: 189,chr6,99520490,99523049,2559,189,1459,14.8,57,0.92
CpG: 63,chr6,99666389,99666913,524,63,371,24,70.8,0.96
CpG: 173,chr6,99692056,99693456,1400,173,938,24.7,67,1.1
CpG: 68,chr6,99726179,99726741,562,68,379,24.2,67.4,1.06
CpG: 27,chr6,99878147,99878434,287,27,184,18.8,64.1,0.92
CpG: 160,chr6,100286500,100288230,1730,160,931,18.5,53.8,1.28
CpG: 63,chr6,100562933,100563742,809,63,520,15.6,64.3,0.75
CpG: 87,chr6,100670591,100671381,790,87,488,22,61.8,1.17
CpG: 50,chr6,100704747,100705181,434,50,287,23,66.1,1.07
CpG: 95,chr6,100833465,100834336,871,95,532,21.8,61.1,1.19
CpG: 117,chr6,101377170,101378087,917,117,618,25.5,67.4,1.13
CpG: 35,chr6,102564203,102564578,375,35,212,18.7,56.5,1.2
CpG: 20,chr6,103512200,103512436,236,20,154,16.9,65.3,0.85
CpG: 41,chr6,106769115,106769454,339,41,222,24.2,65.5,1.14
CpG: 40,chr6,106799839,106800195,356,40,256,22.5,71.9,0.87
CpG: 51,chr6,107529694,107530211,517,51,358,19.7,69.2,0.83
CpG: 28,chr6,108140205,108140507,302,28,186,18.5,61.6,0.98
CpG: 41,chr6,108185236,108185566,330,41,238,24.8,72.1,0.96
CpG: 89,chr6,108659365,108660445,1080,89,745,16.5,69,0.7
CpG: 29,chr6,108668436,108668742,306,29,203,19,66.3,0.86
CpG: 86,chr6,108782978,108783829,851,86,565,20.2,66.4,0.92
CpG: 109,chr6,108828290,108829267,977,109,655,22.3,67,0.99
CpG: 49,chr6,110645760,110646300,540,49,349,18.1,64.6,0.87
CpG: 89,chr6,112489024,112489883,859,89,570,20.7,66.4,0.94
CpG: 67,chr6,112696302,112696813,511,67,341,26.2,66.7,1.18
CpG: 21,chr6,112727264,112727536,272,21,178,15.4,65.4,0.72
CpG: 48,chr6,113046135,113046615,480,48,327,20,68.1,0.86
CpG: 160,chr6,113076301,113077811,1510,160,1055,21.2,69.9,0.88
CpG: 36,chr6,113193928,113194365,437,36,276,16.5,63.2,0.85
CpG: 37,chr6,113194947,113195335,388,37,287,19.1,74,0.74
CpG: 50,chr6,113237615,113238113,498,50,354,20.1,71.1,0.8
CpG: 29,chr6,113282268,113282555,287,29,203,20.2,70.7,0.81
CpG: 24,chr6,113283118,113283413,295,24,200,16.3,67.8,0.71
CpG: 95,chr6,113306583,113307700,1117,95,705,17,63.1,0.86
CpG: 27,chr6,113326707,113327013,306,27,202,17.6,66,0.82
CpG: 75,chr6,113377521,113378618,1097,75,715,13.7,65.2,0.66
CpG: 49,chr6,113392417,113392955,538,49,376,18.2,69.9,0.75
CpG: 20,chr6,113419217,113419451,234,20,147,17.1,62.8,0.88
CpG: 40,chr6,113442530,113442983,453,40,297,17.7,65.6,0.82
CpG: 45,chr6,113469546,113469968,422,45,285,21.3,67.5,0.94
CpG: 86,chr6,113482496,113483395,899,86,599,19.1,66.6,0.86
CpG: 58,chr6,113494571,113495133,562,58,383,20.6,68.1,0.89
CpG: 27,chr6,113501731,113502045,314,27,210,17.2,66.9,0.79
CpG: 35,chr6,113531382,113531739,357,35,227,19.6,63.6,0.98
CpG: 63,chr6,113604509,113605208,699,63,459,18,65.7,0.84
CpG: 62,chr6,113624007,113624545,538,62,362,23,67.3,1.03
CpG: 24,chr6,113638383,113638613,230,24,156,20.9,67.8,0.91
CpG: 140,chr6,113696828,113698036,1208,140,795,23.2,65.8,1.07
CpG: 31,chr6,113748479,113748845,366,31,217,16.9,59.3,1.02
CpG: 24,chr6,113755142,113755487,345,24,210,13.9,60.9,0.75
CpG: 19,chr6,113759004,113759225,221,19,137,17.2,62,0.93
CpG: 38,chr6,113891266,113891562,296,38,193,25.7,65.2,1.21
CpG: 25,chr6,114041664,114041930,266,25,172,18.8,64.7,0.9
CpG: 56,chr6,114131081,114131736,655,56,397,17.1,60.6,0.93
CpG: 40,chr6,114282693,114283052,359,40,265,22.3,73.8,0.82
CpG: 48,chr6,114397717,114398262,545,48,339,17.6,62.2,0.93
CpG: 31,chr6,114643000,114643309,309,31,190,20.1,61.5,1.12
CpG: 40,chr6,114738297,114738621,324,40,243,24.7,75,0.88
CpG: 17,chr6,114870838,114871071,233,17,139,14.6,59.7,0.82
CpG: 141,chr6,114968647,114970013,1366,141,917,20.6,67.1,0.93
CpG: 45,chr6,115037547,115037959,412,45,294,21.8,71.4,0.86
CpG: 75,chr6,115134842,115135537,695,75,481,21.6,69.2,0.91
CpG: 97,chr6,115360967,115362226,1259,97,838,15.4,66.6,0.72
CpG: 36,chr6,115544555,115544868,313,36,209,23,66.8,1.06
CpG: 42,chr6,115601820,115602215,395,42,250,21.3,63.3,1.11
CpG: 82,chr6,115676059,115676846,787,82,532,20.8,67.6,0.91
CpG: 20,chr6,115774520,115774734,214,20,145,18.7,67.8,0.83
CpG: 63,chr6,115808192,115808780,588,63,383,21.4,65.1,1.01
CpG: 44,chr6,115853290,115853807,517,44,321,17,62.1,0.88
CpG: 151,chr6,115993393,115994758,1365,151,897,22.1,65.7,1.03
CpG: 29,chr6,116173644,116173902,258,29,167,22.5,64.7,1.08
CpG: 91,chr6,116193099,116193796,697,91,478,26.1,68.6,1.13
CpG: 41,chr6,116207988,116208491,503,41,324,16.3,64.4,0.79
CpG: 85,chr6,116337772,116338529,757,85,518,22.5,68.4,0.96
CpG: 39,chr6,116460726,116461210,484,39,320,16.1,66.1,0.74
CpG: 19,chr6,116551150,116551363,213,19,130,17.8,61,0.97
CpG: 54,chr6,116628520,116629022,502,54,353,21.5,70.3,0.88
CpG: 15,chr6,116673568,116673770,202,15,134,14.9,66.3,0.68
CpG: 17,chr6,116674001,116674241,240,17,144,14.2,60,0.79
CpG: 98,chr6,117168392,117169397,1005,98,671,19.5,66.8,0.88
CpG: 51,chr6,117841070,117841490,420,51,306,24.3,72.9,0.93
CpG: 49,chr6,117879370,117879738,368,49,256,26.6,69.6,1.1
CpG: 171,chr6,117906612,117908222,1610,171,1137,21.2,70.6,0.86
CpG: 66,chr6,117916852,117917556,704,66,464,18.8,65.9,0.9
CpG: 18,chr6,117997794,117998008,214,18,133,16.8,62.1,0.88
CpG: 50,chr6,118011301,118011798,497,50,281,20.1,56.5,1.26
CpG: 45,chr6,118138867,118139255,388,45,268,23.2,69.1,0.98
CpG: 90,chr6,118196624,118197355,731,90,518,24.6,70.9,0.98
CpG: 21,chr6,118197517,118197810,293,21,170,14.3,58,0.85
CpG: 61,chr6,118419169,118419849,680,61,439,17.9,64.6,0.86
CpG: 39,chr6,118455108,118455567,459,39,301,17,65.6,0.8
CpG: 38,chr6,118561966,118562449,483,38,299,15.7,61.9,0.82
CpG: 26,chr6,118593661,118593973,312,26,190,16.7,60.9,0.92
CpG: 182,chr6,119107316,119109048,1732,182,1098,21,63.4,1.05
CpG: 63,chr6,119175140,119175720,580,63,408,21.7,70.3,0.9
CpG: 29,chr6,119330531,119330841,310,29,213,18.7,68.7,0.87
CpG: 87,chr6,119388188,119389079,891,87,501,19.5,56.2,1.24
CpG: 21,chr6,119440273,119440582,309,21,195,13.6,63.1,0.7
CpG: 202,chr6,119479017,119481177,2160,202,1354,18.7,62.7,0.95
CpG: 153,chr6,119543535,119544615,1080,153,783,28.3,72.5,1.08
CpG: 78,chr6,119847711,119848612,901,78,500,17.3,55.5,1.13
CpG: 64,chr6,119902473,119903048,575,64,391,22.3,68,0.97
CpG: 162,chr6,120037053,120038858,1805,162,1115,18,61.8,0.95
CpG: 91,chr6,120293940,120294802,862,91,609,21.1,70.6,0.85
CpG: 97,chr6,120363831,120364879,1048,97,637,18.5,60.8,1
CpG: 87,chr6,120463175,120463834,659,87,489,26.4,74.2,1
CpG: 151,chr6,120492284,120494016,1732,151,1065,17.4,61.5,0.93
CpG: 75,chr6,120530876,120531553,677,75,466,22.2,68.8,0.94
CpG: 194,chr6,120665378,120667360,1982,194,1215,19.6,61.3,1.05
CpG: 36,chr6,120822428,120822852,424,36,263,17,62,0.9
CpG: 47,chr6,120836127,120836595,468,47,326,20.1,69.7,0.83
CpG: 63,chr6,120916390,120916975,585,63,411,21.5,70.3,0.88
CpG: 55,chr6,121109702,121110111,409,55,309,26.9,75.6,0.94
CpG: 31,chr6,121184143,121184504,361,31,236,17.2,65.4,0.81
CpG: 20,chr6,121245707,121245917,210,20,139,19,66.2,0.9
CpG: 64,chr6,121412797,121413574,777,64,517,16.5,66.5,0.74
CpG: 73,chr6,121473043,121473822,779,73,550,18.7,70.6,0.75
CpG: 39,chr6,122308725,122309255,530,39,326,14.7,61.5,0.79
CpG: 39,chr6,122339254,122339637,383,39,236,20.4,61.6,1.1
CpG: 55,chr6,122764324,122765059,735,55,439,15,59.7,0.85
CpG: 48,chr6,122801536,122802048,512,48,316,18.8,61.7,1.03
CpG: 47,chr6,122811171,122811601,430,47,304,21.9,70.7,0.88
CpG: 61,chr6,122819748,122820314,566,61,371,21.6,65.5,1
CpG: 64,chr6,122874394,122875041,647,64,409,19.8,63.2,1.02
CpG: 54,chr6,124414623,124415193,570,54,349,18.9,61.2,1.01
CpG: 81,chr6,124662440,124663336,896,81,558,18.1,62.3,0.93
CpG: 77,chr6,124711921,124712806,885,77,581,17.4,65.6,0.81
CpG: 39,chr6,124740611,124741127,516,39,329,15.1,63.8,0.74
CpG: 83,chr6,124745540,124746245,705,83,499,23.5,70.8,0.94
CpG: 29,chr6,124769346,124769679,333,29,198,17.4,59.5,1.06
CpG: 21,chr6,124805580,124805836,256,21,171,16.4,66.8,0.74
CpG: 35,chr6,124829251,124829614,363,35,228,19.3,62.8,1
CpG: 78,chr6,124856986,124857726,740,78,517,21.1,69.9,0.86
CpG: 17,chr6,124861153,124861366,213,17,131,16,61.5,0.86
CpG: 34,chr6,124863583,124863959,376,34,248,18.1,66,0.85
CpG: 30,chr6,124910090,124910346,256,30,186,23.4,72.7,0.89
CpG: 65,chr6,124917446,124917993,547,65,344,23.8,62.9,1.21
CpG: 96,chr6,124930978,124931868,890,96,649,21.6,72.9,0.81
CpG: 72,chr6,124965218,124965795,577,72,410,25,71.1,0.99
CpG: 24,chr6,124996811,124997047,236,24,173,20.3,73.3,0.82
CpG: 64,chr6,125008833,125009436,603,64,418,21.2,69.3,0.9
CpG: 54,chr6,125081651,125082307,656,54,407,16.5,62,0.86
CpG: 88,chr6,125095941,125096818,877,88,633,20.1,72.2,0.77
CpG: 65,chr6,125131617,125132294,677,65,433,19.2,64,0.96
CpG: 52,chr6,125145374,125146026,652,52,438,16,67.2,0.72
CpG: 66,chr6,125164801,125165747,946,66,600,14,63.4,0.7
CpG: 66,chr6,125191398,125192175,777,66,479,17,61.6,0.9
CpG: 39,chr6,125215530,125215961,431,39,277,18.1,64.3,0.88
CpG: 20,chr6,125285873,125286114,241,20,171,16.6,71,0.68
CpG: 37,chr6,125313654,125314098,444,37,297,16.7,66.9,0.78
CpG: 26,chr6,125331001,125331242,241,26,170,21.6,70.5,0.91
CpG: 27,chr6,125361723,125361990,267,27,175,20.2,65.5,0.94
CpG: 28,chr6,125380286,125380628,342,28,238,16.4,69.6,0.68
CpG: 60,chr6,125494138,125494838,700,60,461,17.1,65.9,0.79
CpG: 21,chr6,126163317,126163581,264,21,161,15.9,61,0.87
CpG: 39,chr6,126164583,126165062,479,39,299,16.3,62.4,0.84
CpG: 34,chr6,126642985,126643351,366,34,221,18.6,60.4,1.02
CpG: 82,chr6,126644088,126645125,1037,82,658,15.8,63.5,0.78
CpG: 96,chr6,126739257,126740526,1269,96,799,15.1,63,0.77
CpG: 50,chr6,126939176,126939700,524,50,350,19.1,66.8,0.86
CpG: 45,chr6,127080139,127080530,391,45,276,23,70.6,0.93
CpG: 49,chr6,127109179,127109769,590,49,364,16.6,61.7,0.87
CpG: 31,chr6,127150427,127150799,372,31,241,16.7,64.8,0.79
CpG: 28,chr6,127154936,127155221,285,28,202,19.6,70.9,0.8
CpG: 60,chr6,127453451,127454026,575,60,384,20.9,66.8,0.95
CpG: 21,chr6,127561172,127561428,256,21,169,16.4,66,0.76
CpG: 139,chr6,127767713,127769401,1688,139,1084,16.5,64.2,0.81
CpG: 20,chr6,127887694,127887913,219,20,158,18.3,72.1,0.71
CpG: 77,chr6,128034329,128035107,778,77,534,19.8,68.6,0.84
CpG: 37,chr6,128143279,128143573,294,37,227,25.2,77.2,0.95
CpG: 44,chr6,128200323,128200800,477,44,326,18.4,68.3,0.8
CpG: 78,chr6,128300212,128300948,736,78,527,21.2,71.6,0.83
CpG: 68,chr6,128355285,128356066,781,68,515,17.4,65.9,0.8
CpG: 74,chr6,128362433,128363264,831,74,455,17.8,54.8,1.21
CpG: 32,chr6,128424605,128424922,317,32,201,20.2,63.4,1.04
CpG: 124,chr6,128437694,128438825,1131,124,798,21.9,70.6,0.88
CpG: 30,chr6,128760215,128760550,335,30,193,17.9,57.6,1.11
CpG: 25,chr6,128799073,128799301,228,25,147,21.9,64.5,1.14
CpG: 20,chr6,128799586,128799789,203,20,132,19.7,65,1.06
CpG: 29,chr6,128838654,128839008,354,29,197,16.4,55.6,1.13
CpG: 40,chr6,128842885,128843268,383,40,239,20.9,62.4,1.16
CpG: 26,chr6,129533138,129533419,281,26,177,18.5,63,0.95
CpG: 33,chr6,131293024,131293292,268,33,168,24.6,62.7,1.28
CpG: 50,chr6,131388210,131388616,406,50,241,24.6,59.4,1.4
CpG: 34,chr6,131433654,131434025,371,34,259,18.3,69.8,0.75
CpG: 53,chr6,133105264,133105746,482,53,333,22,69.1,0.93
CpG: 117,chr6,134034939,134036272,1333,117,808,17.6,60.6,0.96
CpG: 87,chr6,134566800,134567430,630,87,430,27.6,68.3,1.2
CpG: 41,chr6,134632108,134632598,490,41,319,16.7,65.1,0.79
CpG: 52,chr6,134640878,134641309,431,52,316,24.1,73.3,0.91
CpG: 73,chr6,134792285,134792997,712,73,449,20.5,63.1,1.05
CpG: 44,chr6,134829938,134830535,597,44,368,14.7,61.6,0.78
CpG: 23,chr6,134869872,134870187,315,23,189,14.6,60,0.82
CpG: 79,chr6,134897633,134898621,988,79,576,16,58.3,0.94
CpG: 109,chr6,134919925,134921264,1339,109,821,16.3,61.3,0.87
CpG: 60,chr6,134926880,134927491,611,60,400,19.6,65.5,0.95
CpG: 55,chr6,134928247,134928889,642,55,361,17.1,56.2,1.09
CpG: 53,chr6,134983536,134984131,595,53,403,17.8,67.7,0.78
CpG: 42,chr6,135065333,135065837,504,42,313,16.7,62.1,0.87
CpG: 33,chr6,135167872,135168251,379,33,259,17.4,68.3,0.75
CpG: 50,chr6,135197875,135198380,505,50,323,19.8,64,0.98
CpG: 18,chr6,135732972,135733232,260,18,148,13.8,56.9,0.86
CpG: 22,chr6,136044162,136044450,288,22,152,15.3,52.8,1.1
CpG: 24,chr6,136328529,136328742,213,24,134,22.5,62.9,1.15
CpG: 16,chr6,136399201,136399416,215,16,134,14.9,62.3,0.78
CpG: 18,chr6,136401548,136401771,223,18,135,16.1,60.5,0.9
CpG: 20,chr6,136470880,136471084,204,20,150,19.6,73.5,0.76
CpG: 57,chr6,136518600,136519178,578,57,356,19.7,61.6,1.06
CpG: 25,chr6,136661504,136661800,296,25,189,16.9,63.9,0.84
CpG: 39,chr6,136804031,136804370,339,39,216,23,63.7,1.13
CpG: 85,chr6,136808190,136808958,768,85,517,22.1,67.3,1
CpG: 26,chr6,136816694,136816927,233,26,175,22.3,75.1,0.98
CpG: 63,chr6,136827679,136828198,519,63,367,24.3,70.7,0.98
CpG: 23,chr6,137118141,137118352,211,23,130,21.8,61.6,1.26
CpG: 46,chr6,137169292,137169803,511,46,349,18,68.3,0.77
CpG: 47,chr6,137252334,137252899,565,47,361,16.6,63.9,0.82
CpG: 79,chr6,137648668,137649362,694,79,453,22.8,65.3,1.07
CpG: 86,chr6,137734936,137735602,666,86,449,25.8,67.4,1.14
CpG: 16,chr6,137754479,137754711,232,16,159,13.8,68.5,0.64
CpG: 106,chr6,140423722,140425095,1373,106,780,15.4,56.8,0.96
CpG: 53,chr6,140623384,140623751,367,53,258,28.9,70.3,1.18
CpG: 97,chr6,141249501,141250487,986,97,696,19.7,70.6,0.81
CpG: 42,chr6,142345561,142345965,404,42,260,20.8,64.4,1.01
CpG: 102,chr6,142386839,142387626,787,102,560,25.9,71.2,1.03
CpG: 21,chr6,142414629,142414856,227,21,157,18.5,69.2,0.8
CpG: 17,chr6,142507871,142508094,223,17,143,15.2,64.1,0.74
CpG: 34,chr6,142571133,142571622,489,34,334,13.9,68.3,0.61
CpG: 49,chr6,142756619,142757160,541,49,345,18.1,63.8,0.91
CpG: 51,chr6,142964031,142964549,518,51,360,19.7,69.5,0.84
CpG: 96,chr6,143099458,143100348,890,96,595,21.6,66.9,0.97
CpG: 129,chr6,143166839,143167957,1118,129,777,23.1,69.5,0.97
CpG: 22,chr6,143833412,143833654,242,22,154,18.2,63.6,0.91
CpG: 40,chr6,144781479,144781906,427,40,296,18.7,69.3,0.79
CpG: 48,chr6,145048358,145048813,455,48,317,21.1,69.7,0.87
CpG: 15,chr6,145075573,145075779,206,15,121,14.6,58.7,0.85
CpG: 29,chr6,145210860,145211224,364,29,222,15.9,61,0.89
CpG: 128,chr6,145249372,145250626,1254,128,673,20.4,53.7,1.42
CpG: 34,chr6,145340686,145340989,303,34,211,22.4,69.6,0.95
CpG: 21,chr6,145341275,145341588,313,21,171,13.4,54.6,0.9
CpG: 46,chr6,145746907,145747473,566,46,355,16.3,62.7,0.83
CpG: 138,chr6,145862743,145863901,1158,138,815,23.8,70.4,0.97
CpG: 101,chr6,145865536,145866825,1289,101,795,15.7,61.7,0.82
CpG: 80,chr6,146501592,146502753,1161,80,705,13.8,60.7,0.75
CpG: 64,chr6,146577626,146578299,673,64,456,19,67.8,0.83
CpG: 47,chr6,146634260,146634695,435,47,263,21.6,60.5,1.18
CpG: 47,chr6,146642364,146642903,539,47,368,17.4,68.3,0.75
CpG: 21,chr6,146647262,146647565,303,21,171,13.9,56.4,0.87
CpG: 103,chr6,146724800,146725620,820,103,564,25.1,68.8,1.07
CpG: 21,chr6,146795952,146796187,235,21,168,17.9,71.5,0.7
CpG: 90,chr6,146888055,146888732,677,90,496,26.6,73.3,0.99
CpG: 56,chr6,147042740,147043242,502,56,355,22.3,70.7,0.89
CpG: 85,chr6,147091368,147092178,810,85,552,21,68.1,0.91
CpG: 58,chr6,147263689,147264305,616,58,411,18.8,66.7,0.86
CpG: 75,chr6,147475831,147476518,687,75,473,21.8,68.9,0.93
CpG: 23,chr6,148047232,148047498,266,23,180,17.3,67.7,0.76
CpG: 103,chr6,148211419,148212430,1011,103,627,20.4,62,1.06
CpG: 90,chr6,148354554,148355538,984,90,611,18.3,62.1,0.95
CpG: 80,chr6,148443973,148444722,749,80,504,21.4,67.3,0.96
CpG: 31,chr6,148831204,148831672,468,31,299,13.2,63.9,0.67
CpG: 61,chr6,148895887,148896457,570,61,398,21.4,69.8,0.97
CpG: 217,chr6,148944508,148946749,2241,217,1367,19.4,61,1.05
CpG: 158,chr6,149100691,149101866,1175,158,837,26.9,71.2,1.06
CpG: 54,chr6,149309345,149309837,492,54,338,22,68.7,0.93
CpG: 18,chr6,149353654,149353874,220,18,146,16.4,66.4,0.75
CpG: 27,chr6,149361515,149361900,385,27,257,14,66.8,0.63
CpG: 135,chr7,19004142,19005664,1522,135,1032,17.7,67.8,0.77
CpG: 26,chr7,51511100,51511412,312,26,198,16.7,63.5,0.83
CpG: 37,chr7,99483355,99483713,358,37,233,20.7,65.1,0.98
CpG: 18,chr7,102236147,102236390,243,18,148,14.8,60.9,0.8
CpG: 22,chr7,3181031,3181267,236,22,147,18.6,62.3,1
CpG: 28,chr7,3303442,3303817,375,28,249,14.9,66.4,0.69
CpG: 27,chr7,3366695,3366942,247,27,152,21.9,61.5,1.22
CpG: 26,chr7,3411983,3412269,286,26,188,18.2,65.7,0.84
CpG: 87,chr7,3414874,3415855,981,87,518,17.7,52.8,1.28
CpG: 28,chr7,3423522,3423834,312,28,215,17.9,68.9,0.87
CpG: 17,chr7,3617298,3617534,236,17,146,14.4,61.9,0.76
CpG: 32,chr7,3629691,3630056,365,32,195,17.5,53.4,1.24
CpG: 106,chr7,3645002,3645963,961,106,652,22.1,67.8,0.96
CpG: 27,chr7,3665238,3665517,279,27,184,19.4,65.9,0.93
CpG: 23,chr7,3685743,3685983,240,23,161,19.2,67.1,0.89
CpG: 173,chr7,3692527,3694831,2304,173,1399,15,60.7,0.83
CpG: 61,chr7,3703897,3704757,860,61,469,14.2,54.5,0.96
CpG: 84,chr7,4136845,4137609,764,84,524,22,68.6,0.94
CpG: 18,chr7,4146944,4147148,204,18,147,17.6,72.1,0.69
CpG: 57,chr7,4149173,4149746,573,57,380,19.9,66.3,0.9
CpG: 27,chr7,4151444,4151745,301,27,205,17.9,68.1,0.78
CpG: 80,chr7,4501074,4501809,735,80,421,21.8,57.3,1.33
CpG: 104,chr7,4658436,4659457,1021,104,602,20.4,59,1.18
CpG: 20,chr7,4707259,4707474,215,20,153,18.6,71.2,0.79
CpG: 32,chr7,4740062,4740398,336,32,211,19,62.8,0.98
CpG: 39,chr7,4776890,4777325,435,39,317,17.9,72.9,0.68
CpG: 85,chr7,4789016,4789622,606,85,455,28.1,75.1,1
CpG: 79,chr7,4792725,4793649,924,79,562,17.1,60.8,0.94
CpG: 91,chr7,4811708,4812740,1032,91,613,17.6,59.4,1.01
CpG: 19,chr7,4829972,4830224,252,19,166,15.1,65.9,0.7
CpG: 59,chr7,4836288,4836843,555,59,373,21.3,67.2,0.98
CpG: 62,chr7,4844026,4844842,816,62,535,15.2,65.6,0.72
CpG: 22,chr7,4865968,4866227,259,22,153,17,59.1,1
CpG: 19,chr7,4876978,4877242,264,19,167,14.4,63.3,0.73
CpG: 44,chr7,4915076,4915545,469,44,283,18.8,60.3,1.06
CpG: 107,chr7,4993506,4994754,1248,107,861,17.1,69,0.72
CpG: 18,chr7,4995824,4996052,228,18,152,15.8,66.7,0.72
CpG: 54,chr7,5008123,5008930,807,54,525,13.4,65.1,0.63
CpG: 40,chr7,5014335,5014938,603,40,380,13.3,63,0.69
CpG: 58,chr7,5015255,5015841,586,58,401,19.8,68.4,0.85
CpG: 22,chr7,5017884,5018195,311,22,187,14.1,60.1,0.8
CpG: 50,chr7,5020228,5020739,511,50,359,19.6,70.3,0.79
CpG: 166,chr7,5030199,5031983,1784,166,1204,18.6,67.5,0.82
CpG: 44,chr7,5038259,5038649,390,44,269,22.6,69,0.95
CpG: 34,chr7,5051495,5051839,344,34,210,19.8,61,1.08
CpG: 55,chr7,5052792,5053325,533,55,374,20.6,70.2,0.86
CpG: 55,chr7,5056708,5057231,523,55,372,21,71.1,0.83
CpG: 27,chr7,5060288,5060672,384,27,247,14.1,64.3,0.69
CpG: 150,chr7,5061019,5062612,1593,150,969,18.8,60.8,1.03
CpG: 71,chr7,5080074,5080680,606,71,398,23.4,65.7,1.09
CpG: 30,chr7,5125832,5126107,275,30,188,21.8,68.4,0.93
CpG: 80,chr7,6132062,6133015,953,80,640,16.8,67.2,0.76
CpG: 112,chr7,6155116,6156491,1375,112,784,16.3,57,1.02
CpG: 15,chr7,6172892,6173097,205,15,114,14.6,55.6,0.95
CpG: 45,chr7,6189543,6189911,368,45,258,24.5,70.1,1
CpG: 39,chr7,6286201,6286593,392,39,262,19.9,66.8,0.94
CpG: 39,chr7,6331082,6331473,391,39,250,19.9,63.9,0.98
CpG: 24,chr7,6363189,6363498,309,24,188,15.5,60.8,0.85
CpG: 41,chr7,6382996,6383536,540,41,353,15.2,65.4,0.72
CpG: 24,chr7,6696357,6696642,285,24,182,16.8,63.9,0.84
CpG: 25,chr7,6729450,6729785,335,25,212,14.9,63.3,0.76
CpG: 27,chr7,6730062,6730398,336,27,222,16.1,66.1,0.76
CpG: 17,chr7,6977238,6977454,216,17,135,15.7,62.5,0.81
CpG: 17,chr7,7121294,7121514,220,17,124,15.5,56.4,0.99
CpG: 62,chr7,7277784,7278551,767,62,427,16.2,55.7,1.04
CpG: 135,chr7,7298064,7299770,1706,135,1065,15.8,62.4,0.82
CpG: 27,chr7,7300628,7300903,275,27,192,19.6,69.8,0.82
CpG: 17,chr7,10495183,10495395,212,17,121,16,57.1,0.99
CpG: 46,chr7,12478243,12478755,512,46,336,18,65.6,0.84
CpG: 41,chr7,12780502,12780826,324,41,221,25.3,68.2,1.11
CpG: 29,chr7,12803403,12803766,363,29,226,16,62.3,0.83
CpG: 40,chr7,12818459,12818889,430,40,280,18.6,65.1,0.89
CpG: 35,chr7,12834896,12835208,312,35,191,22.4,61.2,1.2
CpG: 22,chr7,12897810,12898078,268,22,161,16.4,60.1,0.95
CpG: 64,chr7,12921732,12922559,827,64,481,15.5,58.2,0.92
CpG: 63,chr7,12928092,12928689,597,63,403,21.1,67.5,0.94
CpG: 43,chr7,12965767,12966298,531,43,336,16.2,63.3,0.81
CpG: 32,chr7,12971075,12971465,390,32,247,16.4,63.3,0.83
CpG: 42,chr7,12977841,12978296,455,42,295,18.5,64.8,0.88
CpG: 55,chr7,13007636,13008222,586,55,387,18.8,66,0.87
CpG: 38,chr7,13009624,13010099,475,38,303,16,63.8,0.79
CpG: 134,chr7,13023959,13025144,1185,134,808,22.6,68.2,0.97
CpG: 41,chr7,13034422,13034860,438,41,280,18.7,63.9,0.92
CpG: 21,chr7,13037443,13037683,240,21,153,17.5,63.8,0.99
CpG: 73,chr7,13037887,13038630,743,73,481,19.7,64.7,0.94
CpG: 123,chr7,13043322,13044478,1156,123,784,21.3,67.8,0.93
CpG: 44,chr7,13054161,13054813,652,44,386,13.5,59.2,0.8
CpG: 43,chr7,13260981,13261582,601,43,370,14.3,61.6,0.76
CpG: 55,chr7,13278477,13279091,614,55,392,17.9,63.8,0.88
CpG: 100,chr7,14622325,14623100,775,100,478,25.8,61.7,1.36
CpG: 25,chr7,15922242,15922486,244,25,159,20.5,65.2,0.97
CpG: 47,chr7,15945751,15946165,414,47,266,22.7,64.3,1.13
CpG: 35,chr7,15957460,15957815,355,35,226,19.7,63.7,0.98
CpG: 48,chr7,16047317,16047946,629,48,407,15.3,64.7,0.74
CpG: 27,chr7,16052785,16053116,331,27,204,16.3,61.6,0.86
CpG: 54,chr7,16061523,16061849,326,54,252,33.1,77.3,1.12
CpG: 21,chr7,16062006,16062250,244,21,165,17.2,67.6,0.85
CpG: 63,chr7,16098224,16099022,798,63,530,15.8,66.4,0.75
CpG: 24,chr7,16119940,16120208,268,24,171,17.9,63.8,0.9
CpG: 40,chr7,16140564,16141134,570,40,352,14,61.8,0.74
CpG: 43,chr7,16144921,16145340,419,43,277,20.5,66.1,0.95
CpG: 38,chr7,16158751,16159080,329,38,225,23.1,68.4,0.99
CpG: 33,chr7,16175321,16175588,267,33,197,24.7,73.8,0.91
CpG: 17,chr7,16218183,16218393,210,17,132,16.2,62.9,0.83
CpG: 23,chr7,16221963,16222170,207,23,133,22.2,64.3,1.14
CpG: 98,chr7,16272668,16273703,1035,98,710,18.9,68.6,0.81
CpG: 21,chr7,16274115,16274406,291,21,186,14.4,63.9,0.71
CpG: 61,chr7,16286230,16286796,566,61,405,21.6,71.6,0.98
CpG: 25,chr7,16295475,16295759,284,25,162,17.6,57,1.08
CpG: 51,chr7,16299595,16300104,509,51,354,20,69.5,0.83
CpG: 98,chr7,16309424,16310589,1165,98,718,16.8,61.6,0.9
CpG: 32,chr7,16312088,16312450,362,32,216,17.7,59.7,1.01
CpG: 41,chr7,16313668,16314092,424,41,306,19.3,72.2,0.77
CpG: 52,chr7,16387559,16388065,506,52,330,20.6,65.2,0.99
CpG: 151,chr7,16399593,16401468,1875,151,1106,16.1,59,0.96
CpG: 32,chr7,16452924,16453199,275,32,184,23.3,66.9,1.05
CpG: 31,chr7,16474573,16474839,266,31,184,23.3,69.2,0.98
CpG: 91,chr7,16475558,16476830,1272,91,792,14.3,62.3,0.74
CpG: 136,chr7,16614337,16615609,1272,136,803,21.4,63.1,1.08
CpG: 21,chr7,16618935,16619164,229,21,127,18.3,55.5,1.21
CpG: 28,chr7,16738346,16738666,320,28,213,17.5,66.6,0.8
CpG: 25,chr7,16771916,16772201,285,25,170,17.5,59.6,0.99
CpG: 51,chr7,16781943,16782384,441,51,309,23.1,70.1,0.95
CpG: 120,chr7,16810724,16811833,1109,120,766,21.6,69.1,0.91
CpG: 72,chr7,16816158,16816693,535,72,392,26.9,73.3,1.01
CpG: 37,chr7,16842619,16843085,466,37,293,15.9,62.9,0.86
CpG: 16,chr7,16855719,16855949,230,16,150,13.9,65.2,0.66
CpG: 22,chr7,16865629,16865923,294,22,174,15,59.2,0.85
CpG: 20,chr7,16874993,16875257,264,20,159,15.2,60.2,0.85
CpG: 26,chr7,16875430,16875650,220,26,163,23.6,74.1,0.93
CpG: 162,chr7,16885081,16886384,1303,162,816,24.9,62.6,1.27
CpG: 18,chr7,16895119,16895341,222,18,141,16.2,63.5,0.8
CpG: 22,chr7,16906988,16907278,290,22,187,15.2,64.5,0.73
CpG: 78,chr7,16923740,16924420,680,78,433,22.9,63.7,1.14
CpG: 34,chr7,16944548,16944930,382,34,256,17.8,67,0.79
CpG: 40,chr7,16946660,16947083,423,40,279,18.9,66,0.87
CpG: 19,chr7,17022406,17022646,240,19,145,15.8,60.4,0.87
CpG: 47,chr7,17027556,17027959,403,47,289,23.3,71.7,0.93
CpG: 36,chr7,17056218,17056516,298,36,208,24.2,69.8,1
CpG: 34,chr7,18402702,18403107,405,34,291,16.8,71.9,0.65
CpG: 34,chr7,18464333,18464761,428,34,305,15.9,71.3,0.63
CpG: 22,chr7,18892326,18892567,241,22,163,18.3,67.6,0.8
CpG: 33,chr7,18893814,18894150,336,33,238,19.6,70.8,0.83
CpG: 32,chr7,18910180,18910521,341,32,207,18.8,60.7,1.08
CpG: 27,chr7,18926087,18926380,293,27,208,18.4,71,0.73
CpG: 92,chr7,18957478,18958577,1099,92,611,16.7,55.6,1.09
CpG: 17,chr7,18962878,18963101,223,17,138,15.2,61.9,0.8
CpG: 29,chr7,18991023,18991368,345,29,225,16.8,65.2,0.82
CpG: 79,chr7,18991833,18992615,782,79,512,20.2,65.5,0.94
CpG: 29,chr7,19012167,19012532,365,29,258,15.9,70.7,0.66
CpG: 45,chr7,19024146,19024466,320,45,230,28.1,71.9,1.1
CpG: 39,chr7,19065704,19066021,317,39,209,24.6,65.9,1.13
CpG: 41,chr7,19075958,19076394,436,41,261,18.8,59.9,1.05
CpG: 18,chr7,19092969,19093217,248,18,166,14.5,66.9,0.68
CpG: 25,chr7,19094103,19094344,241,25,160,20.7,66.4,0.95
CpG: 83,chr7,19094814,19095521,707,83,489,23.5,69.2,0.98
CpG: 44,chr7,19118232,19118533,301,44,223,29.2,74.1,1.07
CpG: 27,chr7,19131580,19131802,222,27,160,24.3,72.1,0.96
CpG: 58,chr7,19149090,19149924,834,58,473,13.9,56.7,0.87
CpG: 22,chr7,19157426,19157629,203,22,143,21.7,70.4,0.88
CpG: 53,chr7,19179263,19179866,603,53,376,17.6,62.4,0.9
CpG: 89,chr7,19227952,19228775,823,89,535,21.6,65,1.03
CpG: 55,chr7,19271340,19271981,641,55,421,17.2,65.7,0.8
CpG: 26,chr7,19272239,19272559,320,26,197,16.2,61.6,0.86
CpG: 94,chr7,19279164,19280030,866,94,602,21.7,69.5,0.9
CpG: 57,chr7,19282476,19283124,648,57,435,17.6,67.1,0.78
CpG: 16,chr7,19286809,19287011,202,16,140,15.8,69.3,0.66
CpG: 17,chr7,19293108,19293324,216,17,143,15.7,66.2,0.73
CpG: 35,chr7,19304861,19305262,401,35,260,17.5,64.8,0.85
CpG: 142,chr7,19308620,19310450,1830,142,1074,15.5,58.7,0.9
CpG: 42,chr7,19319896,19320242,346,42,237,24.3,68.5,1.05
CpG: 48,chr7,19332798,19333183,385,48,271,24.9,70.4,1.02
CpG: 35,chr7,19342089,19342393,304,35,222,23,73,0.87
CpG: 32,chr7,19345032,19345508,476,32,291,13.4,61.1,0.77
CpG: 23,chr7,19360125,19360349,224,23,157,20.5,70.1,0.85
CpG: 27,chr7,19361074,19361367,293,27,201,18.4,68.6,0.83
CpG: 39,chr7,19369864,19370296,432,39,304,18.1,70.4,0.74
CpG: 67,chr7,19381812,19382388,576,67,390,23.3,67.7,1.02
CpG: 20,chr7,19394038,19394312,274,20,172,14.6,62.8,0.75
CpG: 68,chr7,19403646,19404283,637,68,467,21.4,73.3,0.83
CpG: 30,chr7,19421190,19421537,347,30,225,17.3,64.8,0.83
CpG: 27,chr7,19426082,19426334,252,27,189,21.4,75,0.78
CpG: 21,chr7,19429373,19429601,228,21,170,18.4,74.6,0.67
CpG: 49,chr7,19458055,19458728,673,49,456,14.6,67.8,0.67
CpG: 40,chr7,19469550,19470092,542,40,355,14.8,65.5,0.69
CpG: 76,chr7,19473956,19474548,592,76,375,25.7,63.3,1.3
CpG: 23,chr7,19491796,19492078,282,23,191,16.3,67.7,0.71
CpG: 76,chr7,19507028,19507676,648,76,466,23.5,71.9,0.91
CpG: 58,chr7,19508244,19508962,718,58,427,16.2,59.5,0.94
CpG: 25,chr7,19520007,19520251,244,25,181,20.5,74.2,0.79
CpG: 163,chr7,19522931,19524694,1763,163,1142,18.5,64.8,0.88
CpG: 24,chr7,19532718,19532966,248,24,181,19.4,73,0.73
CpG: 99,chr7,19561728,19562689,961,99,598,20.6,62.2,1.08
CpG: 33,chr7,19573043,19573522,479,33,283,13.8,59.1,0.84
CpG: 48,chr7,19577199,19577670,471,48,307,20.4,65.2,0.96
CpG: 45,chr7,19586349,19586906,557,45,281,16.2,50.4,1.3
CpG: 49,chr7,19604149,19604578,429,49,303,22.8,70.6,0.94
CpG: 34,chr7,19619508,19619849,341,34,233,19.9,68.3,0.86
CpG: 73,chr7,19628916,19629664,748,73,478,19.5,63.9,0.97
CpG: 40,chr7,19696587,19696990,403,40,274,19.9,68,0.87
CpG: 95,chr7,19714911,19715998,1087,95,702,17.5,64.6,0.84
CpG: 61,chr7,19749024,19749788,764,61,503,16,65.8,0.74
CpG: 28,chr7,19796556,19796825,269,28,198,20.8,73.6,0.77
CpG: 24,chr7,19809463,19809725,262,24,170,18.3,64.9,0.87
CpG: 43,chr7,19822491,19822762,271,43,218,31.7,80.4,1
CpG: 25,chr7,19852141,19852415,274,25,196,18.2,71.5,0.72
CpG: 23,chr7,19857825,19858108,283,23,186,16.3,65.7,0.75
CpG: 18,chr7,19920998,19921235,237,18,148,15.2,62.4,0.78
CpG: 24,chr7,24082063,24082312,249,24,159,19.3,63.9,0.97
CpG: 20,chr7,24134117,24134366,249,20,157,16.1,63.1,0.81
CpG: 26,chr7,24299129,24299432,303,26,184,17.2,60.7,0.93
CpG: 23,chr7,24316629,24316857,228,23,133,20.2,58.3,1.2
CpG: 49,chr7,24333322,24333977,655,49,412,15,62.9,0.76
CpG: 38,chr7,24377299,24377638,339,38,244,22.4,72,0.87
CpG: 65,chr7,24399357,24400057,700,65,451,18.6,64.4,0.9
CpG: 84,chr7,24432197,24433295,1098,84,709,15.3,64.6,0.74
CpG: 98,chr7,24481424,24482473,1049,98,665,18.7,63.4,0.95
CpG: 75,chr7,24507003,24507796,793,75,494,18.9,62.3,0.98
CpG: 34,chr7,24531432,24531907,475,34,312,14.3,65.7,0.67
CpG: 97,chr7,24533292,24534410,1118,97,774,17.4,69.2,0.73
CpG: 43,chr7,24547005,24547384,379,43,263,22.7,69.4,0.95
CpG: 47,chr7,24585620,24586052,432,47,304,21.8,70.4,1.01
CpG: 19,chr7,24587458,24587679,221,19,151,17.2,68.3,0.74
CpG: 30,chr7,24593809,24594057,248,30,182,24.2,73.4,0.91
CpG: 27,chr7,24611072,24611408,336,27,208,16.1,61.9,0.86
CpG: 20,chr7,24628856,24629093,237,20,156,16.9,65.8,0.81
CpG: 43,chr7,24869698,24870221,523,43,331,16.4,63.3,0.83
CpG: 80,chr7,24884226,24884974,748,80,502,21.4,67.1,0.95
CpG: 24,chr7,24904250,24904454,204,24,145,23.5,71.1,1.01
CpG: 38,chr7,24944193,24944551,358,38,254,21.2,70.9,0.87
CpG: 24,chr7,24948873,24949091,218,24,143,22,65.6,1.15
CpG: 65,chr7,24954697,24955464,767,65,493,16.9,64.3,0.85
CpG: 26,chr7,24972040,24972287,247,26,164,21.1,66.4,0.96
CpG: 54,chr7,25005415,25006016,601,54,409,18,68.1,0.78
CpG: 87,chr7,25010102,25010845,743,87,516,23.4,69.4,0.97
CpG: 17,chr7,25015308,25015526,218,17,132,15.6,60.6,0.86
CpG: 24,chr7,25072784,25073007,223,24,172,21.5,77.1,0.73
CpG: 82,chr7,25076824,25077734,910,82,594,18,65.3,0.87
CpG: 57,chr7,25081180,25082025,845,57,552,13.5,65.3,0.64
CpG: 25,chr7,25133229,25133457,228,25,163,21.9,71.5,0.86
CpG: 18,chr7,25178797,25179014,217,18,127,16.6,58.5,0.99
CpG: 57,chr7,25179352,25179985,633,57,363,18,57.3,1.11
CpG: 83,chr7,25218805,25220044,1239,83,738,13.4,59.6,0.78
CpG: 22,chr7,25221167,25221383,216,22,139,20.4,64.4,0.99
CpG: 28,chr7,25225712,25226098,386,28,247,14.5,64,0.72
CpG: 45,chr7,25237591,25237946,355,45,269,25.4,75.8,0.89
CpG: 150,chr7,25248940,25250918,1978,150,1232,15.2,62.3,0.78
CpG: 29,chr7,25268212,25268554,342,29,216,17,63.2,0.89
CpG: 78,chr7,25278366,25279271,905,78,565,17.2,62.4,0.89
CpG: 21,chr7,25281793,25282063,270,21,162,15.6,60,0.91
CpG: 73,chr7,25282254,25282974,720,73,441,20.3,61.2,1.1
CpG: 44,chr7,25297356,25297775,419,44,292,21,69.7,0.88
CpG: 33,chr7,25306028,25306324,296,33,186,22.3,62.8,1.13
CpG: 119,chr7,25314707,25316012,1305,119,923,18.2,70.7,0.77
CpG: 34,chr7,25316642,25317104,462,34,298,14.7,64.5,0.71
CpG: 19,chr7,25367958,25368185,227,19,156,16.7,68.7,0.72
CpG: 30,chr7,25379845,25380142,297,30,202,20.2,68,0.87
CpG: 59,chr7,25395275,25396146,871,59,516,13.5,59.2,0.78
CpG: 26,chr7,25422817,25423041,224,26,164,23.2,73.2,0.87
CpG: 44,chr7,25619128,25619635,507,44,286,17.4,56.4,1.1
CpG: 24,chr7,25627348,25627687,339,24,215,14.2,63.4,0.75
CpG: 37,chr7,25659100,25659481,381,37,229,19.4,60.1,1.08
CpG: 42,chr7,25680648,25681139,491,42,309,17.1,62.9,0.86
CpG: 114,chr7,25686753,25688290,1537,114,991,14.8,64.5,0.72
CpG: 34,chr7,25689173,25689551,378,34,257,18,68,0.78
CpG: 23,chr7,25718816,25719131,315,23,190,14.6,60.3,0.84
CpG: 101,chr7,25754265,25755333,1068,101,676,18.9,63.3,0.95
CpG: 30,chr7,25816275,25816698,423,30,258,14.2,61,0.76
CpG: 71,chr7,27166120,27166952,832,71,481,17.1,57.8,1.02
CpG: 46,chr7,27178621,27179159,538,46,355,17.1,66,0.79
CpG: 47,chr7,27195712,27196187,475,47,299,19.8,62.9,1.02
CpG: 61,chr7,27228169,27228785,616,61,427,19.8,69.3,0.83
CpG: 35,chr7,27258576,27258962,386,35,234,18.1,60.6,1
CpG: 22,chr7,27326503,27326773,270,22,173,16.3,64.1,0.79
CpG: 34,chr7,27329388,27329692,304,34,202,22.4,66.4,1.02
CpG: 26,chr7,27330962,27331261,299,26,206,17.4,68.9,0.74
CpG: 32,chr7,27333345,27333619,274,32,179,23.4,65.3,1.1
CpG: 32,chr7,27334459,27334912,453,32,304,14.1,67.1,0.63
CpG: 22,chr7,27337545,27337815,270,22,186,16.3,68.9,0.69
CpG: 29,chr7,27355815,27356144,329,29,212,17.6,64.4,0.88
CpG: 45,chr7,27361551,27361858,307,45,234,29.3,76.2,1.02
CpG: 53,chr7,27364107,27364543,436,53,301,24.3,69,1.04
CpG: 26,chr7,27367618,27367881,263,26,182,19.8,69.2,0.83
CpG: 38,chr7,27372018,27372392,374,38,259,20.3,69.3,0.88
CpG: 22,chr7,27375325,27375567,242,22,168,18.2,69.4,0.83
CpG: 28,chr7,27396380,27396604,224,28,155,25,69.2,1.08
CpG: 89,chr7,27404174,27404994,820,89,569,21.7,69.4,0.92
CpG: 105,chr7,27408229,27409141,912,105,623,23,68.3,1.02
CpG: 38,chr7,27446440,27446740,300,38,163,25.3,54.3,1.75
CpG: 39,chr7,27447845,27448288,443,39,289,17.6,65.2,0.83
CpG: 27,chr7,27470398,27470618,220,27,155,24.5,70.5,1
CpG: 30,chr7,27473570,27473959,389,30,263,15.4,67.6,0.68
CpG: 75,chr7,27486827,27487578,751,75,525,20,69.9,0.84
CpG: 42,chr7,27507785,27508283,498,42,322,16.9,64.7,0.85
CpG: 20,chr7,27517121,27517401,280,20,164,14.3,58.6,0.83
CpG: 32,chr7,27552975,27553337,362,32,241,17.7,66.6,0.81
CpG: 45,chr7,27591715,27592161,446,45,301,20.2,67.5,0.9
CpG: 58,chr7,27653825,27654388,563,58,407,20.6,72.3,0.79
CpG: 56,chr7,27657903,27658450,547,56,379,20.5,69.3,0.86
CpG: 99,chr7,27673584,27674640,1056,99,719,18.8,68.1,0.81
CpG: 29,chr7,27731313,27731629,316,29,186,18.4,58.9,1.11
CpG: 18,chr7,27838473,27838680,207,18,130,17.4,62.8,0.88
CpG: 27,chr7,27929216,27929571,355,27,209,15.2,58.9,0.88
CpG: 35,chr7,28050029,28050340,311,35,199,22.5,64,1.1
CpG: 61,chr7,28169586,28170217,631,61,389,19.3,61.6,1.02
CpG: 85,chr7,28179400,28180425,1025,85,670,16.6,65.4,0.78
CpG: 90,chr7,28267751,28268511,760,90,507,23.7,66.7,1.06
CpG: 66,chr7,28277618,28278231,613,66,428,21.5,69.8,0.89
CpG: 31,chr7,28290928,28291283,355,31,227,17.5,63.9,0.87
CpG: 71,chr7,28294393,28294952,559,71,375,25.4,67.1,1.13
CpG: 38,chr7,28298852,28299140,288,38,209,26.4,72.6,1
CpG: 21,chr7,28301283,28301506,223,21,157,18.8,70.4,0.77
CpG: 53,chr7,28311795,28312278,483,53,326,21.9,67.5,0.97
CpG: 79,chr7,28338149,28339030,881,79,579,17.9,65.7,0.87
CpG: 57,chr7,28350533,28351146,613,57,410,18.6,66.9,0.83
CpG: 112,chr7,28371553,28372996,1443,112,944,15.5,65.4,0.73
CpG: 17,chr7,28378371,28378617,246,17,148,13.8,60.2,0.77
CpG: 36,chr7,28378932,28379348,416,36,267,17.3,64.2,0.85
CpG: 79,chr7,28392347,28393420,1073,79,673,14.7,62.7,0.76
CpG: 16,chr7,28435791,28435993,202,16,142,15.8,70.3,0.66
CpG: 53,chr7,28436309,28436882,573,53,386,18.5,67.4,0.82
CpG: 33,chr7,28452175,28452484,309,33,206,21.4,66.7,1.03
CpG: 62,chr7,28458765,28459719,954,62,596,13,62.5,0.67
CpG: 109,chr7,28466632,28467711,1079,109,747,20.2,69.2,0.84
CpG: 52,chr7,28597812,28598435,623,52,383,16.7,61.5,0.91
CpG: 39,chr7,28630355,28630817,462,39,328,16.9,71,0.67
CpG: 33,chr7,28693280,28693621,341,33,247,19.4,72.4,0.74
CpG: 38,chr7,28716545,28717082,537,38,338,14.2,62.9,0.72
CpG: 38,chr7,28732481,28732908,427,38,259,17.8,60.7,0.97
CpG: 28,chr7,28742022,28742297,275,28,180,20.4,65.5,0.95
CpG: 50,chr7,28766281,28766968,687,50,431,14.6,62.7,0.74
CpG: 32,chr7,28796635,28796937,302,32,205,21.2,67.9,0.92
CpG: 47,chr7,28808822,28809218,396,47,290,23.7,73.2,0.89
CpG: 39,chr7,28811257,28811607,350,39,218,22.3,62.3,1.19
CpG: 24,chr7,28825224,28825477,253,24,147,19,58.1,1.13
CpG: 73,chr7,28961910,28962478,568,73,416,25.7,73.2,1
CpG: 14,chr7,28981622,28981831,209,14,122,13.4,58.4,0.79
CpG: 67,chr7,29019498,29020251,753,67,443,17.8,58.8,1.09
CpG: 18,chr7,29024054,29024255,201,18,122,17.9,60.7,0.97
CpG: 19,chr7,29064427,29064665,238,19,147,16,61.8,0.84
CpG: 32,chr7,29071609,29071960,351,32,229,18.2,65.2,0.86
CpG: 43,chr7,29085738,29086296,558,43,363,15.4,65.1,0.74
CpG: 86,chr7,29155551,29156326,775,86,546,22.2,70.5,0.94
CpG: 27,chr7,29161529,29161873,344,27,234,15.7,68,0.68
CpG: 57,chr7,29171122,29171848,726,57,489,15.7,67.4,0.71
CpG: 24,chr7,29172779,29173090,311,24,193,15.4,62.1,0.8
CpG: 49,chr7,29180262,29180697,435,49,283,22.5,65.1,1.07
CpG: 67,chr7,29232164,29232722,558,67,400,24,71.7,0.93
CpG: 51,chr7,29238081,29238610,529,51,340,19.3,64.3,0.94
CpG: 23,chr7,29247239,29247570,331,23,218,13.9,65.9,0.65
CpG: 90,chr7,29281337,29282228,891,90,623,20.2,69.9,0.83
CpG: 45,chr7,29289213,29289701,488,45,291,18.4,59.6,1.07
CpG: 101,chr7,29303883,29305174,1291,101,868,15.6,67.2,0.7
CpG: 39,chr7,29307883,29308280,397,39,285,19.6,71.8,0.79
CpG: 30,chr7,29309299,29309612,313,30,220,19.2,70.3,0.78
CpG: 20,chr7,29332166,29332375,209,20,136,19.1,65.1,0.91
CpG: 121,chr7,29518284,29519470,1186,121,810,20.4,68.3,0.88
CpG: 35,chr7,29784147,29784545,398,35,271,17.6,68.1,0.76
CpG: 38,chr7,29792836,29793351,515,38,317,14.8,61.6,0.78
CpG: 18,chr7,29859939,29860162,223,18,138,16.1,61.9,0.88
CpG: 41,chr7,29953578,29954028,450,41,299,18.2,66.4,0.83
CpG: 38,chr7,29965121,29965613,492,38,299,15.4,60.8,0.87
CpG: 55,chr7,29983728,29984208,480,55,338,22.9,70.4,0.93
CpG: 34,chr7,30051014,30051460,446,34,284,15.2,63.7,0.76
CpG: 36,chr7,30072549,30072938,389,36,271,18.5,69.7,0.79
CpG: 25,chr7,30090351,30090665,314,25,196,15.9,62.4,0.83
CpG: 57,chr7,30121673,30122264,591,57,390,19.3,66,0.9
CpG: 25,chr7,30143665,30143960,295,25,196,16.9,66.4,0.81
CpG: 89,chr7,30231547,30232612,1065,89,648,16.7,60.8,0.91
CpG: 20,chr7,30232740,30232990,250,20,151,16,60.4,0.88
CpG: 18,chr7,30233444,30233688,244,18,153,14.8,62.7,0.76
CpG: 45,chr7,30280015,30280456,441,45,293,20.4,66.4,0.93
CpG: 21,chr7,30313933,30314159,226,21,155,18.6,68.6,0.81
CpG: 50,chr7,30321976,30322459,483,50,296,20.7,61.3,1.11
CpG: 30,chr7,30347948,30348241,293,30,194,20.5,66.2,0.94
CpG: 34,chr7,30355730,30356092,362,34,233,18.8,64.4,0.91
CpG: 34,chr7,30360397,30360802,405,34,259,16.8,64,0.84
CpG: 40,chr7,30362740,30363162,422,40,273,19,64.7,0.92
CpG: 71,chr7,30421632,30422426,794,71,509,17.9,64.1,0.89
CpG: 16,chr7,30444608,30444814,206,16,139,15.5,67.5,0.68
CpG: 27,chr7,30453876,30454191,315,27,203,17.1,64.4,0.91
CpG: 18,chr7,30456998,30457201,203,18,129,17.7,63.5,0.88
CpG: 18,chr7,30465469,30465679,210,18,140,17.1,66.7,0.78
CpG: 51,chr7,30534887,30535458,571,51,380,17.9,66.5,0.83
CpG: 20,chr7,30552222,30552448,226,20,131,17.7,58,1.05
CpG: 21,chr7,30553245,30553517,272,21,177,15.4,65.1,0.73
CpG: 29,chr7,30563166,30563502,336,29,198,17.3,58.9,1
CpG: 21,chr7,30586767,30587027,260,21,180,16.2,69.2,0.69
CpG: 22,chr7,30588280,30588541,261,22,152,16.9,58.2,1.05
CpG: 72,chr7,30588725,30589572,847,72,545,17,64.3,0.83
CpG: 25,chr7,30625946,30626244,298,25,185,16.8,62.1,0.87
CpG: 43,chr7,30649967,30650420,453,43,292,19,64.5,0.91
CpG: 23,chr7,30664833,30665100,267,23,168,17.2,62.9,0.88
CpG: 25,chr7,30717057,30717302,245,25,151,20.4,61.6,1.08
CpG: 74,chr7,30729233,30730030,797,74,480,18.6,60.2,1.02
CpG: 144,chr7,30955785,30957683,1898,144,1004,15.2,52.9,1.08
CpG: 41,chr7,30973109,30973518,409,41,284,20,69.4,0.83
CpG: 19,chr7,31052107,31052335,228,19,134,16.7,58.8,0.97
CpG: 20,chr7,31067432,31067677,245,20,169,16.3,69,0.69
CpG: 16,chr7,31125082,31125292,210,16,129,15.2,61.4,0.81
CpG: 78,chr7,31126519,31127179,660,78,418,23.6,63.3,1.18
CpG: 51,chr7,31150466,31151051,585,51,413,17.4,70.6,0.71
CpG: 21,chr7,31208293,31208565,272,21,165,15.4,60.7,0.84
CpG: 138,chr7,34132382,34133469,1087,138,680,25.4,62.6,1.3
CpG: 66,chr7,34168005,34168648,643,66,441,20.5,68.6,0.87
CpG: 53,chr7,34196250,34196735,485,53,337,21.9,69.5,0.91
CpG: 41,chr7,34230065,34230396,331,41,228,24.8,68.9,1.05
CpG: 36,chr7,34234010,34234409,399,36,258,18,64.7,0.92
CpG: 92,chr7,34312988,34313712,724,92,505,25.4,69.8,1.06
CpG: 122,chr7,34388766,34389984,1218,122,728,20,59.8,1.12
CpG: 214,chr7,34652853,34655922,3069,214,1642,13.9,53.5,0.97
CpG: 66,chr7,34675220,34676208,988,66,593,13.4,60,0.75
CpG: 112,chr7,34811707,34812989,1282,112,812,17.5,63.3,0.87
CpG: 25,chr7,34912334,34912634,300,25,199,16.7,66.3,0.76
CpG: 88,chr7,35056009,35056743,734,88,466,24,63.5,1.19
CpG: 257,chr7,35117899,35120740,2841,257,1827,18.1,64.3,0.88
CpG: 29,chr7,35185306,35185532,226,29,162,25.7,71.7,1.03
CpG: 36,chr7,35186360,35186671,311,36,220,23.2,70.7,0.93
CpG: 36,chr7,35203778,35204197,419,36,277,17.2,66.1,0.79
CpG: 58,chr7,35215097,35215557,460,58,291,25.2,63.3,1.26
CpG: 28,chr7,35318164,35318446,282,28,191,19.9,67.7,0.93
CpG: 66,chr7,35334211,35335129,918,66,590,14.4,64.3,0.71
CpG: 26,chr7,35537403,35537789,386,26,242,13.5,62.7,0.7
CpG: 106,chr7,35555033,35555971,938,106,648,22.6,69.1,0.95
CpG: 107,chr7,35584485,35585570,1085,107,712,19.7,65.6,0.92
CpG: 39,chr7,35586064,35586613,549,39,353,14.2,64.3,0.69
CpG: 84,chr7,35646841,35647659,818,84,542,20.5,66.3,0.94
CpG: 51,chr7,35754059,35754561,502,51,335,20.3,66.7,0.92
CpG: 57,chr7,35802576,35803049,473,57,346,24.1,73.2,0.9
CpG: 276,chr7,36695312,36698700,3388,276,2118,16.3,62.5,0.83
CpG: 18,chr7,36769133,36769366,233,18,138,15.5,59.2,0.9
CpG: 22,chr7,37336952,37337187,235,22,147,18.7,62.6,0.98
CpG: 18,chr7,37567855,37568089,234,18,151,15.4,64.5,0.75
CpG: 18,chr7,37569388,37569617,229,18,139,15.7,60.7,0.86
CpG: 198,chr7,37769500,37772351,2851,198,1636,13.9,57.4,0.86
CpG: 21,chr7,37772703,37772938,235,21,139,17.9,59.1,1.02
CpG: 20,chr7,37773504,37773708,204,20,114,19.6,55.9,1.26
CpG: 85,chr7,38018894,38019712,818,85,519,20.8,63.4,1.03
CpG: 47,chr7,38061200,38061648,448,47,311,21,69.4,0.88
CpG: 48,chr7,38084896,38085332,436,48,278,22,63.8,1.08
CpG: 111,chr7,38106954,38108064,1110,111,669,20,60.3,1.11
CpG: 20,chr7,38174291,38174496,205,20,130,19.5,63.4,0.97
CpG: 36,chr7,38183665,38184097,432,36,291,16.7,67.4,0.74
CpG: 25,chr7,38221505,38221808,303,25,196,16.5,64.7,0.8
CpG: 35,chr7,38227902,38228247,345,35,227,20.3,65.8,0.94
CpG: 25,chr7,38271114,38271414,300,25,169,16.7,56.3,1.09
CpG: 38,chr7,39517716,39518080,364,38,252,20.9,69.2,0.88
CpG: 29,chr7,39544411,39544702,291,29,190,19.9,65.3,0.94
CpG: 41,chr7,39552470,39552852,382,41,271,21.5,70.9,0.88
CpG: 35,chr7,39588632,39588865,233,35,188,30,80.7,0.93
CpG: 103,chr7,40898778,40900225,1447,103,875,14.2,60.5,0.78
CpG: 26,chr7,40902431,40902701,270,26,166,19.3,61.5,1.02
CpG: 23,chr7,41599179,41599445,266,23,166,17.3,62.4,0.91
CpG: 34,chr7,42505336,42505830,494,34,286,13.8,57.9,0.85
CpG: 47,chr7,43312665,43313231,566,47,365,16.6,64.5,0.86
CpG: 23,chr7,43443954,43444196,242,23,152,19,62.8,0.97
CpG: 51,chr7,43464863,43465479,616,51,398,16.6,64.6,0.8
CpG: 22,chr7,43466415,43466619,204,22,146,21.6,71.6,0.87
CpG: 19,chr7,43562155,43562388,233,19,134,16.3,57.5,1.01
CpG: 15,chr7,43579517,43579735,218,15,126,13.8,57.8,0.84
CpG: 48,chr7,43675143,43675617,474,48,334,20.3,70.5,0.82
CpG: 21,chr7,43676591,43676883,292,21,201,14.4,68.8,0.62
CpG: 23,chr7,43797362,43797629,267,23,175,17.2,65.5,0.82
CpG: 69,chr7,44246334,44247152,818,69,513,16.9,62.7,0.86
CpG: 47,chr7,44304487,44304941,454,47,296,20.7,65.2,0.97
CpG: 19,chr7,44312686,44312908,222,19,154,17.1,69.4,0.71
CpG: 33,chr7,44335953,44336248,295,33,196,22.4,66.4,1.01
CpG: 143,chr7,44351977,44353713,1736,143,1175,16.5,67.7,0.73
CpG: 23,chr7,44356821,44357125,304,23,210,15.1,69.1,0.67
CpG: 43,chr7,44360091,44360509,418,43,283,20.6,67.7,0.9
CpG: 60,chr7,44428835,44429435,600,60,330,20,55,1.35
CpG: 125,chr7,44461514,44462971,1457,125,912,17.2,62.6,0.88
CpG: 29,chr7,44467988,44468221,233,29,159,24.9,68.2,1.08
CpG: 78,chr7,44496214,44497069,855,78,570,18.2,66.7,0.82
CpG: 21,chr7,44527968,44528207,239,21,151,17.6,63.2,0.88
CpG: 43,chr7,44548499,44549017,518,43,342,16.6,66,0.82
CpG: 33,chr7,44551986,44552399,413,33,267,16,64.6,0.77
CpG: 50,chr7,44553519,44554044,525,50,349,19,66.5,0.86
CpG: 26,chr7,44589175,44589379,204,26,149,25.5,73,0.97
CpG: 87,chr7,44591028,44591808,780,87,492,22.3,63.1,1.12
CpG: 17,chr7,44669185,44669406,221,17,153,15.4,69.2,0.64
CpG: 21,chr7,44670766,44671053,287,21,193,14.6,67.2,0.65
CpG: 26,chr7,44748553,44748818,265,26,177,19.6,66.8,0.88
CpG: 51,chr7,44815899,44816421,522,51,345,19.5,66.1,0.89
CpG: 19,chr7,44816762,44816980,218,19,122,17.4,56,1.13
CpG: 69,chr7,44839557,44840309,752,69,492,18.4,65.4,0.86
CpG: 18,chr7,44848448,44848674,226,18,143,15.9,63.3,0.8
CpG: 105,chr7,44849035,44850481,1446,105,865,14.5,59.8,0.84
CpG: 23,chr7,44852574,44852781,207,23,150,22.2,72.5,0.85
CpG: 39,chr7,44854495,44854973,478,39,303,16.3,63.4,0.81
CpG: 24,chr7,44857234,44857563,329,24,211,14.6,64.1,0.71
CpG: 23,chr7,44863502,44863797,295,23,187,15.6,63.4,0.78
CpG: 110,chr7,44868903,44869790,887,110,625,24.8,70.5,1.01
CpG: 55,chr7,44892064,44892748,684,55,370,16.1,54.1,1.1
CpG: 20,chr7,44896133,44896384,251,20,166,15.9,66.1,0.73
CpG: 89,chr7,44929169,44930104,935,89,615,19,65.8,0.88
CpG: 29,chr7,44970450,44970699,249,29,169,23.3,67.9,1.01
CpG: 71,chr7,44985960,44986797,837,71,530,17,63.3,0.89
CpG: 40,chr7,44997468,44997991,523,40,294,15.3,56.2,0.97
CpG: 111,chr7,45007190,45008524,1334,111,876,16.6,65.7,0.77
CpG: 74,chr7,45015768,45016463,695,74,445,21.3,64,1.04
CpG: 114,chr7,45052638,45054164,1526,114,913,14.9,59.8,0.84
CpG: 22,chr7,45062308,45062561,253,22,141,17.4,55.7,1.15
CpG: 26,chr7,45076554,45076788,234,26,152,22.2,65,1.06
CpG: 81,chr7,45123911,45124804,893,81,539,18.1,60.4,1
CpG: 72,chr7,45128517,45129390,873,72,547,16.5,62.7,0.84
CpG: 66,chr7,45154049,45154660,611,66,404,21.6,66.1,0.99
CpG: 27,chr7,45162200,45162489,289,27,198,18.7,68.5,0.83
CpG: 22,chr7,45174751,45175049,298,22,196,14.8,65.8,0.69
CpG: 48,chr7,45176123,45176699,576,48,395,16.7,68.6,0.72
CpG: 76,chr7,45181527,45182563,1036,76,573,14.7,55.3,0.96
CpG: 31,chr7,45204423,45204759,336,31,206,18.5,61.3,0.99
CpG: 37,chr7,45215793,45216153,360,37,249,20.6,69.2,0.9
CpG: 26,chr7,45234296,45234627,331,26,216,15.7,65.3,0.74
CpG: 48,chr7,45240663,45241222,559,48,372,17.2,66.5,0.78
CpG: 37,chr7,45277374,45277610,236,37,174,31.4,73.7,1.15
CpG: 17,chr7,45327232,45327446,214,17,146,15.9,68.2,0.69
CpG: 41,chr7,45333339,45333852,513,41,341,16,66.5,0.74
CpG: 25,chr7,45339482,45339796,314,25,217,15.9,69.1,0.68
CpG: 22,chr7,45346692,45346971,279,22,182,15.8,65.2,0.76
CpG: 18,chr7,45357719,45357941,222,18,152,16.2,68.5,0.71
CpG: 40,chr7,45361497,45361830,333,40,236,24,70.9,0.98
CpG: 95,chr7,45366577,45367777,1200,95,773,15.8,64.4,0.76
CpG: 61,chr7,45369933,45370619,686,61,464,17.8,67.6,0.79
CpG: 51,chr7,45376718,45377276,558,51,340,18.3,60.9,1.05
CpG: 64,chr7,45395402,45396014,612,64,383,20.9,62.6,1.1
CpG: 112,chr7,45406251,45407025,774,112,557,28.9,72,1.12
CpG: 41,chr7,45413570,45413889,319,41,247,25.7,77.4,0.86
CpG: 40,chr7,45415670,45416068,398,40,271,20.1,68.1,0.9
CpG: 36,chr7,45434740,45435258,518,36,321,13.9,62,0.72
CpG: 37,chr7,45459575,45460121,546,37,333,13.6,61,0.75
CpG: 53,chr7,45466567,45466979,412,53,296,25.7,71.8,1
CpG: 26,chr7,45488581,45488888,307,26,198,16.9,64.5,0.83
CpG: 37,chr7,45510017,45510573,556,37,329,13.3,59.2,0.81
CpG: 49,chr7,45525994,45526473,479,49,293,20.5,61.2,1.1
CpG: 18,chr7,45538243,45538484,241,18,156,14.9,64.7,0.76
CpG: 41,chr7,45570156,45570647,491,41,340,16.7,69.2,0.71
CpG: 94,chr7,45628418,45629081,663,94,480,28.4,72.4,1.11
CpG: 50,chr7,45632259,45632776,517,50,363,19.3,70.2,0.78
CpG: 18,chr7,45638708,45638953,245,18,151,14.7,61.6,0.79
CpG: 16,chr7,45679084,45679307,223,16,130,14.3,58.3,0.85
CpG: 41,chr7,45694002,45694347,345,41,247,23.8,71.6,0.93
CpG: 35,chr7,45699965,45700335,370,35,261,18.9,70.5,0.81
CpG: 26,chr7,45704790,45705154,364,26,220,14.3,60.4,0.78
CpG: 19,chr7,45705454,45705704,250,19,165,15.2,66,0.7
CpG: 49,chr7,45706651,45707060,409,49,293,24,71.6,0.93
CpG: 21,chr7,45713359,45713615,256,21,166,16.4,64.8,0.8
CpG: 35,chr7,45714976,45715370,394,35,269,17.8,68.3,0.77
CpG: 60,chr7,45717703,45718318,615,60,399,19.5,64.9,0.93
CpG: 31,chr7,45785616,45785898,282,31,209,22,74.1,0.8
CpG: 21,chr7,45795012,45795317,305,21,203,13.8,66.6,0.63
CpG: 53,chr7,45813835,45814302,467,53,281,22.7,60.2,1.26
CpG: 54,chr7,45819387,45820058,671,54,429,16.1,63.9,0.79
CpG: 21,chr7,45830601,45830827,226,21,144,18.6,63.7,0.93
CpG: 172,chr7,45832442,45834067,1625,172,1060,21.2,65.2,1.01
CpG: 76,chr7,45865970,45866506,536,76,362,28.4,67.5,1.25
CpG: 19,chr7,45924303,45924568,265,19,167,14.3,63,0.74
CpG: 65,chr7,46033596,46034094,498,65,361,26.1,72.5,1.02
CpG: 21,chr7,46100675,46100883,208,21,151,20.2,72.6,0.77
CpG: 69,chr7,46179458,46180227,769,69,496,17.9,64.5,0.87
CpG: 34,chr7,46348865,46349152,287,34,216,23.7,75.3,0.85
CpG: 57,chr7,46376685,46377277,592,57,392,19.3,66.2,0.89
CpG: 206,chr7,46396209,46398311,2102,206,1392,19.6,66.2,0.9
CpG: 32,chr7,46427410,46427805,395,32,233,16.2,59,0.95
CpG: 32,chr7,46639608,46639878,270,32,205,23.7,75.9,0.82
CpG: 43,chr7,46710320,46710753,433,43,282,19.9,65.1,0.94
CpG: 89,chr7,46795609,46796393,784,89,549,22.7,70,0.93
CpG: 69,chr7,46845651,46846371,720,69,481,19.2,66.8,0.86
CpG: 74,chr7,46919587,46920266,679,74,448,21.8,66,1
CpG: 41,chr7,46958336,46958769,433,41,283,18.9,65.4,0.9
CpG: 80,chr7,47007761,47008791,1030,80,594,15.5,57.7,0.93
CpG: 63,chr7,47050436,47051022,586,63,406,21.5,69.3,0.9
CpG: 69,chr7,47132145,47132871,726,69,505,19,69.6,0.79
CpG: 53,chr7,48788875,48789335,460,53,325,23,70.7,0.98
CpG: 103,chr7,48880673,48881767,1094,103,688,18.8,62.9,0.96
CpG: 123,chr7,49245770,49247032,1262,123,809,19.5,64.1,0.95
CpG: 25,chr7,49635468,49635739,271,25,159,18.5,58.7,1.15
CpG: 40,chr7,49636312,49636892,580,40,370,13.8,63.8,0.7
CpG: 33,chr7,49758988,49759252,264,33,204,25,77.3,0.84
CpG: 84,chr7,49778242,49778846,604,84,421,27.8,69.7,1.15
CpG: 42,chr7,49911830,49912323,493,42,330,17,66.9,0.76
CpG: 85,chr7,49974934,49975950,1016,85,677,16.7,66.6,0.77
CpG: 131,chr7,51861457,51862387,930,131,646,28.2,69.5,1.17
CpG: 24,chr7,52005679,52005951,272,24,194,17.6,71.3,0.7
CpG: 39,chr7,55794072,55794419,347,39,233,22.5,67.1,1
CpG: 66,chr7,55841982,55842687,705,66,499,18.7,70.8,0.75
CpG: 65,chr7,55961995,55962566,571,65,395,22.8,69.2,0.96
CpG: 46,chr7,56019264,56019679,415,46,252,22.2,60.7,1.21
CpG: 54,chr7,56049966,56050397,431,54,312,25.1,72.4,0.99
CpG: 48,chr7,57386780,57387224,444,48,322,21.6,72.5,0.83
CpG: 135,chr7,57508992,57510156,1164,135,846,23.2,72.7,0.89
CpG: 120,chr7,57590812,57592071,1259,120,832,19.1,66.1,0.87
CpG: 76,chr7,58658108,58658874,766,76,506,19.8,66.1,0.91
CpG: 101,chr7,59228599,59229618,1019,101,640,19.8,62.8,1.01
CpG: 41,chr7,62348253,62348744,491,41,321,16.7,65.4,0.79
CpG: 20,chr7,62377182,62377459,277,20,174,14.4,62.8,0.73
CpG: 28,chr7,62419676,62420009,333,28,226,16.8,67.9,0.74
CpG: 100,chr7,62463584,62464534,950,100,640,21.1,67.4,0.93
CpG: 62,chr7,63212047,63212650,603,62,399,20.6,66.2,0.95
CpG: 63,chr7,63444876,63445366,490,63,351,25.7,71.6,1.04
CpG: 151,chr7,63757481,63758660,1179,151,745,25.6,63.2,1.28
CpG: 32,chr7,63891487,63891751,264,32,184,24.2,69.7,1.02
CpG: 23,chr7,63896922,63897193,271,23,172,17,63.5,0.84
CpG: 230,chr7,63937358,63939528,2170,230,1419,21.2,65.4,0.99
CpG: 20,chr7,64268390,64268615,225,20,141,17.8,62.7,0.91
CpG: 73,chr7,64287405,64288062,657,73,438,22.2,66.7,1
CpG: 25,chr7,64373798,64374124,326,25,194,15.3,59.5,0.87
CpG: 72,chr7,64392049,64392902,853,72,522,16.9,61.2,0.92
CpG: 125,chr7,64501527,64502566,1039,125,745,24.1,71.7,0.94
CpG: 69,chr7,64872581,64873136,555,69,392,24.9,70.6,1
CpG: 103,chr7,65155629,65156410,781,103,580,26.4,74.3,0.96
CpG: 26,chr7,65156631,65156944,313,26,211,16.6,67.4,0.77
CpG: 91,chr7,65370400,65371262,862,91,538,21.1,62.4,1.11
CpG: 32,chr7,65527172,65527407,235,32,173,27.2,73.6,1.01
CpG: 61,chr7,65644735,65645333,598,61,438,20.4,73.2,0.76
CpG: 52,chr7,65693313,65693767,454,52,324,22.9,71.4,0.91
CpG: 112,chr7,65861786,65862954,1168,112,642,19.2,55,1.27
CpG: 56,chr7,66060454,66060930,476,56,329,23.5,69.1,1
CpG: 57,chr7,66079461,66080003,542,57,355,21,65.5,0.98
CpG: 119,chr7,66108997,66110338,1341,119,721,17.7,53.8,1.23
CpG: 78,chr7,66387620,66388412,792,78,536,19.7,67.7,0.86
CpG: 63,chr7,66427266,66427951,685,63,469,18.4,68.5,0.78
CpG: 47,chr7,66689722,66690292,570,47,371,16.5,65.1,0.8
CpG: 83,chr7,66839902,66840630,728,83,521,22.8,71.6,0.89
CpG: 132,chr7,67372046,67373512,1466,132,877,18,59.8,1.02
CpG: 56,chr7,67645091,67645816,725,56,422,15.4,58.2,0.92
CpG: 117,chr7,67758798,67759887,1089,117,729,21.5,66.9,0.98
CpG: 18,chr7,67803660,67803869,209,18,144,17.2,68.9,0.73
CpG: 27,chr7,67849160,67849515,355,27,223,15.2,62.8,0.84
CpG: 256,chr7,67950703,67953382,2679,256,1621,19.1,60.5,1.04
CpG: 20,chr7,68165008,68165253,245,20,153,16.3,62.4,0.84
CpG: 35,chr7,68748864,68749208,344,35,248,20.3,72.1,0.81
CpG: 81,chr7,70280417,70281696,1279,81,756,12.7,59.1,0.73
CpG: 42,chr7,70331428,70331950,522,42,333,16.1,63.8,0.8
CpG: 21,chr7,70346197,70346406,209,21,142,20.1,67.9,0.87
CpG: 37,chr7,70350841,70351187,346,37,251,21.4,72.5,0.82
CpG: 33,chr7,70357801,70358206,405,33,250,16.3,61.7,0.87
CpG: 69,chr7,70369308,70370330,1022,69,623,13.5,61,0.74
CpG: 57,chr7,71705458,71705883,425,57,310,26.8,72.9,1.01
CpG: 27,chr7,72306504,72306833,329,27,209,16.4,63.5,0.81
CpG: 92,chr7,73375247,73376344,1097,92,688,16.8,62.7,0.86
CpG: 24,chr7,73409277,73409531,254,24,176,18.9,69.3,0.81
CpG: 26,chr7,73417381,73417722,341,26,217,15.2,63.6,0.76
CpG: 31,chr7,73537745,73538003,258,31,176,24,68.2,1.08
CpG: 121,chr7,73557794,73558678,884,121,668,27.4,75.6,0.99
CpG: 89,chr7,73618005,73618870,865,89,546,20.6,63.1,1.03
CpG: 79,chr7,73740237,73741012,775,79,496,20.4,64,1
CpG: 135,chr7,74012601,74014110,1509,135,1000,17.9,66.3,0.82
CpG: 24,chr7,74504303,74504598,295,24,182,16.3,61.7,0.86
CpG: 88,chr7,74554189,74555056,867,88,546,20.3,63,1.04
CpG: 23,chr7,75308843,75309053,210,23,141,21.9,67.1,0.99
CpG: 97,chr7,75455504,75456287,783,97,557,24.8,71.1,0.98
CpG: 24,chr7,75781908,75782111,203,24,138,23.6,68,1.07
CpG: 52,chr7,75848192,75848706,514,52,314,20.2,61.1,1.09
CpG: 49,chr7,78577923,78578433,510,49,284,19.2,55.7,1.24
CpG: 24,chr7,78578654,78578953,299,24,187,16.1,62.5,0.84
CpG: 24,chr7,78782848,78783128,280,24,185,17.1,66.1,0.79
CpG: 41,chr7,78846973,78847338,365,41,266,22.5,72.9,0.85
CpG: 19,chr7,78882496,78882725,229,19,146,16.6,63.8,0.84
CpG: 47,chr7,78895717,78896221,504,47,329,18.7,65.3,0.88
CpG: 23,chr7,78990381,78990677,296,23,193,15.5,65.2,0.73
CpG: 68,chr7,79052803,79053524,721,68,514,18.9,71.3,0.77
CpG: 31,chr7,79148837,79149128,291,31,200,21.3,68.7,0.9
CpG: 33,chr7,79273165,79273469,304,33,209,21.7,68.8,0.94
CpG: 41,chr7,79392032,79392619,587,41,351,14,59.8,0.78
CpG: 152,chr7,79464667,79466385,1718,152,1098,17.7,63.9,0.87
CpG: 17,chr7,79466652,79466859,207,17,125,16.4,60.4,0.9
CpG: 22,chr7,79496057,79496270,213,22,141,20.7,66.2,0.94
CpG: 21,chr7,79499340,79499594,254,21,161,16.5,63.4,0.83
CpG: 60,chr7,79499823,79500281,458,60,350,26.2,76.4,0.9
CpG: 79,chr7,79504772,79505482,710,79,490,22.3,69,0.95
CpG: 54,chr7,79508517,79509111,594,54,347,18.2,58.4,1.07
CpG: 72,chr7,79515295,79515887,592,72,434,24.3,73.3,0.91
CpG: 77,chr7,79535321,79536333,1012,77,641,15.2,63.3,0.76
CpG: 26,chr7,79543300,79543570,270,26,163,19.3,60.4,1.06
CpG: 39,chr7,79617340,79617804,464,39,292,16.8,62.9,0.85
CpG: 84,chr7,79659935,79660894,959,84,630,17.5,65.7,0.81
CpG: 61,chr7,79710052,79710519,467,61,339,26.1,72.6,1
CpG: 45,chr7,79715429,79715900,471,45,341,19.1,72.4,0.74
CpG: 29,chr7,79721325,79721615,290,29,197,20,67.9,0.87
CpG: 42,chr7,79742694,79743167,473,42,310,17.8,65.5,0.83
CpG: 89,chr7,79792643,79793510,867,89,591,20.5,68.2,0.89
CpG: 60,chr7,79811010,79811424,414,60,300,29,72.5,1.13
CpG: 27,chr7,79920436,79920800,364,27,224,14.8,61.5,0.78
CpG: 39,chr7,80025139,80025543,404,39,282,19.3,69.8,0.79
CpG: 73,chr7,80026984,80027571,587,73,434,24.9,73.9,0.92
CpG: 18,chr7,80081785,80082018,233,18,136,15.5,58.4,0.91
CpG: 72,chr7,80114973,80115663,690,72,490,20.9,71,0.83
CpG: 37,chr7,80186700,80187059,359,37,240,20.6,66.9,0.95
CpG: 66,chr7,80198189,80198815,626,66,432,21.1,69,0.89
CpG: 65,chr7,80232411,80232922,511,65,381,25.4,74.6,0.93
CpG: 44,chr7,80246217,80246618,401,44,264,21.9,65.8,1.01
CpG: 42,chr7,80261132,80261518,386,42,256,21.8,66.3,0.99
CpG: 23,chr7,80269578,80269844,266,23,168,17.3,63.2,0.89
CpG: 61,chr7,80294256,80294862,606,61,405,20.1,66.8,0.92
CpG: 28,chr7,80324098,80324365,267,28,168,21,62.9,1.06
CpG: 43,chr7,80339931,80340448,517,43,326,16.6,63.1,0.86
CpG: 26,chr7,80343051,80343324,273,26,173,19,63.4,0.95
CpG: 18,chr7,80363079,80363296,217,18,136,16.6,62.7,0.85
CpG: 109,chr7,80370616,80371559,943,109,674,23.1,71.5,0.91
CpG: 73,chr7,80401905,80402602,697,73,444,20.9,63.7,1.03
CpG: 26,chr7,80402966,80403167,201,26,152,25.9,75.6,0.91
CpG: 25,chr7,80507773,80508028,255,25,173,19.6,67.8,0.86
CpG: 46,chr7,80534669,80535136,467,46,288,19.7,61.7,1.04
CpG: 89,chr7,80688151,80689051,900,89,512,19.8,56.9,1.23
CpG: 62,chr7,80802925,80803540,615,62,431,20.2,70.1,0.84
CpG: 29,chr7,80861061,80861321,260,29,181,22.3,69.6,0.93
CpG: 37,chr7,80875740,80876111,371,37,246,19.9,66.3,0.91
CpG: 26,chr7,80901097,80901345,248,26,168,21,67.7,0.94
CpG: 28,chr7,80904820,80905187,367,28,233,15.3,63.5,0.76
CpG: 51,chr7,80947295,80947944,649,51,414,15.7,63.8,0.77
CpG: 101,chr7,80993021,80994187,1166,101,651,17.3,55.8,1.12
CpG: 181,chr7,81213083,81214331,1248,181,871,29,69.8,1.19
CpG: 85,chr7,81344552,81345431,879,85,561,19.3,63.8,0.95
CpG: 183,chr7,81453586,81455514,1928,183,1230,19,63.8,0.93
CpG: 49,chr7,81493357,81493784,427,49,296,23,69.3,0.96
CpG: 97,chr7,81571238,81571983,745,97,531,26,71.3,1.03
CpG: 90,chr7,81706540,81707203,663,90,451,27.1,68,1.19
CpG: 97,chr7,81762460,81763531,1071,97,695,18.1,64.9,0.87
CpG: 121,chr7,81828695,81829721,1026,121,678,23.6,66.1,1.08
CpG: 56,chr7,81859127,81859639,512,56,352,21.9,68.8,0.93
CpG: 167,chr7,81933527,81934754,1227,167,879,27.2,71.6,1.07
CpG: 108,chr7,81991677,81992746,1069,108,652,20.2,61,1.09
CpG: 64,chr7,82174717,82175418,701,64,448,18.3,63.9,0.9
CpG: 125,chr7,82335315,82336476,1161,125,796,21.5,68.6,0.92
CpG: 46,chr7,82648339,82648814,475,46,316,19.4,66.5,0.88
CpG: 306,chr7,82865931,82870227,4296,306,2487,14.2,57.9,0.85
CpG: 23,chr7,83631855,83632140,285,23,182,16.1,63.9,0.82
CpG: 236,chr7,83882224,83884593,2369,236,1604,19.9,67.7,0.87
CpG: 43,chr7,83891999,83892456,457,43,296,18.8,64.8,0.91
CpG: 51,chr7,84086232,84086786,554,51,379,18.4,68.4,0.79
CpG: 113,chr7,84151109,84152324,1215,113,682,18.6,56.1,1.19
CpG: 83,chr7,84409544,84410337,793,83,526,20.9,66.3,0.95
CpG: 46,chr7,84528859,84529267,408,46,292,22.5,71.6,0.88
CpG: 38,chr7,84605728,84606302,574,38,378,13.2,65.9,0.68
CpG: 61,chr7,84689528,84689974,446,61,321,27.4,72,1.09
CpG: 38,chr7,87246447,87246851,404,38,289,18.8,71.5,0.74
CpG: 48,chr7,88130187,88130695,508,48,340,18.9,66.9,0.86
CpG: 21,chr7,88278003,88278275,272,21,177,15.4,65.1,0.76
CpG: 48,chr7,89338582,89338936,354,48,254,27.1,71.8,1.12
CpG: 32,chr7,89403437,89403742,305,32,198,21,64.9,1
CpG: 81,chr7,89404108,89404951,843,81,585,19.2,69.4,0.8
CpG: 46,chr7,89517311,89517822,511,46,308,18,60.3,1.04
CpG: 32,chr7,89632808,89633177,369,32,250,17.3,67.8,0.76
CpG: 20,chr7,89940826,89941061,235,20,159,17,67.7,0.83
CpG: 107,chr7,89980107,89981408,1301,107,771,16.4,59.3,0.96
CpG: 82,chr7,90129776,90130669,893,82,544,18.4,60.9,1
CpG: 143,chr7,90442690,90444076,1386,143,843,20.6,60.8,1.12
CpG: 38,chr7,90456992,90457441,449,38,292,16.9,65,0.81
CpG: 38,chr7,90475939,90476408,469,38,310,16.2,66.1,0.74
CpG: 18,chr7,92561071,92561297,226,18,133,15.9,58.8,0.92
CpG: 39,chr7,92561469,92561881,412,39,280,18.9,68,0.82
CpG: 73,chr7,92636528,92637265,737,73,468,19.8,63.5,0.99
CpG: 15,chr7,92669147,92669356,209,15,137,14.4,65.6,0.68
CpG: 72,chr7,92669545,92670159,614,72,419,23.5,68.2,1.01
CpG: 30,chr7,92741069,92741444,375,30,231,16,61.6,0.87
CpG: 66,chr7,92874008,92874727,719,66,450,18.4,62.6,0.94
CpG: 134,chr7,93079824,93081200,1376,134,938,19.5,68.2,0.84
CpG: 124,chr7,96209789,96211091,1302,124,874,19,67.1,0.85
CpG: 15,chr7,96211677,96211879,202,15,124,14.9,61.4,0.8
CpG: 59,chr7,96951405,96951938,533,59,359,22.1,67.4,0.98
CpG: 104,chr7,97081447,97082397,950,104,597,21.9,62.8,1.11
CpG: 93,chr7,97325217,97326011,794,93,564,23.4,71,0.93
CpG: 61,chr7,97331855,97332573,718,61,486,17,67.7,0.75
CpG: 38,chr7,97399965,97400387,422,38,262,18,62.1,0.94
CpG: 111,chr7,97579332,97580635,1303,111,848,17,65.1,0.81
CpG: 61,chr7,97696522,97697151,629,61,391,19.4,62.2,1
CpG: 56,chr7,97737845,97738409,564,56,410,19.9,72.7,0.75
CpG: 102,chr7,97788274,97789365,1091,102,649,18.7,59.5,1.06
CpG: 19,chr7,98079218,98079427,209,19,143,18.2,68.4,0.79
CpG: 24,chr7,98111294,98111558,264,24,180,18.2,68.2,0.78
CpG: 18,chr7,98145078,98145280,202,18,127,17.8,62.9,0.93
CpG: 35,chr7,98177912,98178306,394,35,274,17.8,69.5,0.74
CpG: 90,chr7,98193689,98194613,924,90,618,19.5,66.9,0.88
CpG: 70,chr7,98308966,98309678,712,70,501,19.7,70.4,0.83
CpG: 63,chr7,98360801,98361512,711,63,467,17.7,65.7,0.83
CpG: 58,chr7,98489693,98490159,466,58,338,24.9,72.5,0.95
CpG: 101,chr7,98655805,98656940,1135,101,732,17.8,64.5,0.87
CpG: 95,chr7,98702691,98703607,916,95,588,20.7,64.2,1.01
CpG: 26,chr7,98815051,98815365,314,26,209,16.6,66.6,0.76
CpG: 62,chr7,98834846,98835340,494,62,336,25.1,68,1.09
CpG: 17,chr7,98836208,98836425,217,17,132,15.7,60.8,0.85
CpG: 62,chr7,98838814,98839374,560,62,370,22.1,66.1,1.02
CpG: 70,chr7,99140597,99141259,662,70,474,21.1,71.6,0.83
CpG: 65,chr7,99182396,99183071,675,65,439,19.3,65,0.91
CpG: 38,chr7,99248980,99249269,289,38,217,26.3,75.1,0.94
CpG: 145,chr7,99267494,99269248,1754,145,1161,16.5,66.2,0.76
CpG: 26,chr7,99348877,99349156,279,26,178,18.6,63.8,0.92
CpG: 78,chr7,99381324,99382327,1003,78,636,15.6,63.4,0.78
CpG: 152,chr7,99468221,99469101,880,152,682,34.5,77.5,1.15
CpG: 59,chr7,99535417,99535885,468,59,299,25.2,63.9,1.24
CpG: 179,chr7,99625521,99627069,1548,179,1098,23.1,70.9,0.92
CpG: 23,chr7,99828122,99828450,328,23,206,14,62.8,0.71
CpG: 32,chr7,99858889,99859223,334,32,211,19.2,63.2,0.97
CpG: 30,chr7,99917342,99917630,288,30,192,20.8,66.7,0.94
CpG: 91,chr7,99979742,99980503,761,91,540,23.9,71,0.95
CpG: 34,chr7,100005814,100006147,333,34,234,20.4,70.3,0.83
CpG: 20,chr7,100042177,100042396,219,20,125,18.3,57.1,1.14
CpG: 61,chr7,100121096,100121670,574,61,397,21.3,69.2,0.9
CpG: 68,chr7,100159214,100159805,591,68,410,23,69.4,0.96
CpG: 58,chr7,100227219,100227913,694,58,410,16.7,59.1,0.96
CpG: 32,chr7,100285530,100285761,231,32,178,27.7,77.1,0.95
CpG: 32,chr7,100371717,100372059,342,32,220,18.7,64.3,0.92
CpG: 26,chr7,100493254,100493494,240,26,167,21.7,69.6,0.93
CpG: 27,chr7,100536969,100537241,272,27,177,19.9,65.1,0.94
CpG: 29,chr7,100582775,100583160,385,29,231,15.1,60,0.84
CpG: 142,chr7,100607137,100608549,1412,142,926,20.1,65.6,0.95
CpG: 54,chr7,100706513,100707058,545,54,383,19.8,70.3,0.8
CpG: 89,chr7,100862856,100863555,699,89,514,25.5,73.5,0.96
CpG: 54,chr7,100894454,100894884,430,54,318,25.1,74,0.92
CpG: 146,chr7,100930752,100932371,1619,146,1077,18,66.5,0.82
CpG: 25,chr7,100974478,100974827,349,25,226,14.3,64.8,0.68
CpG: 35,chr7,100998530,100999021,491,35,301,14.3,61.3,0.77
CpG: 52,chr7,101011711,101012291,580,52,390,17.9,67.2,0.8
CpG: 118,chr7,101108070,101109237,1167,118,776,20.2,66.5,0.92
CpG: 20,chr7,101296765,101296967,202,20,132,19.8,65.3,0.94
CpG: 43,chr7,101301738,101302154,416,43,290,20.7,69.7,0.85
CpG: 67,chr7,101321027,101321944,917,67,532,14.6,58,0.87
CpG: 31,chr7,101347966,101348189,223,31,164,27.8,73.5,1.03
CpG: 49,chr7,101450867,101451457,590,49,356,16.6,60.3,0.94
CpG: 22,chr7,101504582,101504811,229,22,148,19.2,64.6,0.92
CpG: 42,chr7,101663695,101664107,412,42,265,20.4,64.3,0.99
CpG: 66,chr7,101817991,101818721,730,66,460,18.1,63,0.91
CpG: 28,chr7,101820763,101820996,233,28,147,24,63.1,1.22
CpG: 54,chr7,101821722,101822154,432,54,321,25,74.3,0.91
CpG: 57,chr7,101836547,101837096,549,57,391,20.8,71.2,0.82
CpG: 51,chr7,101837509,101838267,758,51,425,13.5,56.1,0.86
CpG: 31,chr7,101896134,101896477,343,31,208,18.1,60.6,1
CpG: 60,chr7,101905748,101906338,590,60,392,20.3,66.4,0.92
CpG: 45,chr7,101933750,101934287,537,45,327,16.8,60.9,0.91
CpG: 50,chr7,101970067,101970613,546,50,385,18.3,70.5,0.74
CpG: 53,chr7,102065122,102065803,681,53,365,15.6,53.6,1.08
CpG: 27,chr7,102106910,102107246,336,27,222,16.1,66.1,0.74
CpG: 37,chr7,102113277,102113617,340,37,230,21.8,67.6,0.95
CpG: 62,chr7,102209724,102210291,567,62,373,21.9,65.8,1.02
CpG: 22,chr7,102223024,102223247,223,22,161,19.7,72.2,0.76
CpG: 30,chr7,102249755,102250036,281,30,197,21.4,70.1,0.94
CpG: 29,chr7,102250665,102250926,261,29,185,22.2,70.9,0.9
CpG: 100,chr7,102267202,102268333,1131,100,741,17.7,65.5,0.82
CpG: 40,chr7,102441612,102442102,490,40,294,16.3,60,0.91
CpG: 51,chr7,102512907,102513374,467,51,322,21.8,69,0.92
CpG: 48,chr7,104501968,104502389,421,48,299,22.8,71,0.94
CpG: 49,chr7,105399853,105400318,465,49,291,21.1,62.6,1.09
CpG: 30,chr7,105425727,105426166,439,30,293,13.7,66.7,0.64
CpG: 28,chr7,105434959,105435341,382,28,241,14.7,63.1,0.75
CpG: 52,chr7,105481789,105482365,576,52,401,18.1,69.6,0.75
CpG: 46,chr7,105581102,105581541,439,46,320,21,72.9,0.8
CpG: 15,chr7,105617746,105617948,202,15,121,14.9,59.9,0.83
CpG: 56,chr7,105633073,105633815,742,56,429,15.1,57.8,0.93
CpG: 42,chr7,105640203,105640742,539,42,340,15.6,63.1,0.79
CpG: 87,chr7,105736118,105737315,1197,87,742,14.5,62,0.76
CpG: 71,chr7,105743888,105744532,644,71,467,22,72.5,0.84
CpG: 79,chr7,105762140,105762813,673,79,469,23.5,69.7,0.97
CpG: 65,chr7,105787307,105787852,545,65,355,23.9,65.1,1.16
CpG: 72,chr7,105810668,105811337,669,72,452,21.5,67.6,0.95
CpG: 174,chr7,107209177,107210585,1408,174,891,24.7,63.3,1.24
CpG: 122,chr7,107370300,107371499,1199,122,799,20.4,66.6,0.92
CpG: 86,chr7,108950395,108951326,931,86,602,18.5,64.7,0.89
CpG: 74,chr7,109010708,109011269,561,74,432,26.4,77,0.89
CpG: 46,chr7,109083076,109083440,364,46,259,25.3,71.2,1
CpG: 68,chr7,109169528,109170130,602,68,425,22.6,70.6,0.91
CpG: 49,chr7,109174700,109175336,636,49,348,15.4,54.7,1.03
CpG: 59,chr7,109438769,109439363,594,59,398,19.9,67,0.89
CpG: 72,chr7,109518879,109519670,791,72,528,18.2,66.8,0.82
CpG: 59,chr7,109703458,109704045,587,59,384,20.1,65.4,0.94
CpG: 59,chr7,109752051,109752610,559,59,381,21.1,68.2,0.91
CpG: 56,chr7,109781267,109781951,684,56,434,16.4,63.5,0.82
CpG: 32,chr7,109865423,109865671,248,32,161,25.8,64.9,1.23
CpG: 79,chr7,109959900,109960699,799,79,443,19.8,55.4,1.29
CpG: 58,chr7,109985941,109986550,609,58,384,19,63.1,0.97
CpG: 73,chr7,110018179,110018888,709,73,488,20.6,68.8,0.87
CpG: 104,chr7,110060920,110062263,1343,104,851,15.5,63.4,0.77
CpG: 171,chr7,110121558,110123057,1499,171,1034,22.8,69,0.96
CpG: 65,chr7,110221685,110222247,562,65,408,23.1,72.6,0.88
CpG: 111,chr7,110614179,110615131,952,111,627,23.3,65.9,1.1
CpG: 55,chr7,110768534,110768973,439,55,335,25.1,76.3,0.86
CpG: 37,chr7,110844050,110844483,433,37,289,17.1,66.7,0.78
CpG: 63,chr7,111028665,111029405,740,63,474,17,64.1,0.83
CpG: 22,chr7,111055379,111055660,281,22,167,15.7,59.4,0.89
CpG: 151,chr7,111081948,111083501,1553,151,1019,19.4,65.6,0.91
CpG: 65,chr7,111122168,111122925,757,65,488,17.2,64.5,0.83
CpG: 17,chr7,111598917,111599119,202,17,123,16.8,60.9,0.93
CpG: 43,chr7,111779798,111780283,485,43,336,17.7,69.3,0.74
CpG: 90,chr7,112023202,112024166,964,90,611,18.7,63.4,0.95
CpG: 21,chr7,112158293,112158511,218,21,150,19.3,68.8,0.83
CpG: 52,chr7,112225730,112226314,584,52,387,17.8,66.3,0.81
CpG: 49,chr7,112427777,112428444,667,49,422,14.7,63.3,0.73
CpG: 137,chr7,112678886,112680091,1205,137,788,22.7,65.4,1.07
CpG: 158,chr7,112953824,112955432,1608,158,1084,19.7,67.4,0.88
CpG: 143,chr7,113206809,113208636,1827,143,1116,15.7,61.1,0.86
CpG: 92,chr7,113369042,113369986,944,92,633,19.5,67.1,0.87
CpG: 75,chr7,113513339,113514040,701,75,478,21.4,68.2,0.93
CpG: 56,chr7,113766037,113766688,651,56,435,17.2,66.8,0.77
CpG: 116,chr7,114116940,114117867,927,116,653,25,70.4,1.01
CpG: 61,chr7,114254116,114254681,565,61,399,21.6,70.6,0.88
CpG: 44,chr7,114275769,114276278,509,44,325,17.3,63.9,0.85
CpG: 189,chr7,114414929,114416585,1656,189,1075,22.8,64.9,1.09
CpG: 50,chr7,114562569,114563069,500,50,340,20,68,0.87
CpG: 47,chr7,114927140,114927782,642,47,378,14.6,58.9,0.85
CpG: 70,chr7,116031643,116032508,865,70,543,16.2,62.8,0.82
CpG: 37,chr7,116033774,116034170,396,37,277,18.7,69.9,0.8
CpG: 39,chr7,116093081,116093523,442,39,273,17.6,61.8,0.93
CpG: 62,chr7,116237285,116237897,612,62,428,20.3,69.9,0.83
CpG: 118,chr7,116307331,116308407,1076,118,762,21.9,70.8,0.88
CpG: 78,chr7,116333749,116334655,906,78,565,17.2,62.4,0.89
CpG: 101,chr7,116443037,116444061,1024,101,696,19.7,68,0.85
CpG: 49,chr7,116504192,116504830,638,49,419,15.4,65.7,0.73
CpG: 75,chr7,117380956,117381558,602,75,413,24.9,68.6,1.07
CpG: 45,chr7,118115744,118116210,466,45,304,19.3,65.2,0.91
CpG: 39,chr7,118129309,118129813,504,39,313,15.5,62.1,0.8
CpG: 132,chr7,118243021,118244276,1255,132,894,21,71.2,0.84
CpG: 109,chr7,118447423,118448696,1273,109,869,17.1,68.3,0.74
CpG: 176,chr7,118489793,118492038,2245,176,1515,15.7,67.5,0.69
CpG: 44,chr7,118533069,118533458,389,44,242,22.6,62.2,1.18
CpG: 46,chr7,118584403,118584779,376,46,278,24.5,73.9,0.9
CpG: 60,chr7,118705324,118705844,520,60,372,23.1,71.5,0.91
CpG: 34,chr7,118712419,118712914,495,34,287,13.7,58,0.84
CpG: 17,chr7,118740536,118740741,205,17,126,16.6,61.5,0.91
CpG: 73,chr7,118855576,118856223,647,73,402,22.6,62.1,1.17
CpG: 40,chr7,119184311,119184754,443,40,283,18.1,63.9,0.89
CpG: 61,chr7,119720228,119720874,646,61,411,18.9,63.6,0.93
CpG: 28,chr7,119744294,119744583,289,28,191,19.4,66.1,0.9
CpG: 60,chr7,119793770,119794341,571,60,364,21,63.7,1.04
CpG: 21,chr7,119896105,119896407,302,21,204,13.9,67.5,0.63
CpG: 32,chr7,120102212,120102696,484,32,310,13.2,64,0.67
CpG: 22,chr7,120504415,120504630,215,22,137,20.5,63.7,1.03
CpG: 35,chr7,120597744,120598024,280,35,203,25,72.5,0.97
CpG: 79,chr7,120634737,120635797,1060,79,646,14.9,60.9,0.81
CpG: 24,chr7,120809821,120810099,278,24,197,17.3,70.9,0.72
CpG: 28,chr7,120830946,120831325,379,28,207,14.8,54.6,1.02
CpG: 73,chr7,120842729,120843703,974,73,589,15,60.5,0.82
CpG: 86,chr7,120917623,120918429,806,86,531,21.3,65.9,0.98
CpG: 92,chr7,120981717,120982723,1006,92,659,18.3,65.5,0.86
CpG: 94,chr7,121034405,121035262,857,94,534,21.9,62.3,1.13
CpG: 116,chr7,121392179,121393196,1017,116,713,22.8,70.1,0.94
CpG: 15,chr7,121500464,121500678,214,15,124,14,57.9,0.86
CpG: 107,chr7,121706559,121707510,951,107,555,22.5,58.4,1.33
CpG: 52,chr7,121734241,121735053,812,52,484,12.8,59.6,0.74
CpG: 21,chr7,121864993,121865211,218,21,147,19.3,67.4,0.93
CpG: 54,chr7,121981364,121981845,481,54,302,22.5,62.8,1.14
CpG: 20,chr7,122020726,122020977,251,20,158,15.9,62.9,0.8
CpG: 122,chr7,122066788,122067876,1088,122,769,22.4,70.7,0.9
CpG: 49,chr7,122101598,122101956,358,49,267,27.4,74.6,0.98
CpG: 52,chr7,122132584,122133273,689,52,431,15.1,62.6,0.77
CpG: 43,chr7,122159328,122159792,464,43,287,18.5,61.9,0.98
CpG: 89,chr7,122288861,122289880,1019,89,666,17.5,65.4,0.82
CpG: 133,chr7,122969617,122970805,1188,133,819,22.4,68.9,0.95
CpG: 87,chr7,123123769,123124610,841,87,557,20.7,66.2,0.95
CpG: 19,chr7,123369426,123369630,204,19,135,18.6,66.2,0.86
CpG: 18,chr7,123370396,123370626,230,18,142,15.7,61.7,0.87
CpG: 32,chr7,123377849,123378233,384,32,240,16.7,62.5,0.85
CpG: 68,chr7,123500288,123500885,597,68,417,22.8,69.8,0.98
CpG: 147,chr7,123982572,123983871,1299,147,851,22.6,65.5,1.06
CpG: 23,chr7,125393690,125393921,231,23,153,19.9,66.2,0.91
CpG: 52,chr7,125444606,125445208,602,52,364,17.3,60.5,0.95
CpG: 47,chr7,125491301,125491710,409,47,270,23,66,1.09
CpG: 42,chr7,125552065,125552543,478,42,313,17.6,65.5,0.86
CpG: 26,chr7,125581198,125581484,286,26,162,18.2,56.6,1.13
CpG: 80,chr7,125707321,125708258,937,80,630,17.1,67.2,0.76
CpG: 115,chr7,126081563,126082475,912,115,644,25.2,70.6,1.02
CpG: 71,chr7,126199946,126200623,677,71,492,21,72.7,0.8
CpG: 62,chr7,126272596,126273258,662,62,466,18.7,70.4,0.76
CpG: 89,chr7,126291947,126292818,871,89,591,20.4,67.9,0.89
CpG: 39,chr7,126377002,126377542,540,39,338,14.4,62.6,0.74
CpG: 51,chr7,126396379,126396853,474,51,320,21.5,67.5,0.98
CpG: 83,chr7,126428620,126429400,780,83,549,21.3,70.4,0.88
CpG: 63,chr7,126474747,126475568,821,63,497,15.3,60.5,0.84
CpG: 46,chr7,126487151,126487668,517,46,337,17.8,65.2,0.85
CpG: 179,chr7,126501990,126503821,1831,179,1273,19.6,69.5,0.81
CpG: 31,chr7,126535911,126536266,355,31,226,17.5,63.7,0.91
CpG: 58,chr7,126565942,126566511,569,58,378,20.4,66.4,0.93
CpG: 47,chr7,126649275,126649648,373,47,250,25.2,67,1.13
CpG: 79,chr7,126695342,126696351,1009,79,647,15.7,64.1,0.77
CpG: 18,chr7,126704763,126704981,218,18,140,16.5,64.2,0.84
CpG: 56,chr7,126776761,126777275,514,56,377,21.8,73.3,0.81
CpG: 82,chr7,126791916,126792690,774,82,537,21.2,69.4,0.88
CpG: 74,chr7,126798841,126799797,956,74,622,15.5,65.1,0.73
CpG: 34,chr7,126808976,126809384,408,34,261,16.7,64,0.84
CpG: 39,chr7,126847586,126847941,355,39,242,22,68.2,0.96
CpG: 68,chr7,126861763,126862650,887,68,481,15.3,54.2,1.04
CpG: 32,chr7,126884694,126884964,270,32,192,23.7,71.1,0.95
CpG: 78,chr7,126928644,126929320,676,78,458,23.1,67.8,1.01
CpG: 29,chr7,126949701,126950007,306,29,212,19,69.3,0.79
CpG: 41,chr7,126976021,126976608,587,41,349,14,59.5,0.79
CpG: 28,chr7,127017108,127017475,367,28,209,15.3,56.9,0.94
CpG: 17,chr7,127021216,127021431,215,17,152,15.8,70.7,0.74
CpG: 30,chr7,127025352,127025621,269,30,180,22.3,66.9,1
CpG: 46,chr7,127027163,127027541,378,46,264,24.3,69.8,1.02
CpG: 40,chr7,127042181,127042549,368,40,236,21.7,64.1,1.11
CpG: 45,chr7,127195601,127196177,576,45,347,15.6,60.2,0.86
CpG: 65,chr7,127208030,127208705,675,65,384,19.3,56.9,1.19
CpG: 54,chr7,127233080,127233508,428,54,302,25.2,70.6,1.01
CpG: 49,chr7,127244138,127244744,606,49,384,16.2,63.4,0.81
CpG: 132,chr7,127253823,127254634,811,132,585,32.6,72.1,1.26
CpG: 30,chr7,127260498,127260785,287,30,185,20.9,64.5,1.01
CpG: 56,chr7,127273498,127274075,577,56,405,19.4,70.2,0.79
CpG: 31,chr7,127343247,127343623,376,31,239,16.5,63.6,0.84
CpG: 124,chr7,127345131,127346345,1214,124,862,20.4,71,0.82
CpG: 20,chr7,127363670,127363908,238,20,153,16.8,64.3,0.81
CpG: 46,chr7,127375479,127376054,575,46,350,16,60.9,0.87
CpG: 30,chr7,127386621,127386953,332,30,212,18.1,63.9,0.89
CpG: 34,chr7,127393091,127393508,417,34,268,16.3,64.3,0.8
CpG: 32,chr7,127406331,127406680,349,32,237,18.3,67.9,0.8
CpG: 37,chr7,127421784,127422149,365,37,251,20.3,68.8,0.86
CpG: 44,chr7,127444176,127444739,563,44,358,15.6,63.6,0.79
CpG: 43,chr7,127448625,127449118,493,43,321,17.4,65.1,0.82
CpG: 24,chr7,127470934,127471255,321,24,200,15,62.3,0.87
CpG: 29,chr7,127471669,127472041,372,29,259,15.6,69.6,0.64
CpG: 21,chr7,127478243,127478524,281,21,160,14.9,56.9,0.92
CpG: 80,chr7,127478838,127479508,670,80,475,23.9,70.9,0.95
CpG: 118,chr7,127511907,127513004,1097,118,723,21.5,65.9,0.99
CpG: 43,chr7,127588715,127589145,430,43,285,20,66.3,0.91
CpG: 78,chr7,127611029,127612140,1111,78,678,14,61,0.76
CpG: 44,chr7,127614582,127614935,353,44,255,24.9,72.2,0.98
CpG: 71,chr7,127708278,127708999,721,71,450,19.7,62.4,1.02
CpG: 48,chr7,127717034,127717466,432,48,322,22.2,74.5,0.8
CpG: 23,chr7,127745854,127746160,306,23,176,15,57.5,0.91
CpG: 50,chr7,127746480,127747131,651,50,459,15.4,70.5,0.63
CpG: 24,chr7,127752084,127752380,296,24,201,16.2,67.9,0.7
CpG: 36,chr7,127769765,127770211,446,36,300,16.1,67.3,0.72
CpG: 109,chr7,127776587,127777720,1133,109,698,19.2,61.6,1.01
CpG: 24,chr7,127824263,127824550,287,24,203,16.7,70.7,0.68
CpG: 73,chr7,127841412,127842351,939,73,608,15.5,64.7,0.77
CpG: 153,chr7,127875449,127877185,1736,153,1050,17.6,60.5,0.97
CpG: 29,chr7,127895403,127895688,285,29,191,20.4,67,0.91
CpG: 25,chr7,127904064,127904271,207,25,140,24.2,67.6,1.06
CpG: 60,chr7,127935406,127935994,588,60,408,20.4,69.4,0.85
CpG: 17,chr7,127944686,127944904,218,17,145,15.6,66.5,0.71
CpG: 118,chr7,127967107,127968299,1192,118,770,19.8,64.6,0.95
CpG: 44,chr7,128009919,128010402,483,44,319,18.2,66,0.84
CpG: 120,chr7,128237256,128238563,1307,120,817,18.4,62.5,0.94
CpG: 38,chr7,128297756,128298127,371,38,261,20.5,70.4,0.83
CpG: 118,chr7,128417711,128418774,1063,118,753,22.2,70.8,0.89
CpG: 24,chr7,128460230,128460594,364,24,187,13.2,51.4,1.03
CpG: 91,chr7,128461002,128462122,1120,91,668,16.2,59.6,0.92
CpG: 99,chr7,128523328,128524433,1105,99,741,17.9,67.1,0.8
CpG: 40,chr7,128611382,128611840,458,40,273,17.5,59.6,0.99
CpG: 55,chr7,128687969,128688582,613,55,389,17.9,63.5,0.89
CpG: 98,chr7,128739783,128740664,881,98,579,22.2,65.7,1.03
CpG: 49,chr7,128744716,128745257,541,49,337,18.1,62.3,0.93
CpG: 54,chr7,129256599,129257189,590,54,385,18.3,65.3,0.87
CpG: 36,chr7,129591837,129592169,332,36,218,21.7,65.7,1.01
CpG: 131,chr7,130264991,130266512,1521,131,954,17.2,62.7,0.88
CpG: 91,chr7,130519061,130520114,1053,91,663,17.3,63,0.87
CpG: 76,chr7,130546808,130547429,621,76,422,24.5,68,1.07
CpG: 38,chr7,130646012,130646461,449,38,298,16.9,66.4,0.78
CpG: 22,chr7,130728540,130728812,272,22,163,16.2,59.9,0.9
CpG: 21,chr7,130766867,130767117,250,21,154,16.8,61.6,0.89
CpG: 105,chr7,130865633,130866624,991,105,665,21.2,67.1,0.95
CpG: 118,chr7,130936044,130937049,1005,118,710,23.5,70.6,0.94
CpG: 95,chr7,131362266,131363378,1112,95,696,17.1,62.6,0.87
CpG: 42,chr7,131371063,131371436,373,42,259,22.5,69.4,0.94
CpG: 63,chr7,131410087,131410813,726,63,440,17.4,60.6,0.95
CpG: 232,chr7,131541922,131544729,2807,232,1802,16.5,64.2,0.8
CpG: 36,chr7,131552314,131552763,449,36,277,16,61.7,0.84
CpG: 157,chr7,131553890,131556084,2194,157,1290,14.3,58.8,0.83
CpG: 22,chr7,131556977,131557219,242,22,151,18.2,62.4,0.98
CpG: 50,chr7,131560185,131560725,540,50,339,18.5,62.8,0.99
CpG: 87,chr7,131966648,131967566,918,87,627,19,68.3,0.81
CpG: 29,chr7,132154427,132154716,289,29,208,20.1,72,0.77
CpG: 145,chr7,132315604,132317326,1722,145,1133,16.8,65.8,0.79
CpG: 59,chr7,132575893,132576495,602,59,409,19.6,67.9,0.9
CpG: 65,chr7,132597177,132597813,636,65,442,20.4,69.5,0.85
CpG: 38,chr7,132599402,132599926,524,38,300,14.5,57.3,0.89
CpG: 37,chr7,132610564,132610909,345,37,227,21.4,65.8,1.01
CpG: 117,chr7,132812946,132813998,1052,117,680,22.2,64.6,1.07
CpG: 30,chr7,132852377,132852664,287,30,196,20.9,68.3,0.93
CpG: 41,chr7,132859195,132859641,446,41,306,18.4,68.6,0.79
CpG: 115,chr7,132930845,132931852,1007,115,658,22.8,65.3,1.07
CpG: 304,chr7,133121719,133124855,3136,304,2029,19.4,64.7,0.93
CpG: 89,chr7,133637329,133638347,1018,89,658,17.5,64.6,0.85
CpG: 62,chr7,133708686,133709428,742,62,469,16.7,63.2,0.84
CpG: 59,chr7,133776482,133777039,557,59,371,21.2,66.6,0.96
CpG: 73,chr7,134224650,134225407,757,73,492,19.3,65,0.91
CpG: 88,chr7,134670488,134671284,796,88,542,22.1,68.1,0.95
CpG: 72,chr7,134937519,134938313,794,72,490,18.1,61.7,0.95
CpG: 39,chr7,135410478,135410801,323,39,225,24.1,69.7,1
CpG: 86,chr7,135537708,135538613,905,86,574,19,63.4,0.95
CpG: 82,chr7,135715839,135716715,876,82,545,18.7,62.2,0.97
CpG: 19,chr7,136894392,136894605,213,19,151,17.8,70.9,0.84
CpG: 25,chr7,137198500,137198811,311,25,194,16.1,62.4,0.86
CpG: 116,chr7,137309187,137310621,1434,116,896,16.2,62.5,0.83
CpG: 205,chr7,137313128,137315593,2465,205,1449,16.6,58.8,0.96
CpG: 80,chr7,137322350,137323036,686,80,463,23.3,67.5,1.04
CpG: 53,chr7,137410453,137411112,659,53,417,16.1,63.3,0.81
CpG: 65,chr7,137437514,137438103,589,65,427,22.1,72.5,0.85
CpG: 92,chr7,138396938,138398097,1159,92,705,15.9,60.8,0.86
CpG: 67,chr7,138829860,138830433,573,67,399,23.4,69.6,1
CpG: 113,chr7,138845951,138847068,1117,113,712,20.2,63.7,1.01
CpG: 63,chr7,138909270,138909987,717,63,500,17.6,69.7,0.74
CpG: 77,chr7,138940369,138941329,960,77,608,16,63.3,0.82
CpG: 20,chr7,139007348,139007567,219,20,138,18.3,63,0.93
CpG: 17,chr7,139020983,139021188,205,17,159,16.6,77.6,0.65
CpG: 80,chr7,139085953,139086762,809,80,544,19.8,67.2,0.88
CpG: 94,chr7,139187769,139188689,920,94,578,20.4,62.8,1.04
CpG: 44,chr7,139212955,139213485,530,44,350,16.6,66,0.76
CpG: 84,chr7,139248232,139249006,774,84,495,21.7,64,1.06
CpG: 20,chr7,139388537,139388778,241,20,155,16.6,64.3,0.83
CpG: 69,chr7,139389036,139389600,564,69,392,24.5,69.5,1.02
CpG: 215,chr7,139580920,139582928,2008,215,1323,21.4,65.9,0.99
CpG: 45,chr7,139584527,139585213,686,45,405,13.1,59,0.76
CpG: 27,chr7,139659910,139660162,252,27,172,21.4,68.3,0.93
CpG: 21,chr7,139834032,139834242,210,21,144,20,68.6,0.85
CpG: 36,chr7,139894761,139895076,315,36,234,22.9,74.3,0.83
CpG: 119,chr7,139943712,139944962,1250,119,824,19,65.9,0.88
CpG: 17,chr7,139950788,139951005,217,17,128,15.7,59,1.03
CpG: 22,chr7,139978516,139978805,289,22,188,15.2,65.1,0.72
CpG: 78,chr7,140036164,140036961,797,78,534,19.6,67,0.87
CpG: 115,chr7,140047766,140049321,1555,115,958,14.8,61.6,0.79
CpG: 40,chr7,140058039,140058403,364,40,238,22,65.4,1.03
CpG: 25,chr7,140061270,140061497,227,25,155,22,68.3,0.94
CpG: 28,chr7,140070319,140070711,392,28,256,14.3,65.3,0.68
CpG: 26,chr7,140116266,140116556,290,26,199,17.9,68.6,0.78
CpG: 30,chr7,140137551,140137846,295,30,204,20.3,69.2,0.85
CpG: 23,chr7,140787634,140787929,295,23,199,15.6,67.5,0.71
CpG: 48,chr7,140856078,140856825,747,48,444,12.9,59.4,0.73
CpG: 48,chr7,140857047,140857659,612,48,371,15.7,60.6,0.86
CpG: 62,chr7,140881656,140882426,770,62,484,16.1,62.9,0.84
CpG: 47,chr7,140922389,140922913,524,47,325,17.9,62,0.94
CpG: 99,chr7,141060684,141061593,909,99,596,21.8,65.6,1.01
CpG: 21,chr7,141068553,141068775,222,21,143,18.9,64.4,0.93
CpG: 57,chr7,141070293,141071018,725,57,429,15.7,59.2,0.9
CpG: 18,chr7,141092432,141092640,208,18,135,17.3,64.9,0.89
CpG: 52,chr7,141099954,141100625,671,52,422,15.5,62.9,0.78
CpG: 53,chr7,141131187,141131694,507,53,347,20.9,68.4,0.9
CpG: 19,chr7,141168525,141168747,222,19,140,17.1,63.1,0.88
CpG: 28,chr7,141172586,141172869,283,28,181,19.8,64,0.97
CpG: 128,chr7,141193623,141195161,1538,128,903,16.6,58.7,0.97
CpG: 57,chr7,141215608,141216250,642,57,441,17.8,68.7,0.77
CpG: 78,chr7,141228401,141229106,705,78,476,22.1,67.5,0.99
CpG: 20,chr7,141259710,141259976,266,20,168,15,63.2,0.79
CpG: 35,chr7,141291933,141292381,448,35,295,15.6,65.8,0.72
CpG: 38,chr7,141293742,141294185,443,38,292,17.2,65.9,0.8
CpG: 19,chr7,141294626,141294854,228,19,140,16.7,61.4,0.9
CpG: 133,chr7,141327236,141328505,1269,133,794,21,62.6,1.07
CpG: 18,chr7,141338837,141339055,218,18,153,16.5,70.2,0.68
CpG: 22,chr7,141361541,141361824,283,22,182,15.5,64.3,0.75
CpG: 43,chr7,141391888,141392415,527,43,316,16.3,60,0.91
CpG: 23,chr7,141413991,141414203,212,23,149,21.7,70.3,0.91
CpG: 39,chr7,141437321,141437705,384,39,264,20.3,68.8,0.87
CpG: 62,chr7,141447347,141448021,674,62,425,18.4,63.1,0.93
CpG: 47,chr7,141455073,141455560,487,47,340,19.3,69.8,0.8
CpG: 45,chr7,141461772,141462241,469,45,310,19.2,66.1,0.88
CpG: 33,chr7,141464722,141465089,367,33,244,18,66.5,0.83
CpG: 36,chr7,141467373,141467911,538,36,340,13.4,63.2,0.68
CpG: 93,chr7,141474932,141475787,855,93,598,21.8,69.9,0.9
CpG: 52,chr7,141481953,141482428,475,52,298,21.9,62.7,1.12
CpG: 38,chr7,141539650,141540073,423,38,269,18,63.6,0.89
CpG: 88,chr7,141561949,141562633,684,88,470,25.7,68.7,1.09
CpG: 27,chr7,141693540,141693819,279,27,182,19.4,65.2,0.91
CpG: 50,chr7,141902120,141902599,479,50,332,20.9,69.3,0.88
CpG: 22,chr7,141949309,141949612,303,22,183,14.5,60.4,0.82
CpG: 64,chr7,141950083,141950681,598,64,408,21.4,68.2,0.93
CpG: 89,chr7,142060470,142061147,677,89,464,26.3,68.5,1.15
CpG: 50,chr7,142082194,142082742,548,50,399,18.2,72.8,0.71
CpG: 128,chr7,142094379,142095510,1131,128,770,22.6,68.1,0.98
CpG: 45,chr7,142372041,142372448,407,45,299,22.1,73.5,0.82
CpG: 43,chr7,142387671,142388028,357,43,244,24.1,68.3,1.03
CpG: 49,chr7,142532885,142533325,440,49,319,22.3,72.5,0.94
CpG: 178,chr7,142658948,142661318,2370,178,1486,15,62.7,0.77
CpG: 56,chr7,142663909,142664388,479,56,339,23.4,70.8,0.93
CpG: 165,chr7,142967451,142969457,2006,165,1232,16.5,61.4,0.88
CpG: 60,chr7,143052674,143053288,614,60,420,19.5,68.4,0.84
CpG: 46,chr7,143069070,143069595,525,46,325,17.5,61.9,0.92
CpG: 19,chr7,143069768,143070049,281,19,174,13.5,61.9,0.71
CpG: 78,chr7,143107028,143107765,737,78,534,21.2,72.5,0.81
CpG: 41,chr7,143295404,143295824,420,41,258,19.5,61.4,1.04
CpG: 19,chr7,143296313,143296559,246,19,142,15.4,57.7,0.93
CpG: 70,chr7,143437811,143438545,734,70,422,19.1,57.5,1.16
CpG: 86,chr7,143445160,143446003,843,86,511,20.4,60.6,1.13
CpG: 205,chr7,143459055,143461477,2422,205,1296,16.9,53.5,1.19
CpG: 29,chr7,143464850,143465112,262,29,191,22.1,72.9,0.84
CpG: 103,chr7,143501647,143502963,1316,103,821,15.7,62.4,0.81
CpG: 100,chr7,143548410,143549352,942,100,636,21.2,67.5,0.93
CpG: 28,chr7,143822804,143823106,302,28,199,18.5,65.9,0.92
CpG: 28,chr7,143829997,143830360,363,28,237,15.4,65.3,0.74
CpG: 117,chr7,143977817,143979374,1557,117,1020,15,65.5,0.7
CpG: 37,chr7,144175464,144175899,435,37,289,17,66.4,0.77
CpG: 16,chr7,144284660,144284867,207,16,155,15.5,74.9,0.61
CpG: 74,chr7,144553371,144554022,651,74,403,22.7,61.9,1.2
CpG: 53,chr7,144582078,144582598,520,53,341,20.4,65.6,0.96
CpG: 62,chr7,144678477,144678948,471,62,333,26.3,70.7,1.05
CpG: 30,chr7,144738380,144738679,299,30,214,20.1,71.6,0.79
CpG: 148,chr7,144837919,144839664,1745,148,995,17,57,1.04
CpG: 92,chr7,144861248,144862038,790,92,570,23.3,72.2,0.89
CpG: 25,chr7,144895750,144896046,296,25,191,16.9,64.5,0.82
CpG: 68,chr7,144896464,144897267,803,68,505,16.9,62.9,0.86
CpG: 46,chr7,144914946,144915451,505,46,311,18.2,61.6,0.96
CpG: 29,chr7,144939569,144939821,252,29,173,23,68.7,0.99
CpG: 46,chr7,144941166,144941803,637,46,410,14.4,64.4,0.7
CpG: 34,chr7,144942282,144942782,500,34,297,13.6,59.4,0.77
CpG: 44,chr7,144943338,144943616,278,44,198,31.7,71.2,1.25
CpG: 25,chr7,145206283,145206588,305,25,217,16.4,71.1,0.65
CpG: 26,chr8,3221033,3221283,250,26,163,20.8,65.2,0.98
CpG: 50,chr8,3279068,3279608,540,50,374,18.5,69.3,0.77
CpG: 35,chr8,3451857,3452227,370,35,249,18.9,67.3,0.86
CpG: 27,chr8,3476035,3476340,305,27,184,17.7,60.3,0.98
CpG: 55,chr8,3492967,3493611,644,55,419,17.1,65.1,0.83
CpG: 33,chr8,3495872,3496387,515,33,329,12.8,63.9,0.64
CpG: 76,chr8,3500174,3500966,792,76,503,19.2,63.5,0.95
CpG: 18,chr8,3515318,3515566,248,18,147,14.5,59.3,0.86
CpG: 29,chr8,3516773,3517156,383,29,234,15.1,61.1,0.82
CpG: 24,chr8,3537720,3538031,311,24,206,15.4,66.2,0.71
CpG: 67,chr8,3587582,3588213,631,67,426,21.2,67.5,0.95
CpG: 33,chr8,3621239,3621646,407,33,236,16.2,58,0.97
CpG: 32,chr8,3630823,3631224,401,32,247,16,61.6,0.86
CpG: 44,chr8,3676348,3676723,375,44,256,23.5,68.3,1.02
CpG: 39,chr8,3679030,3679509,479,39,304,16.3,63.5,0.81
CpG: 40,chr8,3994234,3994529,295,40,209,27.1,70.8,1.08
CpG: 27,chr8,4087398,4087757,359,27,246,15,68.5,0.69
CpG: 47,chr8,4166553,4166994,441,47,317,21.3,71.9,0.83
CpG: 23,chr8,4206443,4206677,234,23,157,19.7,67.1,0.88
CpG: 23,chr8,4212923,4213183,260,23,184,17.7,70.8,0.73
CpG: 26,chr8,4217071,4217359,288,26,199,18.1,69.1,0.76
CpG: 68,chr8,4238413,4239258,845,68,494,16.1,58.5,0.94
CpG: 37,chr8,4249280,4249706,426,37,276,17.4,64.8,0.83
CpG: 44,chr8,4253002,4253419,417,44,275,21.1,65.9,0.97
CpG: 90,chr8,4258389,4259352,963,90,659,18.7,68.4,0.8
CpG: 25,chr8,4275696,4275947,251,25,155,19.9,61.8,1.08
CpG: 110,chr8,4324437,4325527,1090,110,667,20.2,61.2,1.08
CpG: 21,chr8,4493286,4493562,276,21,179,15.2,64.9,0.73
CpG: 105,chr8,4677317,4678591,1274,105,787,16.5,61.8,0.88
CpG: 25,chr8,4779289,4779590,301,25,179,16.6,59.5,0.96
CpG: 212,chr8,8659823,8661897,2074,212,1400,20.4,67.5,0.9
CpG: 102,chr8,8689796,8690634,838,102,499,24.3,59.5,1.4
CpG: 19,chr8,9207694,9207912,218,19,150,17.4,68.8,0.74
CpG: 30,chr8,9770334,9770674,340,30,238,17.6,70,0.72
CpG: 50,chr8,9771396,9771971,575,50,353,17.4,61.4,0.95
CpG: 35,chr8,9976120,9976554,434,35,267,16.1,61.5,0.86
CpG: 60,chr8,9977664,9978197,533,60,357,22.5,67,1.01
CpG: 52,chr8,10153863,10154340,477,52,331,21.8,69.4,0.95
CpG: 19,chr8,10978499,10978759,260,19,161,14.6,61.9,0.76
CpG: 326,chr8,11006954,11009869,2915,326,1936,22.4,66.4,1.02
CpG: 46,chr8,11187794,11188298,504,46,321,18.3,63.7,0.9
CpG: 108,chr8,11312171,11313231,1060,108,749,20.4,70.7,0.82
CpG: 50,chr8,11478253,11478737,484,50,330,20.7,68.2,0.91
CpG: 64,chr8,11497356,11497908,552,64,386,23.2,69.9,0.96
CpG: 31,chr8,11550493,11550785,292,31,209,21.2,71.6,0.84
CpG: 298,chr8,11555149,11558650,3501,298,2153,17,61.5,0.91
CpG: 24,chr8,11561643,11561981,338,24,189,14.2,55.9,0.91
CpG: 136,chr8,11634787,11636044,1257,136,884,21.6,70.3,0.88
CpG: 17,chr8,11636466,11636671,205,17,139,16.6,67.8,0.74
CpG: 135,chr8,11727435,11728835,1400,135,764,19.3,54.6,1.3
CpG: 73,chr8,11758123,11758774,651,73,427,22.4,65.6,1.09
CpG: 119,chr8,12385051,12386496,1445,119,886,16.5,61.3,0.88
CpG: 178,chr8,12395517,12397679,2162,178,1224,16.5,56.6,1.05
CpG: 72,chr8,12430460,12431350,890,72,588,16.2,66.1,0.74
CpG: 84,chr8,12671772,12672592,820,84,539,20.5,65.7,0.95
CpG: 88,chr8,12756830,12757610,780,88,492,22.6,63.1,1.15
CpG: 23,chr8,12915717,12915971,254,23,174,18.1,68.5,0.81
CpG: 139,chr8,13104514,13105956,1442,139,914,19.3,63.4,0.96
CpG: 45,chr8,13159101,13159386,285,45,212,31.6,74.4,1.15
CpG: 33,chr8,13200396,13200614,218,33,171,30.3,78.4,1
CpG: 17,chr8,13201140,13201353,213,17,123,16,57.7,0.98
CpG: 121,chr8,13287139,13288476,1337,121,876,18.1,65.5,0.86
CpG: 104,chr8,13338534,13339396,862,104,541,24.1,62.8,1.23
CpG: 18,chr8,13468247,13468467,220,18,139,16.4,63.2,0.82
CpG: 61,chr8,13493806,13494518,712,61,471,17.1,66.2,0.78
CpG: 82,chr8,13676991,13677921,930,82,603,17.6,64.8,0.84
CpG: 44,chr8,13757502,13757876,374,44,263,23.5,70.3,0.96
CpG: 104,chr8,13785316,13786400,1084,104,748,19.2,69,0.81
CpG: 54,chr8,13869646,13870141,495,54,345,21.8,69.7,0.91
CpG: 65,chr8,13889868,13890396,528,65,371,24.6,70.3,1.01
CpG: 53,chr8,13907675,13908105,430,53,313,24.7,72.8,0.93
CpG: 86,chr8,13974145,13975143,998,86,657,17.2,65.8,0.81
CpG: 28,chr8,14090178,14090440,262,28,167,21.4,63.7,1.08
CpG: 151,chr8,14095589,14097363,1774,151,1157,17,65.2,0.81
CpG: 25,chr8,14888714,14889037,323,25,207,15.5,64.1,0.76
CpG: 29,chr8,14894518,14894910,392,29,230,14.8,58.7,0.86
CpG: 38,chr8,14911444,14911810,366,38,240,20.8,65.6,1.01
CpG: 23,chr8,14962535,14962751,216,23,127,21.3,58.8,1.23
CpG: 94,chr8,15011029,15012015,986,94,676,19.1,68.6,0.84
CpG: 206,chr8,15027485,15029176,1691,206,1187,24.4,70.2,0.99
CpG: 98,chr8,17534717,17535731,1014,98,646,19.3,63.7,0.95
CpG: 72,chr8,18594998,18595623,625,72,450,23,72,0.89
CpG: 104,chr8,18845955,18846995,1040,104,654,20,62.9,1.01
CpG: 24,chr8,18950724,18950999,275,24,192,17.5,69.8,0.72
CpG: 69,chr8,19535156,19535754,598,69,405,23.1,67.7,1.01
CpG: 69,chr8,19784572,19785241,669,69,454,20.6,67.9,0.94
CpG: 60,chr8,19979954,19980541,587,60,403,20.4,68.7,0.9
CpG: 68,chr8,20122209,20122868,659,68,454,20.6,68.9,0.91
CpG: 68,chr8,20296932,20297602,670,68,452,20.3,67.5,0.92
CpG: 69,chr8,20424211,20424870,659,69,453,20.9,68.7,0.93
CpG: 68,chr8,20550151,20550808,657,68,450,20.7,68.5,0.92
CpG: 37,chr8,20557688,20557946,258,37,173,28.7,67.1,1.29
CpG: 14,chr8,22013383,22013586,203,14,119,13.8,58.6,0.82
CpG: 69,chr8,22060121,22060886,765,69,516,18,67.5,0.81
CpG: 34,chr8,22166148,22166413,265,34,172,25.7,64.9,1.27
CpG: 51,chr8,22185507,22185965,458,51,317,22.3,69.2,0.93
CpG: 68,chr8,22192742,22193244,502,68,378,27.1,75.3,0.96
CpG: 27,chr8,22227233,22227497,264,27,192,20.5,72.7,0.77
CpG: 66,chr8,22398153,22398736,583,66,408,22.6,70,0.98
CpG: 22,chr8,22411481,22411770,289,22,173,15.2,59.9,0.85
CpG: 75,chr8,22476395,22477231,836,75,454,17.9,54.3,1.22
CpG: 87,chr8,22593327,22594117,790,87,539,22,68.2,0.95
CpG: 54,chr8,22653041,22653505,464,54,318,23.3,68.5,1.01
CpG: 38,chr8,22706339,22706684,345,38,231,22,67,0.98
CpG: 30,chr8,22805468,22805734,266,30,181,22.6,68,1.06
CpG: 41,chr8,22807865,22808378,513,41,329,16,64.1,0.79
CpG: 124,chr8,22858896,22860577,1681,124,871,14.8,51.8,1.1
CpG: 127,chr8,22974432,22975707,1275,127,792,19.9,62.1,1.03
CpG: 71,chr8,23058232,23058885,653,71,453,21.7,69.4,0.95
CpG: 45,chr8,23149726,23150233,507,45,317,17.8,62.5,0.92
CpG: 43,chr8,23157466,23157867,401,43,275,21.4,68.6,0.91
CpG: 83,chr8,23207818,23208756,938,83,577,17.7,61.5,0.95
CpG: 58,chr8,23237313,23237905,592,58,386,19.6,65.2,0.92
CpG: 62,chr8,23256688,23257318,630,62,417,19.7,66.2,0.91
CpG: 120,chr8,23411367,23412492,1125,120,741,21.3,65.9,0.98
CpG: 22,chr8,23669616,23669855,239,22,151,18.4,63.2,0.92
CpG: 101,chr8,25016510,25017634,1124,101,732,18,65.1,0.85
CpG: 54,chr8,25038304,25038809,505,54,333,21.4,65.9,0.99
CpG: 51,chr8,25101927,25102511,584,51,389,17.5,66.6,0.79
CpG: 23,chr8,25102848,25103169,321,23,206,14.3,64.2,0.72
CpG: 113,chr8,25200754,25201800,1046,113,628,21.6,60,1.2
CpG: 55,chr8,25240392,25240967,575,55,364,19.1,63.3,0.99
CpG: 97,chr8,25518748,25519478,730,97,539,26.6,73.8,0.98
CpG: 63,chr8,25596976,25597711,735,63,483,17.1,65.7,0.8
CpG: 125,chr8,25601477,25602706,1229,125,823,20.3,67,0.91
CpG: 19,chr8,25676543,25676764,221,19,133,17.2,60.2,0.96
CpG: 50,chr8,25719972,25720494,522,50,356,19.2,68.2,0.82
CpG: 85,chr8,25753778,25754553,775,85,527,21.9,68,0.95
CpG: 124,chr8,25784864,25786038,1174,124,783,21.1,66.7,0.95
CpG: 60,chr8,25840324,25840821,497,60,361,24.1,72.6,0.92
CpG: 60,chr8,25976371,25976797,426,60,335,28.2,78.6,0.92
CpG: 24,chr8,25986159,25986490,331,24,207,14.5,62.5,0.75
CpG: 50,chr8,26015149,26015594,445,50,281,22.5,63.1,1.14
CpG: 133,chr8,26118794,26119887,1093,133,747,24.3,68.3,1.05
CpG: 97,chr8,26157893,26158914,1021,97,602,19,59,1.1
CpG: 17,chr8,26780600,26780822,222,17,152,15.3,68.5,0.66
CpG: 239,chr8,26976644,26979925,3281,239,2070,14.6,63.1,0.75
CpG: 65,chr8,27023452,27024077,625,65,411,20.8,65.8,0.97
CpG: 62,chr8,27042455,27043091,636,62,427,19.5,67.1,0.91
CpG: 80,chr8,27085466,27086198,732,80,496,21.9,67.8,0.95
CpG: 51,chr8,27121393,27121906,513,51,352,19.9,68.6,0.84
CpG: 31,chr8,27128382,27128750,368,31,230,16.8,62.5,0.87
CpG: 70,chr8,27174088,27174778,690,70,478,20.3,69.3,0.85
CpG: 16,chr8,27206539,27206741,202,16,139,15.8,68.8,0.68
CpG: 85,chr8,27227311,27228243,932,85,595,18.2,63.8,0.91
CpG: 52,chr8,27260287,27260749,462,52,334,22.5,72.3,0.89
CpG: 102,chr8,29219126,29220012,886,102,625,23,70.5,0.93
CpG: 40,chr8,31089606,31090076,470,40,292,17,62.1,0.89
CpG: 39,chr8,31111750,31112293,543,39,355,14.4,65.4,0.67
CpG: 16,chr8,31150835,31151036,201,16,123,15.9,61.2,0.85
CpG: 59,chr8,31168504,31169102,598,59,369,19.7,61.7,1.04
CpG: 142,chr8,32008433,32009781,1348,142,892,21.1,66.2,0.96
CpG: 130,chr8,32883371,32884945,1574,130,984,16.5,62.5,0.85
CpG: 92,chr8,33385461,33386273,812,92,556,22.7,68.5,0.97
CpG: 52,chr8,33517017,33517452,435,52,311,23.9,71.5,0.94
CpG: 66,chr8,33599493,33600228,735,66,379,18,51.6,1.37
CpG: 43,chr8,33641710,33642112,402,43,273,21.4,67.9,0.95
CpG: 51,chr8,33653433,33653916,483,51,281,21.1,58.2,1.25
CpG: 90,chr8,33731779,33732587,808,90,508,22.3,62.9,1.15
CpG: 127,chr8,33929366,33930510,1144,127,737,22.2,64.4,1.07
CpG: 31,chr8,34108162,34108590,428,31,272,14.5,63.6,0.72
CpG: 64,chr8,34146413,34147016,603,64,376,21.2,62.4,1.09
CpG: 49,chr8,34154398,34154861,463,49,315,21.2,68,0.92
CpG: 242,chr8,34806595,34809760,3165,242,1921,15.3,60.7,0.83
CpG: 81,chr8,34965042,34965788,746,81,495,21.7,66.4,0.99
CpG: 29,chr8,35376445,35376747,302,29,209,19.2,69.2,0.81
CpG: 121,chr8,35494746,35495705,959,121,651,25.2,67.9,1.1
CpG: 129,chr8,35587583,35588773,1190,129,839,21.7,70.5,0.87
CpG: 29,chr8,35765660,35766010,350,29,228,16.6,65.1,0.79
CpG: 107,chr8,35825576,35826858,1282,107,851,16.7,66.4,0.76
CpG: 76,chr8,36094594,36095242,648,76,466,23.5,71.9,0.93
CpG: 17,chr8,36147008,36147222,214,17,143,15.9,66.8,0.71
CpG: 144,chr8,36248079,36249336,1257,144,820,22.9,65.2,1.11
CpG: 58,chr8,36457764,36458366,602,58,362,19.3,60.1,1.07
CpG: 18,chr8,36549162,36549390,228,18,154,15.8,67.5,0.7
CpG: 55,chr8,36613577,36614123,546,55,368,20.1,67.4,0.89
CpG: 42,chr8,36732630,36732973,343,42,245,24.5,71.4,0.96
CpG: 57,chr8,38660252,38660721,469,57,340,24.3,72.5,0.93
CpG: 59,chr8,39005780,39006363,583,59,410,20.2,70.3,0.82
CpG: 21,chr8,40286382,40286604,222,21,138,18.9,62.2,0.99
CpG: 90,chr8,40307612,40308449,837,90,566,21.5,67.6,0.94
CpG: 102,chr8,40423415,40424300,885,102,634,23.1,71.6,0.9
CpG: 126,chr8,40511096,40512319,1223,126,835,20.6,68.3,0.89
CpG: 48,chr8,40634563,40634928,365,48,279,26.3,76.4,0.9
CpG: 76,chr8,40862122,40862833,711,76,476,21.4,66.9,0.96
CpG: 21,chr8,40898981,40899274,293,21,167,14.3,57,0.88
CpG: 65,chr8,41133448,41134122,674,65,475,19.3,70.5,0.78
CpG: 85,chr8,41239559,41240382,823,85,575,20.7,69.9,0.85
CpG: 55,chr8,41374361,41374963,602,55,419,18.3,69.6,0.76
CpG: 37,chr8,41416741,41417189,448,37,280,16.5,62.5,0.85
CpG: 55,chr8,44934783,44935480,697,55,448,15.8,64.3,0.77
CpG: 90,chr8,44937941,44938767,826,90,546,21.8,66.1,1.02
CpG: 18,chr8,44950565,44950826,261,18,141,13.8,54,0.95
CpG: 25,chr8,44951615,44951884,269,25,151,18.6,56.1,1.18
CpG: 28,chr8,45009918,45010202,284,28,165,19.7,58.1,1.17
CpG: 18,chr8,45010417,45010638,221,18,126,16.3,57,1
CpG: 71,chr8,45023241,45024207,966,71,528,14.7,54.7,0.99
CpG: 21,chr8,45025658,45025904,246,21,138,17.1,56.1,1.09
CpG: 21,chr8,45037052,45037291,239,21,132,17.6,55.2,1.17
CpG: 19,chr8,45044282,45044515,233,19,139,16.3,59.7,1.01
CpG: 29,chr8,45051222,45051542,320,29,188,18.1,58.8,1.05
CpG: 21,chr8,45333165,45333447,282,21,160,14.9,56.7,0.95
CpG: 32,chr8,45358440,45358699,259,32,200,24.7,77.2,0.83
CpG: 47,chr8,45975128,45975554,426,47,263,22.1,61.7,1.16
CpG: 52,chr8,45999747,46000367,620,52,421,16.8,67.9,0.73
CpG: 18,chr8,46035308,46035528,220,18,145,16.4,65.9,0.76
CpG: 43,chr8,46151636,46151905,269,43,205,32,76.2,1.1
CpG: 91,chr8,46163330,46164084,754,91,518,24.1,68.7,1.02
CpG: 35,chr8,46210834,46211112,278,35,193,25.2,69.4,1.06
CpG: 15,chr8,46292169,46292386,217,15,133,13.8,61.3,0.77
CpG: 43,chr8,46294425,46294897,472,43,292,18.2,61.9,0.96
CpG: 81,chr8,46471064,46471743,679,81,484,23.9,71.3,0.94
CpG: 35,chr8,46551741,46552193,452,35,283,15.5,62.6,0.79
CpG: 65,chr8,46617064,46617871,807,65,518,16.1,64.2,0.82
CpG: 104,chr8,46740435,46741501,1066,104,696,19.5,65.3,0.92
CpG: 21,chr8,47193246,47193548,302,21,174,13.9,57.6,0.84
CpG: 186,chr8,47287833,47289523,1690,186,1129,22,66.8,0.99
CpG: 16,chr8,47392428,47392641,213,16,113,15,53.1,1.07
CpG: 153,chr8,47412402,47413926,1524,153,1050,20.1,68.9,0.85
CpG: 66,chr8,47533324,47534058,734,66,465,18,63.4,0.9
CpG: 35,chr8,47646765,47647150,385,35,237,18.2,61.6,1.04
CpG: 208,chr8,47673649,47675941,2292,208,1481,18.2,64.6,0.88
CpG: 169,chr8,47713145,47714552,1407,169,976,24,69.4,1
CpG: 121,chr8,47989883,47991323,1440,121,863,16.8,59.9,0.94
CpG: 49,chr8,48109978,48110388,410,49,277,23.9,67.6,1.06
CpG: 66,chr8,48228507,48229133,626,66,409,21.1,65.3,1
CpG: 28,chr8,48276481,48276878,397,28,224,14.1,56.4,0.89
CpG: 116,chr8,48554983,48556080,1097,116,688,21.1,62.7,1.09
CpG: 60,chr8,48842973,48843696,723,60,419,16.6,58,1.01
CpG: 47,chr8,50915899,50916462,563,47,373,16.7,66.3,0.77
CpG: 73,chr8,54077220,54077965,745,73,470,19.6,63.1,0.98
CpG: 74,chr8,54529497,54530108,611,74,418,24.2,68.4,1.04
CpG: 26,chr8,56294530,56294794,264,26,178,19.7,67.4,0.87
CpG: 57,chr8,56550720,56551432,712,57,399,16,56,1.02
CpG: 19,chr8,57320892,57321132,240,19,134,15.8,55.8,1.03
CpG: 99,chr8,57321381,57322432,1051,99,655,18.8,62.3,0.97
CpG: 37,chr8,57340917,57341421,504,37,313,14.7,62.1,0.79
CpG: 92,chr8,57486939,57488010,1071,92,672,17.2,62.7,0.88
CpG: 148,chr8,57511148,57512876,1728,148,1006,17.1,58.2,1.02
CpG: 167,chr8,57651743,57653381,1638,167,1030,20.4,62.9,1.04
CpG: 43,chr8,58912481,58913003,522,43,329,16.5,63,0.87
CpG: 108,chr8,60632297,60633504,1207,108,795,17.9,65.9,0.83
CpG: 51,chr8,60890225,60890678,453,51,326,22.5,72,0.9
CpG: 105,chr8,60982714,60983709,995,105,665,21.1,66.8,0.95
CpG: 41,chr8,60993138,60993589,451,41,297,18.2,65.9,0.84
CpG: 113,chr8,61223774,61224641,867,113,656,26.1,75.7,0.91
CpG: 23,chr8,61487837,61488093,256,23,162,18,63.3,0.9
CpG: 14,chr8,61515757,61515960,203,14,106,13.8,52.2,1.01
CpG: 25,chr8,61590932,61591254,322,25,203,15.5,63,0.79
CpG: 33,chr8,61759746,61760094,348,33,226,19,64.9,0.9
CpG: 46,chr8,64205418,64205856,438,46,287,21,65.5,0.98
CpG: 58,chr8,64692606,64693169,563,58,400,20.6,71,0.82
CpG: 58,chr8,64733419,64733904,485,58,344,23.9,70.9,0.95
CpG: 88,chr8,64849319,64850354,1035,88,525,17,50.7,1.33
CpG: 73,chr8,64947151,64947789,638,73,448,22.9,70.2,0.95
CpG: 37,chr8,66486224,66486647,423,37,273,17.5,64.5,0.84
CpG: 21,chr8,66687922,66688171,249,21,171,16.9,68.7,0.75
CpG: 143,chr8,66860123,66861182,1059,143,785,27,74.1,0.98
CpG: 61,chr8,68062073,68062697,624,61,348,19.6,55.8,1.27
CpG: 44,chr8,68734750,68735255,505,44,352,17.4,69.7,0.72
CpG: 54,chr8,68793601,68794246,645,54,410,16.7,63.6,0.83
CpG: 17,chr8,68880647,68880854,207,17,135,16.4,65.2,0.77
CpG: 34,chr8,68881033,68881477,444,34,278,15.3,62.6,0.81
CpG: 49,chr8,69088531,69088949,418,49,296,23.4,70.8,0.94
CpG: 19,chr8,69395332,69395559,227,19,147,16.7,64.8,0.84
CpG: 34,chr8,69399389,69399768,379,34,271,17.9,71.5,0.7
CpG: 54,chr8,69584642,69585159,517,54,357,20.9,69.1,0.91
CpG: 38,chr8,69625174,69625563,389,38,273,19.5,70.2,0.85
CpG: 58,chr8,69654445,69655083,638,58,432,18.2,67.7,0.82
CpG: 44,chr8,69716476,69716910,434,44,295,20.3,68,0.9
CpG: 39,chr8,69749631,69749956,325,39,228,24,70.2,0.99
CpG: 36,chr8,69774611,69774955,344,36,239,20.9,69.5,0.89
CpG: 80,chr8,69791016,69791767,751,80,505,21.3,67.2,0.94
CpG: 23,chr8,69808623,69808837,214,23,154,21.5,72,0.83
CpG: 35,chr8,69832539,69832888,349,35,238,20.1,68.2,0.87
CpG: 293,chr8,69880909,69883346,2437,293,1684,24,69.1,1.01
CpG: 30,chr8,69886006,69886293,287,30,187,20.9,65.2,0.99
CpG: 18,chr8,69887289,69887526,237,18,153,15.2,64.6,0.73
CpG: 27,chr8,69887874,69888140,266,27,183,20.3,68.8,0.86
CpG: 48,chr8,69888981,69889537,556,48,382,17.3,68.7,0.73
CpG: 176,chr8,69901464,69903472,2008,176,1271,17.5,63.3,0.87
CpG: 97,chr8,69973660,69974753,1093,97,660,17.7,60.4,0.98
CpG: 109,chr8,69995856,69996974,1118,109,750,19.5,67.1,0.87
CpG: 103,chr8,70042103,70043380,1277,103,773,16.1,60.5,0.88
CpG: 70,chr8,70084173,70085120,947,70,591,14.8,62.4,0.76
CpG: 32,chr8,70086828,70087130,302,32,194,21.2,64.2,1.04
CpG: 45,chr8,70088070,70088514,444,45,312,20.3,70.3,0.83
CpG: 83,chr8,70111888,70112925,1037,83,660,16,63.6,0.79
CpG: 26,chr8,70131302,70131543,241,26,152,21.6,63.1,1.1
CpG: 44,chr8,70139216,70139902,686,44,387,12.8,56.4,0.81
CpG: 24,chr8,70158499,70158732,233,24,170,20.6,73,0.79
CpG: 80,chr8,70211803,70212835,1032,80,619,15.5,60,0.87
CpG: 77,chr8,70234018,70234831,813,77,526,18.9,64.7,0.91
CpG: 46,chr8,70283085,70283514,429,46,306,21.4,71.3,0.87
CpG: 52,chr8,70302335,70302963,628,52,366,16.6,58.3,0.98
CpG: 46,chr8,70315714,70316080,366,46,272,25.1,74.3,0.92
CpG: 24,chr8,70330039,70330276,237,24,167,20.3,70.5,0.84
CpG: 122,chr8,70330649,70332330,1681,122,1010,14.5,60.1,0.8
CpG: 100,chr8,70352720,70353547,827,100,510,24.2,61.7,1.28
CpG: 24,chr8,70373407,70373656,249,24,179,19.3,71.9,0.75
CpG: 82,chr8,70374473,70375385,912,82,628,18,68.9,0.77
CpG: 46,chr8,70376210,70376766,556,46,361,16.5,64.9,0.79
CpG: 65,chr8,70439316,70439828,512,65,326,25.4,63.7,1.25
CpG: 88,chr8,70451676,70452679,1003,88,652,17.5,65,0.83
CpG: 40,chr8,70476609,70477065,456,40,295,17.5,64.7,0.84
CpG: 29,chr8,70487170,70487507,337,29,226,17.2,67.1,0.8
CpG: 43,chr8,70488357,70488752,395,43,291,21.8,73.7,0.8
CpG: 34,chr8,70489481,70489899,418,34,249,16.3,59.6,0.93
CpG: 100,chr8,70493113,70494351,1238,100,810,16.2,65.4,0.76
CpG: 32,chr8,70500889,70501273,384,32,253,16.7,65.9,0.78
CpG: 25,chr8,70503243,70503455,212,25,130,23.6,61.3,1.27
CpG: 27,chr8,70505755,70506064,309,27,196,17.5,63.4,0.87
CpG: 31,chr8,70506489,70506822,333,31,227,18.6,68.2,0.81
CpG: 81,chr8,70510148,70510819,671,81,448,24.1,66.8,1.09
CpG: 44,chr8,70522812,70523264,452,44,296,19.5,65.5,0.92
CpG: 49,chr8,70527627,70528068,441,49,305,22.2,69.2,1
CpG: 88,chr8,70538691,70539934,1243,88,704,14.2,56.6,0.95
CpG: 100,chr8,70594347,70595521,1174,100,753,17,64.1,0.83
CpG: 92,chr8,70597633,70598726,1093,92,722,16.8,66.1,0.77
CpG: 25,chr8,70601286,70601573,287,25,199,17.4,69.3,0.73
CpG: 54,chr8,70608057,70608424,367,54,250,29.4,68.1,1.3
CpG: 53,chr8,70609252,70609854,602,53,413,17.6,68.6,0.75
CpG: 48,chr8,70611159,70611804,645,48,399,14.9,61.9,0.78
CpG: 50,chr8,70629690,70630158,468,50,323,21.4,69,0.9
CpG: 43,chr8,70659438,70659854,416,43,267,20.7,64.2,1.05
CpG: 62,chr8,70673057,70673706,649,62,394,19.1,60.7,1.05
CpG: 23,chr8,70696589,70696815,226,23,168,20.4,74.3,0.74
CpG: 184,chr8,70698678,70700406,1728,184,1120,21.3,64.8,1.01
CpG: 18,chr8,70716816,70717020,204,18,129,17.6,63.2,0.88
CpG: 25,chr8,70730092,70730299,207,25,146,24.2,70.5,0.98
CpG: 31,chr8,70743137,70743596,459,31,303,13.5,66,0.62
CpG: 41,chr8,70744012,70744591,579,41,338,14.2,58.4,0.83
CpG: 36,chr8,70754903,70755261,358,36,233,20.1,65.1,0.97
CpG: 63,chr8,70760658,70761250,592,63,399,21.3,67.4,0.96
CpG: 34,chr8,70768452,70768902,450,34,297,15.1,66,0.71
CpG: 23,chr8,70769497,70769750,253,23,156,18.2,61.7,0.96
CpG: 104,chr8,70776272,70777405,1133,104,698,18.4,61.6,0.97
CpG: 23,chr8,70787693,70787998,305,23,192,15.1,63,0.76
CpG: 58,chr8,70792150,70792731,581,58,400,20,68.8,0.85
CpG: 93,chr8,70796816,70797959,1143,93,732,16.3,64,0.82
CpG: 30,chr8,70803885,70804182,297,30,208,20.2,70,0.87
CpG: 35,chr8,70804812,70805189,377,35,259,18.6,68.7,0.82
CpG: 24,chr8,70816820,70817029,209,24,141,23,67.5,1.02
CpG: 67,chr8,70839006,70839676,670,67,386,20,57.6,1.21
CpG: 22,chr8,70842583,70842831,248,22,163,17.7,65.7,0.84
CpG: 38,chr8,70852629,70853049,420,38,267,18.1,63.6,0.9
CpG: 26,chr8,70856757,70857020,263,26,186,19.8,70.7,0.85
CpG: 33,chr8,70862981,70863240,259,33,185,25.5,71.4,1
CpG: 42,chr8,70865461,70865953,492,42,330,17.1,67.1,0.77
CpG: 46,chr8,70868449,70869092,643,46,410,14.3,63.8,0.71
CpG: 38,chr8,70873273,70873557,284,38,203,26.8,71.5,1.11
CpG: 78,chr8,70892117,70892887,770,78,535,20.3,69.5,0.84
CpG: 58,chr8,70897102,70897671,569,58,357,20.4,62.7,1.04
CpG: 67,chr8,70905909,70906644,735,67,463,18.2,63,0.95
CpG: 122,chr8,70912997,70914749,1752,122,1141,13.9,65.1,0.66
CpG: 83,chr8,71272287,71273128,841,83,570,19.7,67.8,0.88
CpG: 54,chr8,71366819,71367477,658,54,372,16.4,56.5,1.03
CpG: 76,chr8,71371267,71371913,646,76,464,23.5,71.8,0.91
CpG: 67,chr8,71375735,71376272,537,67,388,25,72.3,0.96
CpG: 223,chr8,71380292,71382483,2191,223,1433,20.4,65.4,0.95
CpG: 25,chr8,71396856,71397145,289,25,179,17.3,61.9,0.9
CpG: 50,chr8,71405903,71406421,518,50,355,19.3,68.5,0.85
CpG: 43,chr8,71461441,71461908,467,43,316,18.4,67.7,0.81
CpG: 55,chr8,71463107,71463773,666,55,441,16.5,66.2,0.75
CpG: 31,chr8,71465316,71465587,271,31,174,22.9,64.2,1.12
CpG: 72,chr8,71468951,71469712,761,72,480,18.9,63.1,0.96
CpG: 71,chr8,71476154,71476766,612,71,405,23.2,66.2,1.07
CpG: 51,chr8,71481002,71481718,716,51,467,14.2,65.2,0.68
CpG: 46,chr8,71485560,71486027,467,46,337,19.7,72.2,0.77
CpG: 20,chr8,71487781,71487990,209,20,137,19.1,65.6,0.9
CpG: 67,chr8,71488690,71489496,806,67,523,16.6,64.9,0.8
CpG: 63,chr8,71507583,71508070,487,63,337,25.9,69.2,1.09
CpG: 19,chr8,71511517,71511749,232,19,146,16.4,62.9,0.85
CpG: 35,chr8,71525485,71525831,346,35,245,20.2,70.8,0.81
CpG: 53,chr8,71542724,71543287,563,53,362,18.8,64.3,0.92
CpG: 54,chr8,71558500,71558973,473,54,329,22.8,69.6,0.95
CpG: 49,chr8,71562620,71563060,440,49,309,22.3,70.2,0.91
CpG: 35,chr8,71569574,71569964,390,35,260,17.9,66.7,0.86
CpG: 31,chr8,71570537,71570879,342,31,221,18.1,64.6,0.93
CpG: 64,chr8,71584163,71584979,816,64,487,15.7,59.7,0.88
CpG: 118,chr8,71591659,71592806,1147,118,771,20.6,67.2,0.91
CpG: 27,chr8,71595909,71596248,339,27,226,15.9,66.7,0.72
CpG: 82,chr8,71602124,71602943,819,82,566,20,69.1,0.85
CpG: 71,chr8,71610934,71611551,617,71,398,23,64.5,1.11
CpG: 78,chr8,71629015,71629838,823,78,563,19,68.4,0.81
CpG: 29,chr8,71654762,71655118,356,29,223,16.3,62.6,0.84
CpG: 18,chr8,71660405,71660645,240,18,154,15,64.2,0.73
CpG: 72,chr8,71671037,71671843,806,72,520,17.9,64.5,0.86
CpG: 24,chr8,71676484,71676691,207,24,147,23.2,71,0.95
CpG: 37,chr8,71679575,71679972,397,37,269,18.6,67.8,0.83
CpG: 37,chr8,71685723,71686100,377,37,246,19.6,65.3,0.93
CpG: 38,chr8,71689146,71689501,355,38,253,21.4,71.3,0.84
CpG: 96,chr8,71692674,71693743,1069,96,676,18,63.2,0.9
CpG: 25,chr8,71701450,71701763,313,25,199,16,63.6,0.79
CpG: 18,chr8,71709582,71709821,239,18,157,15.1,65.7,0.7
CpG: 30,chr8,71725501,71725746,245,30,160,24.5,65.3,1.16
CpG: 34,chr8,71881998,71882357,359,34,251,18.9,69.9,0.78
CpG: 24,chr8,71908671,71908878,207,24,145,23.2,70,0.97
CpG: 49,chr8,71922618,71923202,584,49,375,16.8,64.2,0.82
CpG: 29,chr8,71950999,71951295,296,29,192,19.6,64.9,0.94
CpG: 76,chr8,72135056,72135839,783,76,496,19.4,63.3,0.97
CpG: 89,chr8,72160616,72161662,1046,89,677,17,64.7,0.81
CpG: 30,chr8,72219675,72220062,387,30,245,15.5,63.3,0.78
CpG: 52,chr8,72240014,72240639,625,52,405,16.6,64.8,0.8
CpG: 151,chr8,72318722,72320158,1436,151,976,21,68,0.91
CpG: 108,chr8,72420844,72421816,972,108,659,22.2,67.8,0.97
CpG: 21,chr8,72443637,72443880,243,21,147,17.3,60.5,0.95
CpG: 89,chr8,72474708,72475526,818,89,537,21.8,65.6,1.01
CpG: 122,chr8,72492029,72493050,1021,122,614,23.9,60.1,1.32
CpG: 139,chr8,72547480,72549064,1584,139,1022,17.6,64.5,0.85
CpG: 41,chr8,72570733,72571328,595,41,357,13.8,60,0.78
CpG: 27,chr8,72571909,72572179,270,27,195,20,72.2,0.77
CpG: 78,chr8,72723216,72724007,791,78,530,19.7,67,0.9
CpG: 34,chr8,72749742,72750221,479,34,295,14.2,61.6,0.75
CpG: 124,chr8,73352585,73353911,1326,124,857,18.7,64.6,0.9
CpG: 99,chr8,74993552,74994386,834,99,555,23.7,66.5,1.09
CpG: 74,chr8,75033535,75034344,809,74,542,18.3,67,0.82
CpG: 25,chr8,75093516,75093779,263,25,173,19,65.8,0.88
CpG: 55,chr8,75109308,75109911,603,55,369,18.2,61.2,0.97
CpG: 140,chr8,75212788,75214068,1280,140,918,21.9,71.7,0.85
CpG: 107,chr8,76899273,76900752,1479,107,955,14.5,64.6,0.69
CpG: 25,chr8,76901937,76902270,333,25,217,15,65.2,0.71
CpG: 24,chr8,77185913,77186165,252,24,162,19,64.3,0.93
CpG: 104,chr8,77517280,77518435,1155,104,728,18,63,0.91
CpG: 26,chr8,77549333,77549559,226,26,154,23,68.1,0.99
CpG: 27,chr8,77610288,77610521,233,27,155,23.2,66.5,1.05
CpG: 80,chr8,78434795,78435860,1065,80,643,15,60.4,0.83
CpG: 23,chr8,78436275,78436480,205,23,140,22.4,68.3,0.96
CpG: 17,chr8,78437220,78437434,214,17,141,15.9,65.9,0.74
CpG: 143,chr8,78508509,78509789,1280,143,863,22.3,67.4,0.98
CpG: 69,chr8,78820728,78821247,519,69,358,26.6,69,1.14
CpG: 121,chr8,79029491,79030831,1340,121,805,18.1,60.1,1
CpG: 16,chr8,79112564,79112771,207,16,137,15.5,66.2,0.95
CpG: 88,chr8,79294468,79295312,844,88,585,20.9,69.3,0.89
CpG: 143,chr8,79398355,79399582,1227,143,833,23.3,67.9,1.02
CpG: 165,chr8,79639005,79640293,1288,165,900,25.6,69.9,1.05
CpG: 67,chr8,79711304,79711930,626,67,402,21.4,64.2,1.04
CpG: 16,chr8,80057402,80057629,227,16,147,14.1,64.8,0.67
CpG: 40,chr8,80057894,80058292,398,40,266,20.1,66.8,0.91
CpG: 20,chr8,80611267,80611526,259,20,158,15.4,61,0.83
CpG: 163,chr8,80738420,80739970,1550,163,990,21,63.9,1.03
CpG: 110,chr8,80879375,80880327,952,110,651,23.1,68.4,0.99
CpG: 114,chr8,81013964,81015321,1357,114,882,16.8,65,0.8
CpG: 20,chr8,81342430,81342678,248,20,156,16.1,62.9,0.86
CpG: 36,chr8,82773946,82774236,290,36,204,24.8,70.3,1.01
CpG: 108,chr8,82863440,82864570,1130,108,716,19.1,63.4,0.95
CpG: 103,chr8,83165436,83166277,841,103,606,24.5,72.1,0.94
CpG: 89,chr8,83331925,83332719,794,89,538,22.4,67.8,0.98
CpG: 38,chr8,83389732,83390052,320,38,230,23.8,71.9,0.92
CpG: 53,chr8,83442189,83442750,561,53,325,18.9,57.9,1.13
CpG: 42,chr8,83566632,83567128,496,42,324,16.9,65.3,0.8
CpG: 28,chr8,83594398,83594751,353,28,225,15.9,63.7,0.82
CpG: 110,chr8,83607918,83608812,894,110,623,24.6,69.7,1.03
CpG: 21,chr8,83622351,83622570,219,21,140,19.2,63.9,0.98
CpG: 44,chr8,83652550,83652856,306,44,236,28.8,77.1,0.98
CpG: 74,chr8,83668050,83668778,728,74,490,20.3,67.3,0.9
CpG: 76,chr8,83698531,83699339,808,76,524,18.8,64.9,0.9
CpG: 80,chr8,83714989,83715807,818,80,524,19.6,64.1,0.96
CpG: 33,chr8,83741016,83741325,309,33,216,21.4,69.9,0.87
CpG: 54,chr8,83874963,83875442,479,54,341,22.5,71.2,0.89
CpG: 176,chr8,83899680,83901247,1567,176,1083,22.5,69.1,0.94
CpG: 87,chr8,83955192,83956192,1000,87,622,17.4,62.2,0.9
CpG: 81,chr8,83972341,83973054,713,81,526,22.7,73.8,0.84
CpG: 53,chr8,84001296,84001819,523,53,361,20.3,69,0.85
CpG: 149,chr8,84011133,84012756,1623,149,1070,18.4,65.9,0.86
CpG: 17,chr8,84021184,84021386,202,17,136,16.8,67.3,0.74
CpG: 37,chr8,84025969,84026267,298,37,225,24.8,75.5,0.87
CpG: 28,chr8,84042309,84042653,344,28,231,16.3,67.2,0.73
CpG: 118,chr8,84066136,84067467,1331,118,799,17.7,60,0.99
CpG: 21,chr8,84094740,84094996,256,21,166,16.4,64.8,0.79
CpG: 36,chr8,84130718,84131147,429,36,286,16.8,66.7,0.76
CpG: 34,chr8,84147767,84148115,348,34,223,19.5,64.1,0.96
CpG: 65,chr8,84183592,84184188,596,65,364,21.8,61.1,1.17
CpG: 27,chr8,84192649,84192912,263,27,165,20.5,62.7,1.08
CpG: 35,chr8,84197390,84197864,474,35,303,14.8,63.9,0.72
CpG: 22,chr8,84198424,84198684,260,22,187,16.9,71.9,0.66
CpG: 31,chr8,84200884,84201108,224,31,169,27.7,75.4,0.98
CpG: 62,chr8,84236754,84237429,675,62,454,18.4,67.3,0.81
CpG: 42,chr8,84249341,84249831,490,42,301,17.1,61.4,0.92
CpG: 53,chr8,84256884,84257368,484,53,333,21.9,68.8,0.93
CpG: 24,chr8,84270235,84270462,227,24,157,21.1,69.2,0.92
CpG: 127,chr8,84414262,84415690,1428,127,833,17.8,58.3,1.05
CpG: 99,chr8,84559050,84559684,634,99,452,31.2,71.3,1.23
CpG: 19,chr8,84617076,84617329,253,19,169,15,66.8,0.68
CpG: 19,chr8,84638667,84638870,203,19,111,18.7,54.7,1.25
CpG: 83,chr8,84639334,84639944,610,83,395,27.2,64.8,1.3
CpG: 18,chr8,84656754,84656985,231,18,145,15.6,62.8,0.79
CpG: 90,chr8,84661923,84662867,944,90,614,19.1,65,0.9
CpG: 31,chr8,84663998,84664384,386,31,229,16.1,59.3,0.91
CpG: 72,chr8,84687265,84687954,689,72,464,20.9,67.3,0.95
CpG: 34,chr8,84689619,84689992,373,34,231,18.2,61.9,0.95
CpG: 24,chr8,84701557,84701900,343,24,231,14,67.3,0.62
CpG: 30,chr8,84703917,84704218,301,30,207,19.9,68.8,0.84
CpG: 52,chr8,84705336,84705936,600,52,386,17.3,64.3,0.91
CpG: 31,chr8,84706720,84707059,339,31,217,18.3,64,0.93
CpG: 21,chr8,84716109,84716367,258,21,158,16.3,61.2,0.88
CpG: 29,chr8,84771980,84772332,352,29,216,16.5,61.4,0.88
CpG: 70,chr8,84784221,84785041,820,70,529,17.1,64.5,0.82
CpG: 55,chr8,84799186,84799699,513,55,341,21.4,66.5,0.98
CpG: 26,chr8,84800463,84800685,222,26,127,23.4,57.2,1.43
CpG: 53,chr8,84832144,84832718,574,53,368,18.5,64.1,0.9
CpG: 53,chr8,84840252,84840735,483,53,348,21.9,72,0.85
CpG: 66,chr8,84846525,84847389,864,66,530,15.3,61.3,0.81
CpG: 31,chr8,84856898,84857223,325,31,208,19.1,64,0.94
CpG: 64,chr8,84872171,84872896,725,64,430,17.7,59.3,1.02
CpG: 88,chr8,84902673,84903623,950,88,651,18.5,68.5,0.79
CpG: 49,chr8,84908520,84909214,694,49,423,14.1,61,0.76
CpG: 79,chr8,84912537,84913446,909,79,580,17.4,63.8,0.87
CpG: 23,chr8,84923762,84924030,268,23,172,17.2,64.2,0.84
CpG: 43,chr8,84937020,84937486,466,43,308,18.5,66.1,0.86
CpG: 35,chr8,84945730,84946061,331,35,239,21.1,72.2,0.81
CpG: 34,chr8,84965826,84966156,330,34,208,20.6,63,1.07
CpG: 34,chr8,84969409,84969759,350,34,234,19.4,66.9,0.89
CpG: 215,chr8,84976171,84978911,2740,215,1751,15.7,63.9,0.77
CpG: 20,chr8,84980250,84980490,240,20,158,16.7,65.8,0.77
CpG: 41,chr8,84985945,84986282,337,41,231,24.3,68.5,1.05
CpG: 25,chr8,84990547,84990799,252,25,181,19.8,71.8,0.82
CpG: 30,chr8,85007611,85007956,345,30,235,17.4,68.1,0.75
CpG: 35,chr8,85011157,85011542,385,35,239,18.2,62.1,0.94
CpG: 57,chr8,85026824,85027385,561,57,369,20.3,65.8,0.95
CpG: 117,chr8,85036778,85038309,1531,117,969,15.3,63.3,0.81
CpG: 49,chr8,85060033,85060515,482,49,314,20.3,65.1,0.96
CpG: 59,chr8,85071668,85072136,468,59,330,25.2,70.5,1.01
CpG: 32,chr8,85080302,85080604,302,32,198,21.2,65.6,0.99
CpG: 24,chr8,85083242,85083513,271,24,176,17.7,64.9,0.86
CpG: 100,chr8,85299056,85300113,1057,100,690,18.9,65.3,0.89
CpG: 69,chr8,85432233,85432998,765,69,458,18,59.9,1.01
CpG: 64,chr8,85492530,85493216,686,64,476,18.7,69.4,0.79
CpG: 95,chr8,85554846,85555672,826,95,514,23,62.2,1.2
CpG: 132,chr8,85700142,85701055,913,132,671,28.9,73.5,1.07
CpG: 52,chr8,85840538,85840969,431,52,307,24.1,71.2,0.95
CpG: 41,chr8,86624084,86624579,495,41,318,16.6,64.2,0.8
CpG: 123,chr8,86745325,86746376,1051,123,653,23.4,62.1,1.21
CpG: 95,chr8,86884599,86885410,811,95,504,23.4,62.1,1.22
CpG: 39,chr8,87038039,87038387,348,39,243,22.4,69.8,0.92
CpG: 35,chr8,87468768,87469125,357,35,207,19.6,58,1.17
CpG: 71,chr8,87470092,87471082,990,71,595,14.3,60.1,0.8
CpG: 160,chr8,87472179,87473687,1508,160,1013,21.2,67.2,0.94
CpG: 34,chr8,87660170,87660672,502,34,313,13.5,62.4,0.7
CpG: 44,chr8,87662427,87663031,604,44,357,14.6,59.1,0.84
CpG: 34,chr8,87780764,87781212,448,34,280,15.2,62.5,0.78
CpG: 22,chr8,87783002,87783316,314,22,190,14,60.5,0.78
CpG: 40,chr8,87943718,87944082,364,40,269,22,73.9,0.8
CpG: 296,chr8,87958428,87962795,4367,296,2494,13.6,57.1,0.83
CpG: 42,chr8,88118705,88119069,364,42,249,23.1,68.4,1.03
CpG: 73,chr8,88137825,88138511,686,73,448,21.3,65.3,1
CpG: 143,chr8,88198983,88200575,1592,143,834,18,52.4,1.31
CpG: 56,chr8,88272328,88272854,526,56,381,21.3,72.4,0.82
CpG: 95,chr8,88361599,88362355,756,95,533,25.1,70.5,1.01
CpG: 63,chr8,88454053,88454653,600,63,395,21,65.8,0.98
CpG: 53,chr8,88521360,88521790,430,53,286,24.7,66.5,1.11
CpG: 120,chr8,88627098,88627914,816,120,586,29.4,71.8,1.14
CpG: 70,chr8,88696699,88697446,747,70,495,18.7,66.3,0.85
CpG: 32,chr8,89006472,89006769,297,32,199,21.5,67,0.96
CpG: 42,chr8,89025560,89025997,437,42,294,19.2,67.3,0.86
CpG: 261,chr8,89041007,89044345,3338,261,2046,15.6,61.3,0.83
CpG: 32,chr8,89045207,89045589,382,32,206,16.8,53.9,1.21
CpG: 57,chr8,90347708,90348205,497,57,316,22.9,63.6,1.14
CpG: 25,chr8,90828686,90828982,296,25,203,16.9,68.6,0.72
CpG: 172,chr8,90907807,90909447,1640,172,1145,21,69.8,0.86
CpG: 51,chr8,91069993,91070507,514,51,353,19.8,68.7,0.84
CpG: 64,chr8,91133433,91134222,789,64,514,16.2,65.1,0.77
CpG: 48,chr8,91313205,91313787,582,48,365,16.5,62.7,0.87
CpG: 30,chr8,91797677,91798046,369,30,233,16.3,63.1,0.87
CpG: 169,chr8,91799685,91801599,1914,169,1173,17.7,61.3,0.94
CpG: 27,chr8,91801867,91802202,335,27,201,16.1,60,0.92
CpG: 27,chr8,91805367,91805642,275,27,187,19.6,68,0.85
CpG: 396,chr8,92355697,92360826,5129,396,3113,15.4,60.7,0.84
CpG: 25,chr8,92365566,92365890,324,25,186,15.4,57.4,0.95
CpG: 87,chr8,92460296,92461079,783,87,477,22.2,60.9,1.21
CpG: 39,chr8,92674336,92674745,409,39,252,19.1,61.6,1.01
CpG: 27,chr8,92827455,92827748,293,27,200,18.4,68.3,0.8
CpG: 41,chr8,92855270,92855643,373,41,263,22,70.5,0.89
CpG: 78,chr8,92960407,92961414,1007,78,661,15.5,65.6,0.72
CpG: 74,chr8,93810660,93811516,856,74,550,17.3,64.3,0.85
CpG: 32,chr8,93813327,93813675,348,32,221,18.4,63.5,0.93
CpG: 117,chr8,94011645,94012946,1301,117,742,18,57,1.11
CpG: 49,chr8,94036620,94037114,494,49,314,19.8,63.6,0.99
CpG: 21,chr8,94037247,94037528,281,21,177,14.9,63,0.79
CpG: 48,chr8,94098143,94098649,506,48,337,19,66.6,0.87
CpG: 50,chr8,94172329,94172845,516,50,340,19.4,65.9,0.89
CpG: 50,chr8,94178896,94179555,659,50,375,15.2,56.9,0.94
CpG: 51,chr8,94214505,94215014,509,51,339,20,66.6,0.91
CpG: 62,chr8,94386178,94386763,585,62,401,21.2,68.5,0.91
CpG: 21,chr8,94434255,94434461,206,21,132,20.4,64.1,1
CpG: 107,chr8,94532638,94533630,992,107,701,21.6,70.7,0.87
CpG: 112,chr8,94601104,94602522,1418,112,864,15.8,60.9,0.85
CpG: 64,chr8,94666588,94667259,671,64,435,19.1,64.8,0.91
CpG: 51,chr8,94695825,94696316,491,51,335,20.8,68.2,0.9
CpG: 26,chr8,94772027,94772306,279,26,193,18.6,69.2,0.8
CpG: 73,chr8,94838022,94838678,656,73,431,22.3,65.7,1.03
CpG: 65,chr8,94857427,94858105,678,65,438,19.2,64.6,0.92
CpG: 29,chr8,94875947,94876296,349,29,198,16.6,56.7,1.03
CpG: 84,chr8,94913065,94913767,702,84,494,23.9,70.4,0.97
CpG: 77,chr8,94917495,94918246,751,77,549,20.5,73.1,0.77
CpG: 23,chr8,95080877,95081149,272,23,153,16.9,56.2,1.12
CpG: 16,chr8,95081355,95081577,222,16,149,14.4,67.1,0.74
CpG: 18,chr8,95320500,95320757,257,18,164,14,63.8,0.69
CpG: 94,chr8,95327810,95328933,1123,94,716,16.7,63.8,0.83
CpG: 88,chr8,95331537,95332497,960,88,566,18.3,59,1.06
CpG: 118,chr8,95352141,95353477,1336,118,876,17.7,65.6,0.82
CpG: 71,chr8,95434408,95435087,679,71,459,20.9,67.6,0.92
CpG: 44,chr8,95633469,95633889,420,44,288,21,68.6,0.9
CpG: 116,chr8,95677519,95678593,1074,116,739,21.6,68.8,0.92
CpG: 71,chr8,95715799,95716412,613,71,443,23.2,72.3,0.89
CpG: 142,chr8,95806617,95808138,1521,142,978,18.7,64.3,0.92
CpG: 27,chr8,95825368,95825583,215,27,143,25.1,66.5,1.14
CpG: 34,chr8,95888100,95888514,414,34,276,16.4,66.7,0.77
CpG: 16,chr8,95951941,95952150,209,16,120,15.3,57.4,0.94
CpG: 92,chr8,99415495,99416726,1231,92,760,14.9,61.7,0.79
CpG: 22,chr8,102784311,102784548,237,22,156,18.6,65.8,0.86
CpG: 32,chr8,102784878,102785094,216,32,166,29.6,76.9,1
CpG: 14,chr8,104003880,104004102,222,14,127,12.6,57.2,0.8
CpG: 30,chr8,104142503,104142861,358,30,223,16.8,62.3,0.87
CpG: 96,chr8,104170508,104171263,755,96,519,25.4,68.7,1.08
CpG: 24,chr8,104248401,104248625,224,24,164,21.4,73.2,0.81
CpG: 33,chr8,104250850,104251258,408,33,258,16.2,63.2,0.83
CpG: 59,chr8,104340504,104341223,719,59,482,16.4,67,0.73
CpG: 74,chr8,104395053,104395677,624,74,452,23.7,72.4,0.9
CpG: 66,chr8,104442425,104443062,637,66,421,20.7,66.1,0.96
CpG: 57,chr8,104509259,104509946,687,57,482,16.6,70.2,0.7
CpG: 69,chr8,104534090,104534709,619,69,434,22.3,70.1,0.91
CpG: 66,chr8,104540739,104541316,577,66,415,22.9,71.9,0.89
CpG: 31,chr8,104591497,104591834,337,31,223,18.4,66.2,0.87
CpG: 36,chr8,104630590,104630965,375,36,258,19.2,68.8,0.81
CpG: 61,chr8,104641440,104642058,618,61,390,19.7,63.1,1
CpG: 116,chr8,105170768,105171773,1005,116,662,23.1,65.9,1.07
CpG: 30,chr8,105212365,105212828,463,30,277,13,59.8,0.84
CpG: 37,chr8,105225067,105225417,350,37,239,21.1,68.3,0.91
CpG: 67,chr8,105254203,105254735,532,67,376,25.2,70.7,1.01
CpG: 74,chr8,105258995,105259938,943,74,601,15.7,63.7,0.78
CpG: 34,chr8,105264400,105264676,276,34,196,24.6,71,1
CpG: 141,chr8,105268112,105269996,1884,141,1191,15,63.2,0.75
CpG: 19,chr8,105276317,105276537,220,19,148,17.3,67.3,0.83
CpG: 19,chr8,105278919,105279154,235,19,148,16.2,63,0.82
CpG: 100,chr8,105289380,105290588,1208,100,756,16.6,62.6,0.85
CpG: 19,chr8,105293309,105293568,259,19,176,14.7,68,0.64
CpG: 37,chr8,105297551,105297981,430,37,257,17.2,59.8,0.97
CpG: 49,chr8,105326034,105326674,640,49,400,15.3,62.5,0.79
CpG: 50,chr8,105347550,105348165,615,50,405,16.3,65.9,0.75
CpG: 60,chr8,105348746,105349672,926,60,537,13,58,0.79
CpG: 44,chr8,105374604,105375144,540,44,359,16.3,66.5,0.75
CpG: 18,chr8,105471364,105471606,242,18,159,14.9,65.7,0.71
CpG: 63,chr8,105496576,105497165,589,63,416,21.4,70.6,0.86
CpG: 64,chr8,105518522,105519317,795,64,513,16.1,64.5,0.77
CpG: 107,chr8,105565511,105566920,1409,107,852,15.2,60.5,0.83
CpG: 49,chr8,105605286,105605677,391,49,270,25.1,69.1,1.06
CpG: 52,chr8,105613932,105614532,600,52,424,17.3,70.7,0.7
CpG: 166,chr8,105635930,105637598,1668,166,1049,19.9,62.9,1.01
CpG: 33,chr8,105693814,105694212,398,33,217,16.6,54.5,1.13
CpG: 77,chr8,105700706,105701789,1083,77,645,14.2,59.6,0.8
CpG: 19,chr8,105704320,105704586,266,19,168,14.3,63.2,0.72
CpG: 49,chr8,105707564,105708145,581,49,400,16.9,68.8,0.72
CpG: 52,chr8,105758221,105758724,503,52,344,20.7,68.4,0.88
CpG: 24,chr8,105851852,105852064,212,24,128,22.6,60.4,1.28
CpG: 111,chr8,105854780,105855955,1175,111,712,18.9,60.6,1.03
CpG: 63,chr8,105860461,105861139,678,63,462,18.6,68.1,0.8
CpG: 39,chr8,105880834,105881279,445,39,275,17.5,61.8,0.97
CpG: 64,chr8,105900295,105900883,588,64,417,21.8,70.9,0.87
CpG: 66,chr8,105965642,105966133,491,66,359,26.9,73.1,1.02
CpG: 34,chr8,105979058,105979549,491,34,313,13.8,63.7,0.69
CpG: 64,chr8,106010908,106011533,625,64,415,20.5,66.4,0.93
CpG: 73,chr8,106059663,106060215,552,73,393,26.4,71.2,1.05
CpG: 97,chr8,106135915,106137136,1221,97,780,15.9,63.9,0.78
CpG: 26,chr8,106150229,106150527,298,26,187,17.4,62.8,0.9
CpG: 18,chr8,106162956,106163199,243,18,141,14.8,58,0.88
CpG: 74,chr8,106168691,106169168,477,74,362,31,75.9,1.12
CpG: 104,chr8,106210478,106211520,1042,104,676,20,64.9,0.95
CpG: 41,chr8,106336590,106336927,337,41,234,24.3,69.4,1.03
CpG: 35,chr8,106337820,106338110,290,35,207,24.1,71.4,0.95
CpG: 31,chr8,106415255,106415558,303,31,201,20.5,66.3,0.95
CpG: 20,chr8,106507742,106507966,224,20,136,17.9,60.7,0.97
CpG: 26,chr8,106511382,106511698,316,26,199,16.5,63,0.83
CpG: 63,chr8,106603293,106604024,731,63,484,17.2,66.2,0.8
CpG: 45,chr8,106683002,106683506,504,45,339,17.9,67.3,0.79
CpG: 49,chr8,106870633,106871037,404,49,298,24.3,73.8,0.89
CpG: 77,chr8,106893008,106893910,902,77,481,17.1,53.3,1.22
CpG: 129,chr8,106935415,106936740,1325,129,873,19.5,65.9,0.9
CpG: 102,chr8,107030970,107031935,965,102,707,21.1,73.3,0.81
CpG: 20,chr8,107038001,107038204,203,20,133,19.7,65.5,0.93
CpG: 84,chr8,107048039,107048802,763,84,519,22,68,0.96
CpG: 117,chr8,107056191,107057333,1142,117,742,20.5,65,0.97
CpG: 72,chr8,107095951,107096597,646,72,434,22.3,67.2,1.02
CpG: 55,chr8,107150513,107151011,498,55,335,22.1,67.3,1.01
CpG: 121,chr8,107293307,107294520,1213,121,835,20,68.8,0.84
CpG: 50,chr8,107424614,107425192,578,50,376,17.3,65.1,0.83
CpG: 29,chr8,107436200,107436435,235,29,167,24.7,71.1,0.98
CpG: 24,chr8,107439236,107439539,303,24,174,15.8,57.4,0.96
CpG: 65,chr8,107587938,107588529,591,65,411,22,69.5,0.92
CpG: 21,chr8,108175167,108175431,264,21,139,15.9,52.7,1.17
CpG: 50,chr8,108704636,108705080,444,50,302,22.5,68,0.98
CpG: 89,chr8,108714467,108715379,912,89,611,19.5,67,0.87
CpG: 37,chr8,108792263,108792751,488,37,333,15.2,68.2,0.65
CpG: 17,chr8,108800198,108800410,212,17,133,16,62.7,0.82
CpG: 23,chr8,108947087,108947425,338,23,216,13.6,63.9,0.67
CpG: 24,chr8,108950159,108950467,308,24,185,15.6,60.1,0.87
CpG: 26,chr8,108950855,108951192,337,26,195,15.4,57.9,0.92
CpG: 38,chr8,108956572,108957024,452,38,280,16.8,61.9,0.93
CpG: 20,chr8,109340687,109340906,219,20,137,18.3,62.6,0.95
CpG: 51,chr8,109565415,109565990,575,51,340,17.7,59.1,1.02
CpG: 32,chr8,109608458,109608786,328,32,207,19.5,63.1,0.98
CpG: 77,chr8,109692751,109693740,989,77,604,15.6,61.1,0.84
CpG: 77,chr8,109705340,109705943,603,77,407,25.5,67.5,1.13
CpG: 22,chr8,109724140,109724419,279,22,169,15.8,60.6,0.88
CpG: 48,chr8,109737281,109737877,596,48,387,16.1,64.9,0.77
CpG: 90,chr8,109778522,109779359,837,90,585,21.5,69.9,0.88
CpG: 93,chr8,109868437,109869279,842,93,562,22.1,66.7,0.99
CpG: 34,chr8,109948109,109948586,477,34,291,14.3,61,0.77
CpG: 63,chr8,109961725,109962289,564,63,393,22.3,69.7,0.92
CpG: 43,chr8,110079697,110080128,431,43,293,20,68,0.88
CpG: 29,chr8,110168125,110168328,203,29,147,28.6,72.4,1.09
CpG: 44,chr8,110217678,110218128,450,44,302,19.6,67.1,0.88
CpG: 17,chr8,110365437,110365643,206,17,126,16.5,61.2,0.88
CpG: 46,chr8,110618519,110619079,560,46,315,16.4,56.2,1.04
CpG: 33,chr8,110721293,110721532,239,33,180,27.6,75.3,1.04
CpG: 18,chr8,110738399,110738616,217,18,159,16.6,73.3,0.7
CpG: 26,chr8,110738782,110739099,317,26,221,16.4,69.7,0.68
CpG: 29,chr8,110846500,110846804,304,29,193,19.1,63.5,0.97
CpG: 22,chr8,110846996,110847291,295,22,185,14.9,62.7,0.77
CpG: 22,chr8,110902334,110902546,212,22,141,20.8,66.5,0.95
CpG: 41,chr8,110919886,110920296,410,41,278,20,67.8,0.89
CpG: 31,chr8,110970106,110970478,372,31,230,16.7,61.8,0.87
CpG: 45,chr8,110997501,110997883,382,45,255,23.6,66.8,1.09
CpG: 26,chr8,111027645,111027897,252,26,169,20.6,67.1,0.92
CpG: 25,chr8,111033836,111034144,308,25,204,16.2,66.2,0.77
CpG: 136,chr8,111056217,111057295,1078,136,780,25.2,72.4,0.96
CpG: 100,chr8,111094313,111095040,727,100,510,27.5,70.2,1.12
CpG: 105,chr8,111145224,111146010,786,105,590,26.7,75.1,0.95
CpG: 83,chr8,111258374,111259381,1007,83,605,16.5,60.1,0.91
CpG: 87,chr8,111299505,111300477,972,87,583,17.9,60,1.01
CpG: 23,chr8,111337878,111338111,233,23,149,19.7,63.9,0.99
CpG: 61,chr8,111393455,111393988,533,61,394,22.9,73.9,0.84
CpG: 129,chr8,111536202,111537629,1427,129,872,18.1,61.1,0.97
CpG: 67,chr8,111643371,111643976,605,67,420,22.1,69.4,0.92
CpG: 67,chr8,111731736,111732325,589,67,398,22.8,67.6,1.01
CpG: 60,chr8,111743475,111743973,498,60,375,24.1,75.3,0.87
CpG: 60,chr8,111853762,111854484,722,60,449,16.6,62.2,0.86
CpG: 51,chr8,111876410,111876854,444,51,314,23,70.7,0.92
CpG: 84,chr8,111889938,111890869,931,84,594,18,63.8,0.89
CpG: 23,chr8,111910100,111910333,233,23,174,19.7,74.7,0.71
CpG: 49,chr8,111933341,111933810,469,49,329,20.9,70.1,0.86
CpG: 76,chr8,111940594,111941295,701,76,478,21.7,68.2,0.93
CpG: 26,chr8,111992147,111992408,261,26,166,19.9,63.6,1.01
CpG: 89,chr8,112011357,112012214,857,89,573,20.8,66.9,0.93
CpG: 44,chr8,113635237,113635799,562,44,332,15.7,59.1,0.9
CpG: 69,chr8,113848188,113848854,666,69,466,20.7,70,0.85
CpG: 41,chr8,114205538,114205995,457,41,290,17.9,63.5,0.89
CpG: 49,chr8,114439551,114440094,543,49,367,18,67.6,0.79
CpG: 17,chr8,114521841,114522070,229,17,139,14.8,60.7,0.81
CpG: 155,chr8,115705738,115707525,1787,155,1026,17.3,57.4,1.05
CpG: 17,chr8,115708035,115708273,238,17,154,14.3,64.7,0.68
CpG: 19,chr8,116624065,116624309,244,19,150,15.6,61.5,0.82
CpG: 34,chr8,116732295,116732622,327,34,209,20.8,63.9,1.03
CpG: 35,chr8,116733196,116733515,319,35,189,21.9,59.2,1.26
CpG: 20,chr8,116863490,116863709,219,20,149,18.3,68,0.79
CpG: 76,chr8,116921124,116922036,912,76,583,16.7,63.9,0.82
CpG: 64,chr8,116943452,116944047,595,64,398,21.5,66.9,0.96
CpG: 45,chr8,116978661,116979149,488,45,325,18.4,66.6,0.83
CpG: 52,chr8,116993059,116993625,566,52,378,18.4,66.8,0.83
CpG: 114,chr8,117157620,117158649,1029,114,637,22.2,61.9,1.17
CpG: 26,chr8,117436558,117436900,342,26,224,15.2,65.5,0.71
CpG: 62,chr8,117498196,117498881,685,62,485,18.1,70.8,0.73
CpG: 16,chr8,117590119,117590320,201,16,125,15.9,62.2,0.84
CpG: 58,chr8,117801706,117802285,579,58,379,20,65.5,0.94
CpG: 70,chr8,118283568,118284585,1017,70,603,13.8,59.3,0.78
CpG: 37,chr8,119344460,119344778,318,37,225,23.3,70.8,0.93
CpG: 105,chr8,119394549,119395469,920,105,630,22.8,68.5,0.98
CpG: 80,chr8,119446598,119447443,845,80,539,18.9,63.8,0.93
CpG: 20,chr8,119447647,119447894,247,20,163,16.2,66,0.87
CpG: 81,chr8,119558397,119558932,535,81,382,30.3,71.4,1.2
CpG: 91,chr8,119574408,119575505,1097,91,627,16.6,57.2,1.01
CpG: 21,chr8,119605020,119605289,269,21,166,15.6,61.7,0.86
CpG: 25,chr8,119612563,119612847,284,25,181,17.6,63.7,0.87
CpG: 23,chr8,119626069,119626355,286,23,178,16.1,62.2,0.83
CpG: 35,chr8,119632939,119633397,458,35,302,15.3,65.9,0.71
CpG: 21,chr8,119699911,119700134,223,21,172,18.8,77.1,0.64
CpG: 20,chr8,119768197,119768451,254,20,164,15.7,64.6,0.76
CpG: 61,chr8,119840183,119840679,496,61,332,24.6,66.9,1.1
CpG: 36,chr8,119862194,119862489,295,36,220,24.4,74.6,0.88
CpG: 33,chr8,119870213,119870676,463,33,297,14.3,64.1,0.69
CpG: 21,chr8,119876356,119876641,285,21,185,14.7,64.9,0.71
CpG: 110,chr8,119910682,119911497,815,110,600,27,73.6,1
CpG: 34,chr8,119956604,119957060,456,34,276,14.9,60.5,0.82
CpG: 22,chr8,119992170,119992439,269,22,170,16.4,63.2,0.82
CpG: 92,chr8,120100983,120101870,887,92,580,20.7,65.4,0.98
CpG: 113,chr8,120113643,120114695,1052,113,707,21.5,67.2,0.96
CpG: 140,chr8,120228798,120230336,1538,140,967,18.2,62.9,0.92
CpG: 23,chr8,120399590,120399842,252,23,159,18.3,63.1,0.94
CpG: 26,chr8,120449898,120450261,363,26,188,14.3,51.8,1.07
CpG: 175,chr8,120487474,120489709,2235,175,1272,15.7,56.9,0.97
CpG: 17,chr8,120505150,120505361,211,17,128,16.1,60.7,0.88
CpG: 235,chr8,120535770,120538261,2491,235,1632,18.9,65.5,0.89
CpG: 18,chr8,120538682,120538922,240,18,166,15,69.2,0.63
CpG: 22,chr8,120577725,120578023,298,22,169,14.8,56.7,0.92
CpG: 61,chr8,120588874,120589537,663,61,430,18.4,64.9,0.94
CpG: 79,chr8,120633711,120634631,920,79,599,17.2,65.1,0.82
CpG: 136,chr8,120667661,120668809,1148,136,774,23.7,67.4,1.04
CpG: 53,chr8,120736000,120736485,485,53,334,21.9,68.9,0.92
CpG: 30,chr8,121073543,121073839,296,30,206,20.3,69.6,0.85
CpG: 36,chr8,121080734,121080988,254,36,184,28.3,72.4,1.08
CpG: 245,chr8,121082684,121085236,2552,245,1618,19.2,63.4,0.95
CpG: 31,chr8,121089351,121089790,439,31,292,14.1,66.5,0.64
CpG: 60,chr8,121108015,121108587,572,60,379,21,66.3,0.97
CpG: 225,chr8,121116212,121118193,1981,225,1373,22.7,69.3,0.95
CpG: 33,chr8,121125381,121125828,447,33,284,14.8,63.5,0.73
CpG: 121,chr8,121127839,121129274,1435,121,954,16.9,66.5,0.77
CpG: 21,chr8,121273037,121273282,245,21,153,17.1,62.4,0.89
CpG: 15,chr8,121468776,121468983,207,15,131,14.5,63.3,0.72
CpG: 30,chr8,121554060,121554449,389,30,260,15.4,66.8,0.69
CpG: 66,chr8,121578450,121579129,679,66,432,19.4,63.6,1
CpG: 39,chr8,121585276,121585701,425,39,269,18.4,63.3,0.92
CpG: 87,chr8,121590237,121590909,672,87,486,25.9,72.3,0.99
CpG: 171,chr8,121651371,121653286,1915,171,1076,17.9,56.2,1.13
CpG: 113,chr8,121729826,121730997,1171,113,666,19.3,56.9,1.19
CpG: 67,chr8,121752998,121753739,741,67,482,18.1,65,0.86
CpG: 20,chr8,121784791,121785017,226,20,161,17.7,71.2,0.7
CpG: 60,chr8,121829172,121829710,538,60,355,22.3,66,1.03
CpG: 117,chr8,121906790,121908048,1258,117,757,18.6,60.2,1.03
CpG: 88,chr8,121950374,121951234,860,88,484,20.5,56.3,1.3
CpG: 86,chr8,122230165,122230956,791,86,524,21.7,66.2,1
CpG: 27,chr8,122269156,122269528,372,27,238,14.5,64,0.71
CpG: 19,chr8,122281252,122281509,257,19,178,14.8,69.3,0.73
CpG: 61,chr8,122281748,122282240,492,61,355,24.8,72.2,1.04
CpG: 21,chr8,122282660,122282861,201,21,149,20.9,74.1,0.76
CpG: 31,chr8,122284239,122284653,414,31,262,15,63.3,0.75
CpG: 152,chr8,122335818,122337183,1365,152,935,22.3,68.5,0.97
CpG: 91,chr8,122376387,122377141,754,91,486,24.1,64.5,1.16
CpG: 34,chr8,122432595,122432969,374,34,266,18.2,71.1,0.75
CpG: 34,chr8,122443405,122443853,448,34,271,15.2,60.5,0.83
CpG: 110,chr8,122550733,122551714,981,110,652,22.4,66.5,1.03
CpG: 80,chr8,122567678,122568383,705,80,478,22.7,67.8,0.99
CpG: 51,chr8,122576478,122576995,517,51,344,19.7,66.5,0.92
CpG: 25,chr8,122611817,122612047,230,25,151,21.7,65.7,1.05
CpG: 22,chr8,122630710,122630962,252,22,177,17.5,70.2,0.71
CpG: 129,chr8,122677783,122678923,1140,129,728,22.6,63.9,1.11
CpG: 42,chr8,122775376,122775877,501,42,316,16.8,63.1,0.84
CpG: 20,chr8,122864937,122865178,241,20,158,16.6,65.6,0.77
CpG: 35,chr8,122870474,122870956,482,35,307,14.5,63.7,0.74
CpG: 195,chr8,123041287,123042967,1680,195,1151,23.2,68.5,1
CpG: 69,chr8,123065281,123065881,600,69,403,23,67.2,1.02
CpG: 73,chr8,123102219,123102897,678,73,455,21.5,67.1,0.96
CpG: 40,chr8,123117316,123117626,310,40,232,25.8,74.8,0.93
CpG: 25,chr8,123206517,123206756,239,25,147,20.9,61.5,1.11
CpG: 70,chr8,123212424,123213077,653,70,433,21.4,66.3,0.99
CpG: 47,chr8,123224770,123225220,450,47,299,20.9,66.4,0.98
CpG: 25,chr8,123235591,123235800,209,25,147,23.9,70.3,0.97
CpG: 18,chr8,123236124,123236335,211,18,142,17.1,67.3,0.77
CpG: 104,chr8,123253814,123254955,1141,104,659,18.2,57.8,1.09
CpG: 25,chr8,123318347,123318618,271,25,189,18.5,69.7,0.76
CpG: 47,chr8,123332639,123333155,516,47,285,18.2,55.2,1.22
CpG: 19,chr8,123354048,123354285,237,19,157,16,66.2,0.75
CpG: 91,chr8,123373476,123374433,957,91,646,19,67.5,0.84
CpG: 38,chr8,123411354,123411758,404,38,276,18.8,68.3,0.81
CpG: 18,chr8,123421072,123421288,216,18,139,16.7,64.4,0.82
CpG: 28,chr8,123442953,123443317,364,28,234,15.4,64.3,0.75
CpG: 71,chr8,123477594,123478220,626,71,425,22.7,67.9,1
CpG: 46,chr8,123514819,123515367,548,46,376,16.8,68.6,0.71
CpG: 27,chr8,123545701,123545954,253,27,164,21.3,64.8,1.14
CpG: 82,chr8,123653659,123654543,884,82,474,18.6,53.6,1.29
CpG: 39,chr8,123805984,123806291,307,39,212,25.4,69.1,1.08
CpG: 106,chr8,123858992,123859990,998,106,682,21.2,68.3,0.91
CpG: 54,chr8,123891877,123892617,740,54,455,14.6,61.5,0.78
CpG: 80,chr8,123948848,123949584,736,80,489,21.7,66.4,0.99
CpG: 91,chr8,123982413,123983227,814,91,553,22.4,67.9,0.97
CpG: 101,chr8,124020780,124021661,881,101,518,22.9,58.8,1.33
CpG: 111,chr8,124231176,124232486,1310,111,789,16.9,60.2,0.94
CpG: 110,chr8,124433751,124434782,1031,110,634,21.3,61.5,1.13
CpG: 43,chr8,124520634,124521036,402,43,275,21.4,68.4,0.93
CpG: 80,chr8,124662804,124663630,826,80,517,19.4,62.6,1.03
CpG: 71,chr8,124721639,124722407,768,71,521,18.5,67.8,0.8
CpG: 79,chr8,124751248,124752045,797,79,534,19.8,67,0.9
CpG: 236,chr8,124792292,124794928,2636,236,1729,17.9,65.6,0.83
CpG: 74,chr8,124862770,124863555,785,74,526,18.9,67,0.84
CpG: 17,chr8,124896297,124896502,205,17,132,16.6,64.4,0.8
CpG: 150,chr8,124896710,124898512,1802,150,1054,16.6,58.5,0.97
CpG: 118,chr8,124948141,124949698,1557,118,783,15.2,50.3,1.21
CpG: 81,chr8,125012729,125013474,745,81,531,21.7,71.3,0.87
CpG: 23,chr8,125015845,125016165,320,23,216,14.4,67.5,0.64
CpG: 81,chr8,125054030,125054784,754,81,509,21.5,67.5,0.95
CpG: 140,chr8,125569223,125570454,1231,140,764,22.7,62.1,1.19
CpG: 73,chr8,125669765,125670321,556,73,411,26.3,73.9,0.96
CpG: 37,chr8,125734127,125734513,386,37,272,19.2,70.5,0.77
CpG: 31,chr8,125898075,125898384,309,31,214,20.1,69.3,0.84
CpG: 105,chr8,125910412,125911393,981,105,631,21.4,64.3,1.04
CpG: 73,chr8,125995100,125995926,826,73,541,17.7,65.5,0.83
CpG: 97,chr8,126138655,126139557,902,97,633,21.5,70.2,0.88
CpG: 68,chr8,126298423,126299049,626,68,463,21.7,74,0.83
CpG: 56,chr8,126422275,126422864,589,56,387,19,65.7,0.88
CpG: 114,chr8,126474331,126475129,798,114,579,28.6,72.6,1.1
CpG: 33,chr8,126584077,126584337,260,33,185,25.4,71.2,1.01
CpG: 267,chr8,126592368,126594954,2586,267,1598,20.6,61.8,1.09
CpG: 70,chr8,126945528,126946020,492,70,354,28.5,72,1.1
CpG: 42,chr8,126970767,126971228,461,42,307,18.2,66.6,0.87
CpG: 160,chr8,127063558,127065048,1490,160,1001,21.5,67.2,0.96
CpG: 46,chr8,128356984,128357547,563,46,365,16.3,64.8,0.78
CpG: 19,chr8,128358447,128358687,240,19,144,15.8,60,0.89
CpG: 43,chr8,128359376,128359802,426,43,277,20.2,65,0.96
CpG: 120,chr8,128685320,128686390,1070,120,743,22.4,69.4,0.93
CpG: 17,chr8,129268424,129268657,233,17,164,14.6,70.4,0.6
CpG: 26,chr9,3199798,3200105,307,26,195,16.9,63.5,0.86
CpG: 38,chr9,3532193,3532626,433,38,294,17.6,67.9,0.76
CpG: 30,chr9,4260538,4260842,304,30,214,19.7,70.4,0.8
CpG: 70,chr9,4309133,4309885,752,70,474,18.6,63,0.94
CpG: 19,chr9,4977625,4977851,226,19,145,16.8,64.2,0.83
CpG: 28,chr9,6168469,6168869,400,28,225,14,56.2,0.88
CpG: 30,chr9,7176711,7177070,359,30,221,16.7,61.6,0.88
CpG: 79,chr9,7184469,7185187,718,79,480,22,66.9,0.99
CpG: 69,chr9,7763787,7764494,707,69,494,19.5,69.9,0.81
CpG: 63,chr9,7836877,7837494,617,63,408,20.4,66.1,0.93
CpG: 21,chr9,7872571,7872824,253,21,164,16.6,64.8,0.79
CpG: 158,chr9,8003468,8004940,1472,158,936,21.5,63.6,1.06
CpG: 27,chr9,8042441,8042712,271,27,190,19.9,70.1,0.81
CpG: 60,chr9,8134104,8134575,471,60,293,25.5,62.2,1.32
CpG: 45,chr9,8543990,8544648,658,45,422,13.7,64.1,0.67
CpG: 19,chr9,8900492,8900717,225,19,146,16.9,64.9,0.82
CpG: 68,chr9,8901405,8902030,625,68,455,21.8,72.8,0.84
CpG: 64,chr9,9238697,9239289,592,64,403,21.6,68.1,0.93
CpG: 15,chr9,11277646,11277855,209,15,128,14.4,61.2,0.77
CpG: 53,chr9,13749105,13749574,469,53,340,22.6,72.5,0.87
CpG: 161,chr9,13826423,13828229,1806,161,1147,17.8,63.5,0.89
CpG: 85,chr9,14276146,14276772,626,85,465,27.2,74.3,0.99
CpG: 63,chr9,14380647,14381181,534,63,387,23.6,72.5,0.9
CpG: 54,chr9,14500256,14500932,676,54,392,16,58,0.96
CpG: 56,chr9,14614297,14614977,680,56,468,16.5,68.8,0.7
CpG: 123,chr9,14750818,14752271,1453,123,959,16.9,66,0.78
CpG: 49,chr9,14784415,14785010,595,49,352,16.5,59.2,0.94
CpG: 39,chr9,14845268,14845760,492,39,303,15.9,61.6,0.87
CpG: 34,chr9,14860061,14860408,347,34,233,19.6,67.1,0.89
CpG: 67,chr9,15044998,15045542,544,67,372,24.6,68.4,1.05
CpG: 53,chr9,15279532,15280039,507,53,345,20.9,68,0.91
CpG: 53,chr9,15306146,15306592,446,53,303,23.8,67.9,1.03
CpG: 42,chr9,15357496,15357878,382,42,271,22,70.9,0.88
CpG: 112,chr9,15493380,15494270,890,112,625,25.2,70.2,1.04
CpG: 26,chr9,15627862,15628112,250,26,177,20.8,70.8,0.84
CpG: 69,chr9,15709545,15710045,500,69,374,27.6,74.8,1.01
CpG: 58,chr9,16501887,16502421,534,58,379,21.7,71,0.87
CpG: 58,chr9,18291975,18292614,639,58,407,18.2,63.7,0.9
CpG: 25,chr9,18473544,18473789,245,25,150,20.4,61.2,1.19
CpG: 42,chr9,20384925,20385431,506,42,294,16.6,58.1,0.98
CpG: 39,chr9,20459617,20460087,470,39,279,16.6,59.4,0.94
CpG: 33,chr9,20492516,20492906,390,33,252,16.9,64.6,0.81
CpG: 56,chr9,20521200,20521760,560,56,375,20,67,0.9
CpG: 15,chr9,20544285,20544493,208,15,135,14.4,64.9,0.69
CpG: 35,chr9,20581269,20581685,416,35,268,16.8,64.4,0.81
CpG: 45,chr9,20607226,20607678,452,45,279,19.9,61.7,1.05
CpG: 48,chr9,20641998,20642464,466,48,310,20.6,66.5,0.93
CpG: 25,chr9,20644735,20645036,301,25,178,16.6,59.1,0.97
CpG: 53,chr9,20651979,20652529,550,53,368,19.3,66.9,0.87
CpG: 60,chr9,20726445,20727075,630,60,436,19,69.2,0.8
CpG: 43,chr9,20727431,20728055,624,43,375,13.8,60.1,0.76
CpG: 52,chr9,20868533,20868977,444,52,317,23.4,71.4,0.93
CpG: 70,chr9,20878027,20878599,572,70,404,24.5,70.6,0.98
CpG: 54,chr9,20888102,20888570,468,54,316,23.1,67.5,1.02
CpG: 52,chr9,20898264,20898729,465,52,337,22.4,72.5,0.86
CpG: 46,chr9,20952560,20953008,448,46,304,20.5,67.9,0.89
CpG: 68,chr9,20975904,20976860,956,68,605,14.2,63.3,0.72
CpG: 66,chr9,21002720,21003404,684,66,441,19.3,64.5,0.93
CpG: 41,chr9,21031776,21032284,508,41,341,16.1,67.1,0.73
CpG: 63,chr9,21033069,21033764,695,63,462,18.1,66.5,0.82
CpG: 25,chr9,21036741,21037105,364,25,239,13.7,65.7,0.64
CpG: 26,chr9,21037610,21037854,244,26,170,21.3,69.7,0.88
CpG: 21,chr9,21038618,21038826,208,21,147,20.2,70.7,0.84
CpG: 26,chr9,21066913,21067224,311,26,212,16.7,68.2,0.72
CpG: 50,chr9,21073089,21073581,492,50,315,20.3,64,1
CpG: 58,chr9,21091664,21092127,463,58,314,25.1,67.8,1.09
CpG: 29,chr9,21131207,21131569,362,29,217,16,59.9,0.9
CpG: 40,chr9,21149705,21150057,352,40,248,22.7,70.5,0.92
CpG: 42,chr9,21161281,21161682,401,42,266,20.9,66.3,0.96
CpG: 122,chr9,21165043,21166340,1297,122,848,18.8,65.4,0.88
CpG: 43,chr9,21181558,21181907,349,43,258,24.6,73.9,0.91
CpG: 37,chr9,21184003,21184452,449,37,317,16.5,70.6,0.68
CpG: 55,chr9,21233415,21234024,609,55,396,18.1,65,0.86
CpG: 93,chr9,21238530,21239400,870,93,599,21.4,68.9,0.9
CpG: 113,chr9,21244070,21245179,1109,113,749,20.4,67.5,0.9
CpG: 26,chr9,21248397,21248654,257,26,183,20.2,71.2,0.8
CpG: 52,chr9,21265196,21265663,467,52,324,22.3,69.4,0.93
CpG: 54,chr9,21287672,21288321,649,54,412,16.6,63.5,0.86
CpG: 61,chr9,21290817,21291645,828,61,535,14.7,64.6,0.71
CpG: 37,chr9,21312114,21312529,415,37,271,17.8,65.3,0.84
CpG: 20,chr9,21320948,21321238,290,20,184,13.8,63.4,0.69
CpG: 94,chr9,21367448,21368510,1062,94,654,17.7,61.6,0.95
CpG: 21,chr9,21412192,21412474,282,21,179,14.9,63.5,0.74
CpG: 67,chr9,21424878,21425374,496,67,358,27,72.2,1.08
CpG: 27,chr9,21509925,21510286,361,27,229,15,63.4,0.77
CpG: 104,chr9,21546352,21547476,1124,104,668,18.5,59.4,1.06
CpG: 96,chr9,21592763,21593655,892,96,583,21.5,65.4,1.01
CpG: 47,chr9,21616276,21616655,379,47,269,24.8,71,1.02
CpG: 18,chr9,21685922,21686143,221,18,137,16.3,62,0.85
CpG: 46,chr9,21723349,21723950,601,46,360,15.3,59.9,0.86
CpG: 59,chr9,21759950,21760656,706,59,410,16.7,58.1,0.99
CpG: 40,chr9,21795115,21795543,428,40,310,18.7,72.4,0.72
CpG: 50,chr9,21798440,21798914,474,50,350,21.1,73.8,0.78
CpG: 51,chr9,21852370,21852764,394,51,293,25.9,74.4,0.94
CpG: 52,chr9,21917823,21918315,492,52,353,21.1,71.7,0.82
CpG: 29,chr9,21936998,21937315,317,29,215,18.3,67.8,0.81
CpG: 19,chr9,21944331,21944561,230,19,143,16.5,62.2,0.85
CpG: 18,chr9,21947564,21947823,259,18,178,13.9,68.7,0.61
CpG: 47,chr9,21955731,21956226,495,47,309,19,62.4,1.01
CpG: 28,chr9,21961538,21961877,339,28,213,16.5,62.8,0.84
CpG: 21,chr9,21962523,21962743,220,21,149,19.1,67.7,0.92
CpG: 26,chr9,21981294,21981582,288,26,189,18.1,65.6,0.84
CpG: 20,chr9,21988062,21988280,218,20,147,18.3,67.4,0.82
CpG: 24,chr9,21989892,21990218,326,24,202,14.7,62,0.77
CpG: 36,chr9,22002647,22003010,363,36,219,19.8,60.3,1.1
CpG: 25,chr9,22018546,22018873,327,25,201,15.3,61.5,0.81
CpG: 171,chr9,22050414,22052167,1753,171,1246,19.5,71.1,0.77
CpG: 27,chr9,22055777,22056121,344,27,220,15.7,64,0.77
CpG: 69,chr9,22070782,22071501,719,69,410,19.2,57,1.18
CpG: 18,chr9,22076227,22076469,242,18,144,14.9,59.5,0.84
CpG: 30,chr9,22085301,22085696,395,30,238,15.2,60.3,0.84
CpG: 49,chr9,22116844,22117343,499,49,322,19.6,64.5,0.96
CpG: 50,chr9,22156692,22157236,544,50,331,18.4,60.8,1
CpG: 35,chr9,22164739,22165124,385,35,235,18.2,61,0.99
CpG: 25,chr9,22188053,22188346,293,25,195,17.1,66.6,0.8
CpG: 24,chr9,22225766,22226030,264,24,182,18.2,68.9,0.77
CpG: 22,chr9,22259556,22259860,304,22,204,14.5,67.1,0.64
CpG: 48,chr9,22307327,22307755,428,48,301,22.4,70.3,0.92
CpG: 66,chr9,22388813,22389477,664,66,429,19.9,64.6,0.95
CpG: 40,chr9,22411367,22411818,451,40,290,17.7,64.3,0.87
CpG: 72,chr9,22467632,22468340,708,72,438,20.3,61.9,1.09
CpG: 23,chr9,22475489,22475751,262,23,169,17.6,64.5,0.86
CpG: 150,chr9,23222362,23223909,1547,150,1077,19.4,69.6,0.8
CpG: 90,chr9,24503005,24503598,593,90,427,30.4,72,1.18
CpG: 36,chr9,24695948,24696360,412,36,270,17.5,65.5,0.82
CpG: 37,chr9,24774109,24774519,410,37,278,18,67.8,0.79
CpG: 27,chr9,24780994,24781291,297,27,202,18.2,68,0.79
CpG: 24,chr9,24952701,24952957,256,24,176,18.8,68.8,0.79
CpG: 94,chr9,25151090,25152026,936,94,636,20.1,67.9,0.89
CpG: 151,chr9,25251963,25253373,1410,151,940,21.4,66.7,0.97
CpG: 65,chr9,25481485,25481964,479,65,343,27.1,71.6,1.08
CpG: 96,chr9,26733486,26734277,791,96,572,24.3,72.3,0.93
CpG: 34,chr9,26755649,26756070,421,34,260,16.2,61.8,0.86
CpG: 35,chr9,26999270,26999714,444,35,274,15.8,61.7,0.83
CpG: 123,chr9,27029480,27030862,1382,123,831,17.8,60.1,0.99
CpG: 53,chr9,27155027,27155508,481,53,331,22,68.8,0.94
CpG: 124,chr9,27299011,27300603,1592,124,1011,15.6,63.5,0.78
CpG: 55,chr9,28403242,28403710,468,55,340,23.5,72.6,0.89
CpG: 89,chr9,29411750,29412756,1006,89,657,17.7,65.3,0.83
CpG: 45,chr9,30426946,30427396,450,45,308,20,68.4,0.85
CpG: 91,chr9,30921476,30922577,1101,91,698,16.5,63.4,0.82
CpG: 98,chr9,30942520,30943344,824,98,581,23.8,70.5,0.96
CpG: 98,chr9,31030138,31031319,1181,98,735,16.6,62.2,0.87
CpG: 70,chr9,31131286,31131913,627,70,454,22.3,72.4,0.86
CpG: 124,chr9,31211076,31212107,1031,124,755,24.1,73.2,0.9
CpG: 20,chr9,31212288,31212525,237,20,161,16.9,67.9,0.77
CpG: 95,chr9,31280554,31281378,824,95,586,23.1,71.1,0.92
CpG: 73,chr9,31386005,31386636,631,73,451,23.1,71.5,0.92
CpG: 172,chr9,31912847,31915232,2385,172,1393,14.4,58.4,0.85
CpG: 89,chr9,32032172,32033087,915,89,468,19.5,51.1,1.49
CpG: 39,chr9,32409218,32409639,421,39,280,18.5,66.5,0.84
CpG: 83,chr9,32540472,32541389,917,83,631,18.1,68.8,0.77
CpG: 52,chr9,32695608,32696257,649,52,352,16,54.2,1.09
CpG: 28,chr9,33728216,33728420,204,28,144,27.5,70.6,1.1
CpG: 27,chr9,34486091,34486336,245,27,174,22,71,0.88
CpG: 24,chr9,34488869,34489096,227,24,146,21.1,64.3,1.02
CpG: 45,chr9,35116564,35116956,392,45,228,23,58.2,1.36
CpG: 40,chr9,35199770,35200100,330,40,244,24.2,73.9,0.91
CpG: 79,chr9,35210826,35211664,838,79,535,18.9,63.8,0.93
CpG: 61,chr9,35267282,35267992,710,61,449,17.2,63.2,0.86
CpG: 19,chr9,35281558,35281765,207,19,127,18.4,61.4,0.98
CpG: 106,chr9,35421126,35422113,987,106,688,21.5,69.7,0.89
CpG: 55,chr9,35558234,35558718,484,55,329,22.7,68,0.99
CpG: 84,chr9,35569662,35570530,868,84,565,19.4,65.1,0.91
CpG: 28,chr9,35574462,35574663,201,28,148,27.9,73.6,1.03
CpG: 34,chr9,36726272,36726731,459,34,295,14.8,64.3,0.73
CpG: 45,chr9,36767479,36768005,526,45,312,17.1,59.3,0.97
CpG: 64,chr9,36796873,36797441,568,64,427,22.5,75.2,0.8
CpG: 19,chr9,37145199,37145441,242,19,152,15.7,62.8,0.81
CpG: 17,chr9,37145602,37145827,225,17,121,15.1,53.8,1.06
CpG: 51,chr9,37146458,37146914,456,51,340,22.4,74.6,0.81
CpG: 27,chr9,37255241,37255528,287,27,200,18.8,69.7,0.78
CpG: 27,chr9,37348287,37348622,335,27,198,16.1,59.1,0.92
CpG: 37,chr9,37384547,37384857,310,37,225,23.9,72.6,0.93
CpG: 27,chr9,37420746,37421064,318,27,215,17,67.6,0.76
CpG: 24,chr9,37429562,37429782,220,24,148,21.8,67.3,0.96
CpG: 29,chr9,37432993,37433357,364,29,251,15.9,69,0.68
CpG: 76,chr9,37460164,37460864,700,76,493,21.7,70.4,0.88
CpG: 99,chr9,37489050,37490155,1105,99,680,17.9,61.5,0.95
CpG: 21,chr9,37530325,37530590,265,21,172,15.8,64.9,0.78
CpG: 29,chr9,37657022,37657336,314,29,200,18.5,63.7,0.92
CpG: 47,chr9,40192289,40192752,463,47,321,20.3,69.3,0.85
CpG: 27,chr9,40269285,40269653,368,27,239,14.7,64.9,0.7
CpG: 76,chr9,40455338,40456147,809,76,545,18.8,67.4,0.83
CpG: 28,chr9,40531185,40531461,276,28,182,20.3,65.9,0.93
CpG: 59,chr9,40686054,40686647,593,59,420,19.9,70.8,0.79
CpG: 89,chr9,40800665,40801714,1049,89,688,17,65.6,0.79
CpG: 20,chr9,40871768,40872035,267,20,153,15,57.3,0.91
CpG: 26,chr9,40876202,40876450,248,26,162,21,65.3,0.99
CpG: 64,chr9,40877466,40878186,720,64,459,17.8,63.8,0.88
CpG: 36,chr9,40963918,40964231,313,36,212,23,67.7,1.05
CpG: 91,chr9,41156840,41157699,859,91,608,21.2,70.8,0.85
CpG: 15,chr9,41376488,41376689,201,15,128,14.9,63.7,0.74
CpG: 19,chr9,41890357,41890612,255,19,163,14.9,63.9,0.74
CpG: 65,chr9,42123866,42124499,633,65,373,20.5,58.9,1.19
CpG: 58,chr9,42264078,42264508,430,58,311,27,72.3,1.04
CpG: 24,chr9,42324790,42325065,275,24,152,17.5,55.3,1.18
CpG: 39,chr9,42472019,42472354,335,39,246,23.3,73.4,0.88
CpG: 31,chr9,42520789,42521113,324,31,231,19.1,71.3,0.76
CpG: 49,chr9,42897405,42897932,527,49,368,18.6,69.8,0.76
CpG: 111,chr9,42943897,42944996,1099,111,751,20.2,68.3,0.92
CpG: 127,chr9,43105426,43106549,1123,127,759,22.6,67.6,0.99
CpG: 48,chr9,43116129,43116600,471,48,338,20.4,71.8,0.79
CpG: 28,chr9,43205488,43205863,375,28,268,14.9,71.5,0.64
CpG: 80,chr9,43239193,43240105,912,80,561,17.5,61.5,0.93
CpG: 16,chr9,43286932,43287138,206,16,132,15.5,64.1,0.76
CpG: 109,chr9,43743678,43744707,1029,109,718,21.2,69.8,0.87
CpG: 30,chr9,43745258,43745629,371,30,248,16.2,66.8,0.73
CpG: 26,chr9,43803486,43803859,373,26,214,13.9,57.4,0.85
CpG: 33,chr9,44020497,44020911,414,33,257,15.9,62.1,0.86
CpG: 16,chr9,44043488,44043701,213,16,136,15,63.8,0.77
CpG: 39,chr9,44066829,44067244,415,39,272,18.8,65.5,0.88
CpG: 63,chr9,44084731,44085287,556,63,380,22.7,68.3,0.97
CpG: 30,chr9,44129989,44130387,398,30,261,15.1,65.6,0.71
CpG: 60,chr9,44134631,44135365,734,60,495,16.3,67.4,0.73
CpG: 30,chr9,44233786,44234012,226,30,171,26.5,75.7,0.93
CpG: 15,chr9,44253261,44253463,202,15,129,14.9,63.9,0.73
CpG: 38,chr9,44267882,44268226,344,38,258,22.1,75,0.79
CpG: 65,chr9,44287597,44288354,757,65,520,17.2,68.7,0.73
CpG: 66,chr9,44305285,44305977,692,66,461,19.1,66.6,0.86
CpG: 84,chr9,44319565,44320353,788,84,562,21.3,71.3,0.84
CpG: 24,chr9,44326916,44327163,247,24,165,19.4,66.8,0.87
CpG: 122,chr9,44334419,44335581,1162,122,734,21,63.2,1.05
CpG: 35,chr9,44343911,44344249,338,35,230,20.7,68,0.9
CpG: 41,chr9,44361340,44361830,490,41,288,16.7,58.8,0.97
CpG: 86,chr9,44379153,44379884,731,86,506,23.5,69.2,1
CpG: 41,chr9,44396933,44397451,518,41,355,15.8,68.5,0.67
CpG: 58,chr9,44407135,44407934,799,58,483,14.5,60.5,0.8
CpG: 37,chr9,44417857,44418284,427,37,267,17.3,62.5,0.89
CpG: 28,chr9,44440612,44441005,393,28,249,14.2,63.4,0.71
CpG: 59,chr9,44482651,44483484,833,59,473,14.2,56.8,0.89
CpG: 57,chr9,44498438,44499178,740,57,506,15.4,68.4,0.66
CpG: 132,chr9,44604079,44605427,1348,132,890,19.6,66,0.92
CpG: 23,chr9,44708421,44708652,231,23,167,19.9,72.3,0.78
CpG: 28,chr9,44721182,44721439,257,28,194,21.8,75.5,0.77
CpG: 81,chr9,44733683,44734536,853,81,582,19,68.2,0.82
CpG: 21,chr9,44734895,44735190,295,21,195,14.2,66.1,0.65
CpG: 75,chr9,44767215,44767886,671,75,472,22.4,70.3,0.91
CpG: 77,chr9,44799010,44799804,794,77,543,19.4,68.4,0.83
CpG: 119,chr9,44880812,44882280,1468,119,831,16.2,56.6,1.01
CpG: 37,chr9,44920370,44920726,356,37,243,20.8,68.3,0.9
CpG: 25,chr9,44965437,44965717,280,25,172,17.9,61.4,0.95
CpG: 20,chr9,45055132,45055428,296,20,185,13.5,62.5,0.71
CpG: 72,chr9,45138315,45138986,671,72,469,21.5,69.9,0.89
CpG: 24,chr9,45268958,45269238,280,24,172,17.1,61.4,0.91
CpG: 25,chr9,45370199,45370483,284,25,196,17.6,69,0.74
CpG: 106,chr9,45430236,45431577,1341,106,920,15.8,68.6,0.68
CpG: 30,chr9,45672613,45672916,303,30,200,19.8,66,0.91
CpG: 21,chr9,45828387,45828653,266,21,183,15.8,68.8,0.72
CpG: 28,chr9,45838654,45838941,287,28,200,19.5,69.7,0.82
CpG: 94,chr9,45906346,45907255,909,94,617,20.7,67.9,0.94
CpG: 88,chr9,45954680,45955380,700,88,471,25.1,67.3,1.11
CpG: 60,chr9,45984474,45984974,500,60,353,24,70.6,0.96
CpG: 77,chr9,46012524,46013438,914,77,523,16.8,57.2,1.06
CpG: 25,chr9,46270106,46270416,310,25,192,16.1,61.9,0.85
CpG: 35,chr9,46273146,46273488,342,35,235,20.5,68.7,0.87
CpG: 38,chr9,46282934,46283299,365,38,249,20.8,68.2,0.9
CpG: 42,chr9,46443405,46443903,498,42,297,16.9,59.6,0.95
CpG: 215,chr9,47529731,47531874,2143,215,1449,20.1,67.6,0.88
CpG: 45,chr9,48480343,48480713,370,45,268,24.3,72.4,1.01
CpG: 96,chr9,48495046,48495925,879,96,570,21.8,64.8,1.05
CpG: 135,chr9,48834678,48836347,1669,135,1071,16.2,64.2,0.79
CpG: 70,chr9,48984969,48985827,858,70,487,16.3,56.8,1.08
CpG: 36,chr9,49055413,49055833,420,36,278,17.1,66.2,0.8
CpG: 72,chr9,49340312,49340960,648,72,438,22.2,67.6,0.97
CpG: 123,chr9,49796790,49798520,1730,123,1100,14.2,63.6,0.71
CpG: 51,chr9,50528378,50528783,405,51,282,25.2,69.6,1.05
CpG: 31,chr9,50561130,50561392,262,31,183,23.7,69.8,1.01
CpG: 48,chr9,50603783,50604302,519,48,325,18.5,62.6,0.95
CpG: 81,chr9,50616780,50617588,808,81,537,20,66.5,0.91
CpG: 72,chr9,50659218,50659862,644,72,451,22.4,70,0.91
CpG: 64,chr9,50698675,50699351,676,64,465,18.9,68.8,0.8
CpG: 49,chr9,50727721,50728291,570,49,376,17.2,66,0.79
CpG: 54,chr9,50767997,50768558,561,54,358,19.3,63.8,0.96
CpG: 70,chr9,50775208,50775874,666,70,440,21,66.1,0.96
CpG: 71,chr9,50856807,50857475,668,71,469,21.3,70.2,0.89
CpG: 125,chr9,51008343,51009443,1100,125,758,22.7,68.9,0.96
CpG: 61,chr9,51103399,51104047,648,61,447,18.8,69,0.8
CpG: 50,chr9,51278564,51279283,719,50,480,13.9,66.8,0.62
CpG: 131,chr9,51764861,51766217,1356,131,883,19.3,65.1,0.92
CpG: 79,chr9,51963071,51963638,567,79,420,27.9,74.1,1.02
CpG: 152,chr9,52047996,52049015,1019,152,760,29.8,74.6,1.07
CpG: 91,chr9,52167884,52168718,834,91,557,21.8,66.8,0.98
CpG: 50,chr9,53247745,53248307,562,50,359,17.8,63.9,0.87
CpG: 53,chr9,53383947,53384579,632,53,405,16.8,64.1,0.82
CpG: 98,chr9,53536538,53537644,1106,98,710,17.7,64.2,0.86
CpG: 42,chr9,53610088,53610454,366,42,263,23,71.9,0.89
CpG: 101,chr9,53666753,53667624,871,101,618,23.2,71,0.92
CpG: 73,chr9,53705629,53706515,886,73,579,16.5,65.3,0.8
CpG: 58,chr9,53771611,53772123,512,58,351,22.7,68.6,0.97
CpG: 46,chr9,53974755,53975354,599,46,360,15.4,60.1,0.85
CpG: 28,chr9,54068195,54068504,309,28,221,18.1,71.5,0.71
CpG: 58,chr9,54286384,54286918,534,58,370,21.7,69.3,0.9
CpG: 65,chr9,54501025,54501623,598,65,432,21.7,72.2,0.84
CpG: 27,chr9,54559948,54560181,233,27,165,23.2,70.8,0.93
CpG: 70,chr9,54586280,54586966,686,70,484,20.4,70.6,0.84
CpG: 108,chr9,54699059,54700046,987,108,662,21.9,67.1,0.97
CpG: 35,chr9,54764654,54765026,372,35,255,18.8,68.5,0.8
CpG: 32,chr9,54765477,54765900,423,32,259,15.1,61.2,0.81
CpG: 53,chr9,54863617,54864118,501,53,292,21.2,58.3,1.25
CpG: 21,chr9,54917237,54917459,222,21,149,18.9,67.1,0.84
CpG: 57,chr9,54950760,54951273,513,57,361,22.2,70.4,0.9
CpG: 35,chr9,54981330,54981615,285,35,201,24.6,70.5,1.03
CpG: 42,chr9,55026216,55026662,446,42,278,18.8,62.3,0.97
CpG: 112,chr9,55148920,55150136,1216,112,682,18.4,56.1,1.17
CpG: 64,chr9,55208850,55209485,635,64,435,20.2,68.5,0.87
CpG: 29,chr9,55326514,55326752,238,29,173,24.4,72.7,0.95
CpG: 64,chr9,55511742,55512456,714,64,452,17.9,63.3,0.89
CpG: 37,chr9,55540822,55541254,432,37,290,17.1,67.1,0.76
CpG: 103,chr9,55541736,55542895,1159,103,722,17.8,62.3,0.93
CpG: 29,chr9,55543995,55544273,278,29,175,20.9,62.9,1.05
CpG: 104,chr9,55545460,55546720,1260,104,750,16.5,59.5,0.93
CpG: 43,chr9,55937807,55938304,497,43,314,17.3,63.2,0.9
CpG: 52,chr9,56041810,56042329,519,52,367,20,70.7,0.8
CpG: 82,chr9,56160397,56161143,746,82,532,22,71.3,0.87
CpG: 71,chr9,56417670,56418224,554,71,403,25.6,72.7,0.99
CpG: 35,chr9,56619643,56620178,535,35,330,13.1,61.7,0.71
CpG: 38,chr9,56620653,56621194,541,38,325,14,60.1,0.8
CpG: 106,chr9,56635027,56636120,1093,106,710,19.4,65,0.92
CpG: 125,chr9,56795771,56797068,1297,125,873,19.3,67.3,0.89
CpG: 23,chr9,56864984,56865213,229,23,149,20.1,65.1,0.98
CpG: 43,chr9,56928157,56928603,446,43,296,19.3,66.4,0.88
CpG: 58,chr9,56937433,56937961,528,58,331,22,62.7,1.12
CpG: 32,chr9,56950605,56950953,348,32,207,18.4,59.5,1.05
CpG: 98,chr9,56994991,56995839,848,98,599,23.1,70.6,0.93
CpG: 104,chr9,57072188,57073344,1156,104,751,18,65,0.88
CpG: 99,chr9,57076181,57077129,948,99,648,20.9,68.4,0.92
CpG: 49,chr9,57130733,57131318,585,49,386,16.8,66,0.77
CpG: 110,chr9,57261524,57262813,1289,110,858,17.1,66.6,0.78
CpG: 36,chr9,57467994,57468231,237,36,170,30.4,71.7,1.18
CpG: 74,chr9,57503950,57504740,790,74,524,18.7,66.3,0.85
CpG: 95,chr9,57521062,57521813,751,95,543,25.3,72.3,0.98
CpG: 45,chr9,57537457,57537810,353,45,251,25.5,71.1,1.01
CpG: 21,chr9,57552531,57552799,268,21,154,15.7,57.5,0.99
CpG: 26,chr9,57560883,57561201,318,26,201,16.4,63.2,0.82
CpG: 43,chr9,57589417,57589804,387,43,286,22.2,73.9,0.81
CpG: 62,chr9,57645172,57645783,611,62,404,20.3,66.1,0.95
CpG: 47,chr9,57708497,57708990,493,47,277,19.1,56.2,1.28
CpG: 181,chr9,57764439,57766197,1758,181,1201,20.6,68.3,0.89
CpG: 50,chr9,57836514,57837066,552,50,386,18.1,69.9,0.74
CpG: 107,chr9,57939932,57941023,1091,107,727,19.6,66.6,0.89
CpG: 134,chr9,58197983,58199920,1937,134,1201,13.8,62,0.72
CpG: 22,chr9,58201822,58202028,206,22,112,21.4,54.4,1.8
CpG: 18,chr9,58247028,58247256,228,18,138,15.8,60.5,0.86
CpG: 24,chr9,58253065,58253422,357,24,232,13.4,65,0.66
CpG: 133,chr9,58311655,58313120,1465,133,965,18.2,65.9,0.84
CpG: 116,chr9,58487925,58489103,1178,116,772,19.7,65.5,0.92
CpG: 54,chr9,58554865,58555306,441,54,333,24.5,75.5,0.86
CpG: 76,chr9,58582049,58582852,803,76,485,18.9,60.4,1.06
CpG: 17,chr9,58741398,58741645,247,17,148,13.8,59.9,0.78
CpG: 205,chr9,58822230,58824166,1936,205,1328,21.2,68.6,0.9
CpG: 163,chr9,59035708,59037181,1473,163,955,22.1,64.8,1.06
CpG: 96,chr9,59291029,59292010,981,96,635,19.6,64.7,0.93
CpG: 30,chr9,59353199,59353483,284,30,175,21.1,61.6,1.18
CpG: 131,chr9,59485718,59487038,1320,131,799,19.8,60.5,1.09
CpG: 49,chr9,59539536,59540042,506,49,337,19.4,66.6,0.88
CpG: 77,chr9,59577874,59578646,772,77,545,19.9,70.6,0.81
CpG: 25,chr9,59603032,59603363,331,25,229,15.1,69.2,0.64
CpG: 65,chr9,59617012,59617734,722,65,451,18,62.5,0.92
CpG: 100,chr9,59656245,59657561,1316,100,815,15.2,61.9,0.81
CpG: 56,chr9,59680104,59680737,633,56,406,17.7,64.1,0.86
CpG: 89,chr9,59750681,59751585,904,89,616,19.7,68.1,0.85
CpG: 60,chr9,60521761,60522128,367,60,293,32.7,79.8,1.04
CpG: 18,chr9,60687984,60688225,241,18,142,14.9,58.9,0.86
CpG: 54,chr9,60713023,60713457,434,54,324,24.9,74.7,0.9
CpG: 55,chr9,60794393,60794987,594,55,411,18.5,69.2,0.78
CpG: 27,chr9,61369480,61369822,342,27,220,15.8,64.3,0.77
CpG: 71,chr9,61370646,61371649,1003,71,616,14.2,61.4,0.76
CpG: 188,chr9,61372252,61374318,2066,188,1357,18.2,65.7,0.84
CpG: 74,chr9,61914186,61914891,705,74,441,21,62.6,1.07
CpG: 67,chr9,61946290,61946975,685,67,480,19.6,70.1,0.8
CpG: 38,chr9,62026500,62026984,484,38,324,15.7,66.9,0.7
CpG: 88,chr9,62121851,62122786,935,88,628,18.8,67.2,0.86
CpG: 21,chr9,62282065,62282293,228,21,152,18.4,66.7,0.84
CpG: 291,chr9,62340766,62344699,3933,291,2372,14.8,60.3,0.82
CpG: 19,chr9,62363708,62363954,246,19,162,15.4,65.9,0.71
CpG: 76,chr9,62536503,62537148,645,76,451,23.6,69.9,0.97
CpG: 26,chr9,62677691,62677940,249,26,181,20.9,72.7,0.79
CpG: 109,chr9,62811017,62812030,1013,109,706,21.5,69.7,0.89
CpG: 38,chr9,62838769,62838985,216,38,172,35.2,79.6,1.11
CpG: 105,chr9,62980106,62981282,1176,105,784,17.9,66.7,0.83
CpG: 24,chr9,63138719,63139003,284,24,186,16.9,65.5,0.82
CpG: 39,chr9,63142315,63142777,462,39,295,16.9,63.9,0.83
CpG: 214,chr9,63144138,63146674,2536,214,1641,16.9,64.7,0.81
CpG: 79,chr9,63148669,63149412,743,79,463,21.3,62.3,1.1
CpG: 42,chr9,63377634,63377960,326,42,244,25.8,74.8,0.95
CpG: 66,chr9,63398769,63399420,651,66,475,20.3,73,0.78
CpG: 56,chr9,63602464,63602905,441,56,328,25.4,74.4,0.92
CpG: 125,chr9,63757114,63758550,1436,125,946,17.4,65.9,0.8
CpG: 25,chr9,63927599,63927832,233,25,173,21.5,74.2,0.78
CpG: 45,chr9,63953581,63954041,460,45,305,19.6,66.3,0.89
CpG: 258,chr9,64020164,64023250,3086,258,1907,16.7,61.8,0.88
CpG: 24,chr9,64060298,64060525,227,24,163,21.1,71.8,0.82
CpG: 36,chr9,64084791,64085113,322,36,235,22.4,73,0.84
CpG: 30,chr9,64179250,64179554,304,30,195,19.7,64.1,0.96
CpG: 85,chr9,64253118,64253860,742,85,523,22.9,70.5,0.92
CpG: 55,chr9,64281408,64281922,514,55,346,21.4,67.3,0.98
CpG: 88,chr9,64340472,64341326,854,88,611,20.6,71.5,0.82
CpG: 132,chr9,64385642,64387233,1591,132,1031,16.6,64.8,0.79
CpG: 20,chr9,64638272,64638497,225,20,151,17.8,67.1,0.79
CpG: 59,chr9,64737300,64737817,517,59,370,22.8,71.6,0.9
CpG: 90,chr9,64811116,64812050,934,90,653,19.3,69.9,0.79
CpG: 32,chr9,64960773,64961153,380,32,253,16.8,66.6,0.78
CpG: 77,chr9,65021060,65021817,757,77,525,20.3,69.4,0.85
CpG: 80,chr9,65032306,65033067,761,80,509,21,66.9,0.94
CpG: 65,chr9,65101215,65101932,717,65,415,18.1,57.9,1.11
CpG: 41,chr9,65123790,65124095,305,41,221,26.9,72.5,1.03
CpG: 90,chr9,65140923,65141997,1074,90,568,16.8,52.9,1.22
CpG: 63,chr9,65162687,65163433,746,63,469,16.9,62.9,0.85
CpG: 52,chr9,65215135,65215661,526,52,362,19.8,68.8,0.85
CpG: 90,chr9,65293994,65294966,972,90,588,18.5,60.5,1.01
CpG: 113,chr9,65346019,65347094,1075,113,699,21,65,0.99
CpG: 22,chr9,65371867,65372106,239,22,163,18.4,68.2,0.82
CpG: 102,chr9,65390688,65391611,923,102,632,22.1,68.5,0.94
CpG: 22,chr9,65398450,65398657,207,22,145,21.3,70,0.87
CpG: 45,chr9,65435695,65436093,398,45,286,22.6,71.9,0.88
CpG: 48,chr9,65460867,65461342,475,48,321,20.2,67.6,0.89
CpG: 35,chr9,65579868,65580281,413,35,279,16.9,67.6,0.75
CpG: 57,chr9,65587762,65588282,520,57,350,21.9,67.3,0.97
CpG: 34,chr9,65629195,65629711,516,34,300,13.2,58.1,0.78
CpG: 118,chr9,65629953,65631235,1282,118,785,18.4,61.2,0.99
CpG: 33,chr9,65676439,65676779,340,33,243,19.4,71.5,0.76
CpG: 37,chr9,65909274,65909796,522,37,330,14.2,63.2,0.72
CpG: 56,chr9,66059969,66060494,525,56,355,21.3,67.6,0.95
CpG: 56,chr9,66069148,66069878,730,56,463,15.3,63.4,0.78
CpG: 26,chr9,66124605,66124884,279,26,185,18.6,66.3,0.86
CpG: 49,chr9,66158077,66158450,373,49,279,26.3,74.8,0.94
CpG: 23,chr9,66220618,66220866,248,23,166,18.5,66.9,0.87
CpG: 96,chr9,66349996,66351049,1053,96,656,18.2,62.3,0.95
CpG: 78,chr9,66511509,66512053,544,78,379,28.7,69.7,1.2
CpG: 155,chr9,66591932,66593674,1742,155,1110,17.8,63.7,0.88
CpG: 66,chr9,66795188,66795964,776,66,522,17,67.3,0.79
CpG: 51,chr9,66805821,66806225,404,51,296,25.2,73.3,0.95
CpG: 80,chr9,66834422,66835389,967,80,626,16.5,64.7,0.84
CpG: 68,chr9,66919210,66919898,688,68,469,19.8,68.2,0.89
CpG: 64,chr9,66945915,66946572,657,64,444,19.5,67.6,0.85
CpG: 74,chr9,66974829,66975542,713,74,513,20.8,71.9,0.8
CpG: 47,chr9,67043530,67044058,528,47,337,17.8,63.8,0.88
CpG: 107,chr9,67048090,67049644,1554,107,949,13.8,61.1,0.74
CpG: 124,chr9,67632698,67634147,1449,124,901,17.1,62.2,0.89
CpG: 130,chr9,67759684,67760714,1030,130,711,25.2,69,1.07
CpG: 131,chr9,67830786,67831744,958,131,717,27.3,74.8,0.99
CpG: 36,chr9,67840252,67840647,395,36,254,18.2,64.3,0.88
CpG: 127,chr9,68653545,68654962,1417,127,898,17.9,63.4,0.9
CpG: 148,chr9,69289645,69291400,1755,148,1162,16.9,66.2,0.78
CpG: 45,chr9,69397882,69398205,323,45,225,27.9,69.7,1.16
CpG: 41,chr9,69453637,69454125,488,41,338,16.8,69.3,0.71
CpG: 152,chr9,69759172,69761245,2073,152,1277,14.7,61.6,0.8
CpG: 20,chr9,69769052,69769266,214,20,121,18.7,56.5,1.19
CpG: 70,chr9,69989361,69989951,590,70,423,23.7,71.7,0.92
CpG: 51,chr9,70012461,70012950,489,51,306,20.9,62.6,1.07
CpG: 69,chr9,70141053,70141727,674,69,418,20.5,62,1.07
CpG: 34,chr9,70421360,70421597,237,34,174,28.7,73.4,1.07
CpG: 80,chr9,70503066,70503877,811,80,460,19.7,56.7,1.24
CpG: 103,chr9,70542322,70543417,1095,103,662,18.8,60.5,1.03
CpG: 97,chr9,70656620,70657454,834,97,560,23.3,67.1,1.04
CpG: 129,chr9,70678704,70679786,1082,129,733,23.8,67.7,1.04
CpG: 124,chr9,71215304,71216666,1362,124,864,18.2,63.4,0.91
CpG: 57,chr9,71485409,71486045,636,57,371,17.9,58.3,1.05
CpG: 62,chr9,71771233,71771796,563,62,416,22,73.9,0.82
CpG: 154,chr9,72110859,72112240,1381,154,830,22.3,60.1,1.24
CpG: 80,chr9,72132890,72133482,592,80,449,27,75.8,0.94
CpG: 71,chr9,72274676,72275402,726,71,384,19.6,52.9,1.42
CpG: 22,chr9,72438374,72438619,245,22,149,18,60.8,0.97
CpG: 26,chr9,72491753,72492035,282,26,183,18.4,64.9,0.89
CpG: 22,chr9,72531760,72531995,235,22,145,18.7,61.7,0.98
CpG: 34,chr9,72532342,72532648,306,34,191,22.2,62.4,1.15
CpG: 104,chr9,72661883,72663057,1174,104,704,17.7,60,0.99
CpG: 101,chr9,72807002,72807894,892,101,633,22.6,71,0.9
CpG: 24,chr9,72856790,72857097,307,24,182,15.6,59.3,0.89
CpG: 93,chr9,72925155,72926085,930,93,599,20,64.4,0.98
CpG: 23,chr9,72958799,72959033,234,23,150,19.7,64.1,0.96
CpG: 89,chr9,72985204,72986093,889,89,576,20,64.8,0.96
CpG: 48,chr9,73039433,73039967,534,48,340,18,63.7,0.89
CpG: 30,chr9,73044696,73045052,356,30,232,16.9,65.2,0.81
CpG: 64,chr9,73103241,73103920,679,64,488,18.9,71.9,0.73
CpG: 45,chr9,73113405,73113781,376,45,251,23.9,66.8,1.08
CpG: 105,chr9,74848331,74849612,1281,105,763,16.4,59.6,0.93
CpG: 170,chr9,74861640,74863886,2246,170,1417,15.1,63.1,0.76
CpG: 67,chr9,74952675,74953335,660,67,447,20.3,67.7,0.93
CpG: 63,chr9,75037625,75038147,522,63,380,24.1,72.8,0.94
CpG: 105,chr9,75070927,75071923,996,105,644,21.1,64.7,1.01
CpG: 32,chr9,75231948,75232337,389,32,273,16.5,70.2,0.67
CpG: 49,chr9,75314066,75314557,491,49,324,20,66,0.94
CpG: 98,chr9,75409190,75410295,1105,98,614,17.7,55.6,1.15
CpG: 61,chr9,75441314,75441983,669,61,421,18.2,62.9,0.94
CpG: 55,chr9,75559130,75559684,554,55,375,19.9,67.7,0.91
CpG: 56,chr9,75610732,75611346,614,56,396,18.2,64.5,0.88
CpG: 102,chr9,75625456,75626335,879,102,609,23.2,69.3,0.97
CpG: 32,chr9,75683863,75684200,337,32,222,19,65.9,0.89
CpG: 28,chr9,76014906,76015179,273,28,192,20.5,70.3,0.84
CpG: 28,chr9,76323287,76323677,390,28,222,14.4,56.9,0.89
CpG: 24,chr9,76567128,76567371,243,24,167,19.8,68.7,0.84
CpG: 87,chr9,77544402,77545329,927,87,566,18.8,61.1,1.01
CpG: 85,chr9,77655178,77655862,684,85,479,24.9,70,1.02
CpG: 63,chr9,77750613,77750962,349,63,263,36.1,75.4,1.27
CpG: 77,chr9,77754516,77755223,707,77,449,21.8,63.5,1.09
CpG: 61,chr9,77910455,77911010,555,61,416,22,75,0.78
CpG: 68,chr9,77917272,77918016,744,68,462,18.3,62.1,0.95
CpG: 82,chr9,78108045,78108781,736,82,515,22.3,70,0.91
CpG: 49,chr9,78113129,78113626,497,49,348,19.7,70,0.81
CpG: 29,chr9,78175885,78176133,248,29,166,23.4,66.9,1.05
CpG: 95,chr9,78395600,78396287,687,95,492,27.7,71.6,1.09
CpG: 24,chr9,78427458,78427765,307,24,185,15.6,60.3,0.86
CpG: 84,chr9,78442517,78443268,751,84,488,22.4,65,1.06
CpG: 90,chr9,78448086,78448821,735,90,493,24.5,67.1,1.09
CpG: 15,chr9,78456807,78457026,219,15,123,13.7,56.2,0.88
CpG: 116,chr9,78480858,78482170,1312,116,869,17.7,66.2,0.82
CpG: 50,chr9,78587606,78588172,566,50,375,17.7,66.3,0.81
CpG: 37,chr9,78615628,78616010,382,37,256,19.4,67,0.87
CpG: 41,chr9,78821638,78821916,278,41,179,29.5,64.4,1.43
CpG: 42,chr9,79342325,79342842,517,42,321,16.2,62.1,0.84
CpG: 67,chr9,79718442,79719250,808,67,507,16.6,62.7,0.85
CpG: 27,chr9,79719513,79719819,306,27,183,17.6,59.8,0.99
CpG: 44,chr9,79759490,79759962,472,44,295,18.6,62.5,0.97
CpG: 67,chr9,79793063,79793756,693,67,380,19.3,54.8,1.29
CpG: 139,chr9,80066644,80067937,1293,139,831,21.5,64.3,1.04
CpG: 50,chr9,80164935,80165358,423,50,312,23.6,73.8,0.9
CpG: 117,chr9,81631675,81633537,1862,117,1156,12.6,62.1,0.66
CpG: 37,chr9,81863541,81864005,464,37,310,15.9,66.8,0.71
CpG: 65,chr9,82829654,82830312,658,65,435,19.8,66.1,0.9
CpG: 77,chr9,82975075,82975816,741,77,430,20.8,58,1.23
CpG: 68,chr9,83145857,83146719,862,68,546,15.8,63.3,0.79
CpG: 43,chr9,83440808,83441284,476,43,302,18.1,63.4,0.9
CpG: 16,chr9,83447779,83447992,213,16,120,15,56.3,0.95
CpG: 67,chr9,83548127,83548633,506,67,348,26.5,68.8,1.12
CpG: 70,chr9,83805768,83806518,750,70,488,18.7,65.1,0.88
CpG: 41,chr9,83834509,83834934,425,41,295,19.3,69.4,0.86
CpG: 35,chr9,83925000,83925312,312,35,225,22.4,72.1,0.86
CpG: 137,chr9,85326428,85328095,1667,137,1025,16.4,61.5,0.87
CpG: 62,chr9,85748903,85749379,476,62,340,26.1,71.4,1.03
CpG: 159,chr9,85842773,85844489,1716,159,1170,18.5,68.2,0.8
CpG: 63,chr9,86464542,86465000,458,63,330,27.5,72.1,1.08
CpG: 87,chr9,86467055,86467651,596,87,460,29.2,77.2,0.99
CpG: 81,chr9,86571567,86572410,843,81,579,19.2,68.7,0.82
CpG: 77,chr9,86695381,86696045,664,77,456,23.2,68.7,1.01
CpG: 148,chr9,86879502,86880861,1359,148,885,21.8,65.1,1.04
CpG: 65,chr9,87015364,87015971,607,65,394,21.4,64.9,1.02
CpG: 44,chr9,87021942,87022355,413,44,290,21.3,70.2,0.86
CpG: 28,chr9,87255277,87255637,360,28,224,15.6,62.2,0.8
CpG: 160,chr9,87729485,87731049,1564,160,1065,20.5,68.1,0.89
CpG: 67,chr9,87739133,87740059,926,67,574,14.5,62,0.75
CpG: 62,chr9,88327104,88327879,775,62,514,16,66.3,0.74
CpG: 81,chr9,88438514,88439419,905,81,592,17.9,65.4,0.85
CpG: 22,chr9,88481266,88481474,208,22,134,21.2,64.4,1.13
CpG: 149,chr9,88481758,88483199,1441,149,883,20.7,61.3,1.11
CpG: 56,chr9,88522877,88523429,552,56,330,20.3,59.8,1.14
CpG: 33,chr9,88599530,88599905,375,33,222,17.6,59.2,1.01
CpG: 36,chr9,88719532,88719828,296,36,209,24.3,70.6,1
CpG: 33,chr9,88858876,88859155,279,33,185,23.7,66.3,1.08
CpG: 33,chr9,89066523,89066900,377,33,242,17.5,64.2,0.85
CpG: 36,chr9,89211141,89211437,296,36,210,24.3,70.9,0.99
CpG: 18,chr9,89622411,89622666,255,18,158,14.1,62,0.74
CpG: 52,chr9,89704691,89705333,642,52,399,16.2,62.1,0.84
CpG: 165,chr9,89908631,89911157,2526,165,1377,13.1,54.5,0.89
CpG: 20,chr9,90054522,90054728,206,20,144,19.4,69.9,0.85
CpG: 100,chr9,90113871,90114904,1033,100,677,19.4,65.5,0.96
CpG: 68,chr9,90163082,90163971,889,68,583,15.3,65.6,0.71
CpG: 33,chr9,90270314,90270608,294,33,201,22.4,68.4,0.97
CpG: 25,chr9,91355644,91355937,293,25,179,17.1,61.1,0.92
CpG: 24,chr9,91361457,91361732,275,24,152,17.5,55.3,1.31
CpG: 28,chr9,91362347,91362603,256,28,168,21.9,65.6,1.02
CpG: 123,chr9,91364073,91365462,1389,123,860,17.7,61.9,0.92
CpG: 25,chr9,91365745,91365981,236,25,142,21.2,60.2,1.17
CpG: 45,chr9,91378538,91379204,666,45,413,13.5,62,0.71
CpG: 64,chr9,91381431,91382110,679,64,440,18.9,64.8,0.9
CpG: 41,chr9,91384038,91384491,453,41,284,18.1,62.7,0.92
CpG: 24,chr9,92250368,92250657,289,24,183,16.6,63.3,0.87
CpG: 36,chr9,92457691,92458061,370,36,264,19.5,71.4,0.77
CpG: 76,chr9,92541993,92542767,774,76,515,19.6,66.5,0.89
CpG: 200,chr9,94537088,94539070,1982,200,1233,20.2,62.2,1.05
CpG: 233,chr9,95405215,95407761,2546,233,1698,18.3,66.7,0.82
CpG: 85,chr9,95511289,95512305,1016,85,638,16.7,62.8,0.85
CpG: 155,chr9,95559196,95560865,1669,155,1006,18.6,60.3,1.04
CpG: 63,chr9,95637558,95638082,524,63,388,24,74,0.89
CpG: 76,chr9,95749799,95750466,667,76,456,22.8,68.4,0.98
CpG: 38,chr9,95845015,95845327,312,38,229,24.4,73.4,0.96
CpG: 87,chr9,95857487,95858246,759,87,518,22.9,68.2,0.98
CpG: 43,chr9,95954651,95955093,442,43,295,19.5,66.7,0.88
CpG: 64,chr9,96119146,96119784,638,64,374,20.1,58.6,1.17
CpG: 84,chr9,96196111,96196749,638,84,474,26.3,74.3,0.95
CpG: 117,chr9,96363614,96364869,1255,117,773,18.6,61.6,0.98
CpG: 55,chr9,96478228,96478741,513,55,324,21.4,63.2,1.08
CpG: 26,chr9,96536969,96537199,230,26,173,22.6,75.2,0.91
CpG: 96,chr9,96630710,96631574,864,96,562,22.2,65,1.1
CpG: 81,chr9,96719504,96720064,560,81,430,28.9,76.8,0.99
CpG: 96,chr9,96888889,96889943,1054,96,735,18.2,69.7,0.75
CpG: 34,chr9,96995801,96996226,425,34,283,16,66.6,0.72
CpG: 104,chr9,97018037,97019105,1068,104,733,19.5,68.6,0.83
CpG: 90,chr9,97110593,97111378,785,90,543,22.9,69.2,0.96
CpG: 27,chr9,97365647,97366011,364,27,218,14.8,59.9,0.86
CpG: 18,chr9,97701065,97701306,241,18,169,14.9,70.1,0.72
CpG: 74,chr9,98032720,98033588,868,74,471,17.1,54.3,1.18
CpG: 48,chr9,98296489,98296945,456,48,308,21.1,67.5,0.92
CpG: 32,chr9,98424832,98425125,293,32,199,21.8,67.9,0.97
CpG: 69,chr9,98563278,98564103,825,69,537,16.7,65.1,0.79
CpG: 36,chr9,98601375,98601757,382,36,241,18.8,63.1,0.95
CpG: 40,chr9,98842404,98842785,381,40,268,21,70.3,0.9
CpG: 29,chr9,98856468,98856777,309,29,219,18.8,70.9,0.79
CpG: 37,chr9,98864863,98865214,351,37,257,21.1,73.2,0.85
CpG: 14,chr9,98954655,98954857,202,14,127,13.9,62.9,0.72
CpG: 240,chr9,98954990,98957445,2455,240,1635,19.6,66.6,0.88
CpG: 40,chr9,98973077,98973428,351,40,236,22.8,67.2,1.01
CpG: 79,chr9,98986178,98986886,708,79,496,22.3,70.1,0.93
CpG: 121,chr9,99139555,99140498,943,121,665,25.7,70.5,1.08
CpG: 56,chr9,99243197,99243704,507,56,348,22.1,68.6,0.95
CpG: 69,chr9,99357831,99358560,729,69,491,18.9,67.4,0.84
CpG: 85,chr9,99436274,99437170,896,85,588,19,65.6,0.89
CpG: 36,chr9,99493936,99494372,436,36,278,16.5,63.8,0.84
CpG: 67,chr9,99568296,99568993,697,67,472,19.2,67.7,0.84
CpG: 52,chr9,99575729,99576200,471,52,318,22.1,67.5,0.98
CpG: 39,chr9,99629582,99630044,462,39,301,16.9,65.2,0.81
CpG: 70,chr9,99868720,99869713,993,70,581,14.1,58.5,0.82
CpG: 24,chr9,99870589,99870931,342,24,186,14,54.4,0.95
CpG: 39,chr9,99871339,99871750,411,39,270,19,65.7,0.89
CpG: 97,chr9,99875089,99876419,1330,97,859,14.6,64.6,0.71
CpG: 22,chr9,99947383,99947631,248,22,179,17.7,72.2,0.68
CpG: 111,chr9,100545348,100546343,995,111,688,22.3,69.1,0.94
CpG: 48,chr9,100570748,100571170,422,48,308,22.7,73,0.86
CpG: 160,chr9,100642887,100644491,1604,160,951,20,59.3,1.14
CpG: 53,chr9,101034544,101034960,416,53,271,25.5,65.1,1.2
CpG: 177,chr9,101073465,101075041,1576,177,976,22.5,61.9,1.18
CpG: 21,chr9,101075313,101075600,287,21,154,14.6,53.7,1.02
CpG: 73,chr9,101251054,101251791,737,73,485,19.8,65.8,0.92
CpG: 122,chr9,102353238,102354708,1470,122,945,16.6,64.3,0.81
CpG: 60,chr9,102505893,102506472,579,60,400,20.7,69.1,0.87
CpG: 87,chr9,102625775,102626648,873,87,564,19.9,64.6,0.96
CpG: 36,chr9,102689979,102690345,366,36,253,19.7,69.1,0.83
CpG: 105,chr9,102717597,102718950,1353,105,817,15.5,60.4,0.87
CpG: 73,chr9,102834708,102835546,838,73,430,17.4,51.3,1.33
CpG: 46,chr9,103008326,103008896,570,46,376,16.1,66,0.74
CpG: 78,chr9,103111653,103112627,974,78,578,16,59.3,0.92
CpG: 42,chr9,103201715,103202140,425,42,285,19.8,67.1,0.88
CpG: 69,chr9,103304907,103305617,710,69,428,19.4,60.3,1.07
CpG: 150,chr9,103364567,103366089,1522,150,887,19.7,58.3,1.16
CpG: 77,chr9,103761233,103762090,857,77,535,18,62.4,0.93
CpG: 77,chr9,104002424,104003233,809,77,553,19,68.4,0.82
CpG: 45,chr9,104062728,104063177,449,45,288,20,64.1,0.99
CpG: 98,chr9,104262283,104263188,905,98,638,21.7,70.5,0.87
CpG: 26,chr9,105053227,105053475,248,26,172,21,69.4,0.89
CpG: 56,chr9,105131384,105131847,463,56,324,24.2,70,0.99
CpG: 58,chr9,105395087,105395645,558,58,366,20.8,65.6,0.97
CpG: 101,chr9,105494545,105495594,1049,101,689,19.3,65.7,0.9
CpG: 31,chr9,105642886,105643330,444,31,282,14,63.5,0.7
CpG: 28,chr9,105644568,105644931,363,28,199,15.4,54.8,1.04
CpG: 19,chr9,106159853,106160125,272,19,155,14,57,0.86
CpG: 69,chr9,106170625,106171273,648,69,431,21.3,66.5,0.99
CpG: 47,chr9,106198973,106199339,366,47,283,25.7,77.3,0.87
CpG: 47,chr9,106203006,106203335,329,47,253,28.6,76.9,0.97
CpG: 36,chr9,106226088,106226477,389,36,250,18.5,64.3,0.9
CpG: 62,chr9,106247596,106248183,587,62,394,21.1,67.1,0.94
CpG: 32,chr9,106367642,106368000,358,32,229,17.9,64,0.89
CpG: 85,chr9,106368405,106369453,1048,85,565,16.2,53.9,1.12
CpG: 43,chr9,106429476,106429869,393,43,260,21.9,66.2,1.03
CpG: 24,chr9,106447391,106447745,354,24,230,13.6,65,0.64
CpG: 59,chr9,106453424,106454151,727,59,421,16.2,57.9,1.01
CpG: 93,chr9,106464738,106465734,996,93,636,18.7,63.9,0.93
CpG: 36,chr9,106477062,106477464,402,36,261,17.9,64.9,0.87
CpG: 27,chr9,106647485,106647831,346,27,225,15.6,65,0.74
CpG: 19,chr9,106650797,106651012,215,19,144,17.7,67,0.79
CpG: 24,chr9,106655825,106656079,254,24,173,18.9,68.1,0.82
CpG: 85,chr9,106685322,106686039,717,85,520,23.7,72.5,0.9
CpG: 44,chr9,106788897,106789269,372,44,277,23.7,74.5,0.85
CpG: 80,chr9,106821767,106822620,853,80,545,18.8,63.9,0.92
CpG: 14,chr9,106885069,106885275,206,14,136,13.6,66,0.64
CpG: 186,chr9,106885631,106887477,1846,186,1093,20.2,59.2,1.15
CpG: 83,chr9,106891554,106892561,1007,83,630,16.5,62.6,0.85
CpG: 29,chr9,107193526,107193906,380,29,230,15.3,60.5,0.84
CpG: 98,chr9,107231268,107232140,872,98,576,22.5,66.1,1.03
CpG: 37,chr9,107296546,107297001,455,37,288,16.3,63.3,0.85
CpG: 23,chr9,107338121,107338442,321,23,193,14.3,60.1,0.83
CpG: 46,chr9,107399590,107400052,462,46,260,19.9,56.3,1.27
CpG: 20,chr9,107400282,107400496,214,20,152,18.7,71,0.75
CpG: 18,chr9,107443982,107444251,269,18,149,13.4,55.4,0.88
CpG: 32,chr9,107526629,107527023,394,32,255,16.2,64.7,0.78
CpG: 19,chr9,107527153,107527372,219,19,135,17.4,61.6,0.92
CpG: 49,chr9,107533881,107534563,682,49,409,14.4,60,0.8
CpG: 22,chr9,107534955,107535276,321,22,195,13.7,60.7,0.74
CpG: 57,chr9,107551414,107551915,501,57,344,22.8,68.7,0.97
CpG: 98,chr9,107554098,107555125,1027,98,669,19.1,65.1,0.9
CpG: 41,chr9,107563217,107563531,314,41,231,26.1,73.6,0.97
CpG: 44,chr9,107568998,107569591,593,44,387,14.8,65.3,0.7
CpG: 22,chr9,107570819,107571092,273,22,173,16.1,63.4,0.82
CpG: 16,chr9,107580721,107580925,204,16,128,15.7,62.7,0.83
CpG: 60,chr9,107587474,107588171,697,60,433,17.2,62.1,0.9
CpG: 31,chr9,107598789,107599151,362,31,233,17.1,64.4,0.83
CpG: 28,chr9,107612701,107612978,277,28,193,20.2,69.7,0.83
CpG: 24,chr9,107635122,107635353,231,24,123,20.8,53.2,1.51
CpG: 60,chr9,107675931,107676718,787,60,465,15.2,59.1,0.87
CpG: 78,chr9,107709242,107710020,778,78,477,20.1,61.3,1.07
CpG: 53,chr9,107770367,107771105,738,53,456,14.4,61.8,0.76
CpG: 69,chr9,107872344,107872863,519,69,360,26.6,69.4,1.14
CpG: 25,chr9,107887977,107888293,316,25,210,15.8,66.5,0.72
CpG: 53,chr9,107901213,107901890,677,53,429,15.7,63.4,0.79
CpG: 35,chr9,107935884,107936240,356,35,246,19.7,69.1,0.84
CpG: 33,chr9,107950850,107951281,431,33,257,15.3,59.6,0.86
CpG: 35,chr9,107985777,107986152,375,35,259,18.7,69.1,0.81
CpG: 78,chr9,108002298,108003188,890,78,578,17.5,64.9,0.83
CpG: 43,chr9,108049055,108049582,527,43,325,16.3,61.7,0.86
CpG: 29,chr9,108079157,108079397,240,29,170,24.2,70.8,1.01
CpG: 38,chr9,108094190,108094645,455,38,317,16.7,69.7,0.69
CpG: 33,chr9,108106162,108106582,420,33,274,15.7,65.2,0.74
CpG: 23,chr9,108110489,108110745,256,23,165,18,64.5,0.87
CpG: 23,chr9,108115255,108115488,233,23,154,19.7,66.1,0.92
CpG: 68,chr9,108190030,108190582,552,68,373,24.6,67.6,1.1
CpG: 92,chr9,108263276,108263928,652,92,470,28.2,72.1,1.09
CpG: 109,chr9,108305855,108306930,1075,109,668,20.3,62.1,1.05
CpG: 30,chr9,108339271,108339614,343,30,217,17.5,63.3,0.88
CpG: 22,chr9,108339817,108340089,272,22,157,16.2,57.7,0.98
CpG: 65,chr9,108347630,108348310,680,65,442,19.1,65,0.96
CpG: 35,chr9,108452293,108452689,396,35,264,17.7,66.7,0.8
CpG: 44,chr9,108460504,108460934,430,44,307,20.5,71.4,0.8
CpG: 68,chr9,108490681,108491320,639,68,426,21.3,66.7,0.99
CpG: 123,chr9,108516675,108517931,1256,123,767,19.6,61.1,1.05
CpG: 51,chr9,108560318,108560774,456,51,290,22.4,63.6,1.11
CpG: 101,chr9,108566554,108567818,1264,101,794,16,62.8,0.81
CpG: 60,chr9,108569794,108570460,666,60,423,18,63.5,0.9
CpG: 46,chr9,108578298,108578872,574,46,383,16,66.7,0.76
CpG: 16,chr9,108579051,108579289,238,16,149,13.4,62.6,0.69
CpG: 68,chr9,108597042,108597760,718,68,486,18.9,67.7,0.83
CpG: 105,chr9,108648690,108649537,847,105,571,24.8,67.4,1.09
CpG: 27,chr9,108662075,108662435,360,27,237,15,65.8,0.72
CpG: 113,chr9,108691975,108693007,1032,113,664,21.9,64.3,1.06
CpG: 34,chr9,108783638,108783956,318,34,226,21.4,71.1,0.85
CpG: 51,chr9,108808254,108808715,461,51,275,22.1,59.7,1.25
CpG: 16,chr9,108825097,108825321,224,16,124,14.3,55.4,0.93
CpG: 37,chr9,108825791,108826198,407,37,259,18.2,63.6,0.96
CpG: 83,chr9,108827073,108828002,929,83,570,17.9,61.4,0.95
CpG: 98,chr9,108831849,108832944,1095,98,703,17.9,64.2,0.87
CpG: 43,chr9,108854053,108854666,613,43,387,14,63.1,0.71
CpG: 45,chr9,108936653,108937192,539,45,355,16.7,65.9,0.78
CpG: 51,chr9,109073765,109074323,558,51,363,18.3,65.1,0.86
CpG: 23,chr9,109082125,109082423,298,23,191,15.4,64.1,0.87
CpG: 91,chr9,109095082,109095976,894,91,578,20.4,64.7,0.97
CpG: 92,chr9,109875383,109876383,1000,92,663,18.4,66.3,0.84
CpG: 113,chr9,109931457,109932587,1130,113,784,20,69.4,0.84
CpG: 27,chr9,110100923,110101134,211,27,151,25.6,71.6,1
CpG: 78,chr9,110116968,110117820,852,78,561,18.3,65.8,0.85
CpG: 99,chr9,110131623,110132524,901,99,624,22,69.3,0.93
CpG: 78,chr9,110245005,110245839,834,78,529,18.7,63.4,0.93
CpG: 44,chr9,110304950,110305498,548,44,324,16.1,59.1,0.92
CpG: 67,chr9,110333263,110333737,474,67,349,28.3,73.6,1.05
CpG: 59,chr9,110380486,110381316,830,59,547,14.2,65.9,0.66
CpG: 63,chr9,110407708,110408371,663,63,445,19,67.1,0.84
CpG: 30,chr9,110476471,110476762,291,30,194,20.6,66.7,0.97
CpG: 143,chr9,110531900,110533309,1409,143,868,20.3,61.6,1.09
CpG: 26,chr9,110630002,110630342,340,26,202,15.3,59.4,0.88
CpG: 20,chr9,110638398,110638630,232,20,158,17.2,68.1,0.74
CpG: 69,chr9,110653672,110654307,635,69,458,21.7,72.1,0.84
CpG: 34,chr9,110656521,110656867,346,34,226,19.7,65.3,1
CpG: 41,chr9,110726968,110727405,437,41,294,18.8,67.3,0.83
CpG: 119,chr9,110742722,110744070,1348,119,874,17.7,64.8,0.85
CpG: 61,chr9,110781253,110781945,692,61,458,17.6,66.2,0.81
CpG: 18,chr9,110834515,110834728,213,18,129,16.9,60.6,0.92
CpG: 39,chr9,110857871,110858267,396,39,269,19.7,67.9,0.86
CpG: 34,chr9,110873730,110874092,362,34,253,18.8,69.9,0.77
CpG: 57,chr9,110879961,110880440,479,57,341,23.8,71.2,0.94
CpG: 24,chr9,110953767,110954036,269,24,174,17.8,64.7,0.89
CpG: 97,chr9,111117912,111118651,739,97,556,26.3,75.2,0.93
CpG: 117,chr9,111271111,111272378,1267,117,796,18.5,62.8,0.94
CpG: 192,chr9,111311364,111312804,1440,192,1030,26.7,71.5,1.04
CpG: 60,chr9,111689987,111690485,498,60,372,24.1,74.7,0.86
CpG: 39,chr9,112235147,112235630,483,39,342,16.1,70.8,0.67
CpG: 65,chr9,113707882,113708376,494,65,358,26.3,72.5,1
CpG: 113,chr9,113741167,113742135,968,113,636,23.3,65.7,1.09
CpG: 49,chr9,113988685,113989106,421,49,325,23.3,77.2,0.87
CpG: 30,chr9,114026623,114026853,230,30,169,26.1,73.5,1
CpG: 55,chr9,114057238,114057741,503,55,369,21.9,73.4,0.83
CpG: 44,chr9,114367955,114368395,440,44,285,20,64.8,0.95
CpG: 24,chr9,114384736,114385011,275,24,171,17.5,62.2,0.91
CpG: 89,chr9,114389996,114390730,734,89,514,24.3,70,1.01
CpG: 71,chr9,114401059,114401687,628,71,448,22.6,71.3,0.9
CpG: 243,chr9,114562280,114564596,2316,243,1401,21,60.5,1.15
CpG: 47,chr9,114639827,114640284,457,47,318,20.6,69.6,0.85
CpG: 88,chr9,114688467,114689377,910,88,581,19.3,63.8,0.95
CpG: 44,chr9,114731112,114731542,430,44,301,20.5,70,0.84
CpG: 23,chr9,114752944,114753212,268,23,184,17.2,68.7,0.74
CpG: 73,chr9,114781225,114782048,823,73,576,17.7,70,0.73
CpG: 51,chr9,114843665,114844200,535,51,350,19.1,65.4,0.91
CpG: 64,chr9,114933374,114934034,660,64,469,19.4,71.1,0.78
CpG: 81,chr9,114978046,114979085,1039,81,652,15.6,62.8,0.8
CpG: 167,chr9,115309501,115310991,1490,167,983,22.4,66,1.03
CpG: 83,chr9,116174665,116175439,774,83,548,21.4,70.8,0.86
CpG: 82,chr9,117872168,117873077,909,82,597,18,65.7,0.86
CpG: 108,chr9,118040102,118041216,1114,108,726,19.4,65.2,0.91
CpG: 52,chr9,118149867,118150356,489,52,339,21.3,69.3,0.89
CpG: 30,chr9,118476863,118477213,350,30,191,17.1,54.6,1.15
CpG: 107,chr9,118478480,118479486,1006,107,667,21.3,66.3,0.97
CpG: 83,chr9,118506139,118507181,1042,83,640,15.9,61.4,0.85
CpG: 17,chr9,118559594,118559833,239,17,153,14.2,64,0.77
CpG: 77,chr9,118606598,118607327,729,77,453,21.1,62.1,1.1
CpG: 25,chr9,118925209,118925491,282,25,174,17.7,61.7,0.94
CpG: 101,chr9,118925842,118927072,1230,101,664,16.4,54,1.17
CpG: 45,chr9,119093277,119093775,498,45,346,18.1,69.5,0.75
CpG: 34,chr9,119102656,119102968,312,34,194,21.8,62.2,1.14
CpG: 54,chr9,119156533,119157059,526,54,371,20.5,70.5,0.83
CpG: 23,chr9,119162622,119162858,236,23,154,19.5,65.3,0.92
CpG: 118,chr9,119321884,119323111,1227,118,782,19.2,63.7,0.95
CpG: 34,chr9,119339620,119340000,380,34,243,17.9,63.9,0.88
CpG: 50,chr9,119341510,119341967,457,50,332,21.9,72.6,0.83
CpG: 58,chr9,119357454,119357911,457,58,325,25.4,71.1,1.01
CpG: 139,chr9,119401916,119403600,1684,139,962,16.5,57.1,1.02
CpG: 22,chr9,119427445,119427702,257,22,168,17.1,65.4,0.82
CpG: 44,chr9,119444836,119445177,341,44,234,25.8,68.6,1.11
CpG: 24,chr9,119485633,119485943,310,24,195,15.5,62.9,0.8
CpG: 16,chr9,119486563,119486773,210,16,126,15.2,60,0.88
CpG: 108,chr9,119578474,119579349,875,108,640,24.7,73.1,0.92
CpG: 17,chr9,119609880,119610090,210,17,124,16.2,59,0.98
CpG: 90,chr9,119894747,119895533,786,90,522,22.9,66.4,1.04
CpG: 29,chr9,119937449,119937779,330,29,227,17.6,68.8,0.75
CpG: 17,chr9,119974190,119974410,220,17,139,15.5,63.2,0.78
CpG: 119,chr9,119982977,119984084,1107,119,790,21.5,71.4,0.86
CpG: 52,chr9,120011040,120011521,481,52,323,21.6,67.2,0.96
CpG: 56,chr9,120110302,120110896,594,56,392,18.9,66,0.88
CpG: 74,chr9,120127500,120128163,663,74,445,22.3,67.1,0.99
CpG: 111,chr9,120303647,120304555,908,111,634,24.4,69.8,1
CpG: 95,chr9,120492381,120493084,703,95,509,27,72.4,1.03
CpG: 56,chr9,120571381,120571798,417,56,305,26.9,73.1,1.01
CpG: 46,chr9,120577084,120577580,496,46,315,18.5,63.5,0.92
CpG: 127,chr9,120933178,120934555,1377,127,777,18.4,56.4,1.17
CpG: 69,chr9,121041311,121042430,1119,69,652,12.3,58.3,0.73
CpG: 63,chr9,121277064,121277957,893,63,547,14.1,61.3,0.75
CpG: 47,chr9,121297667,121298089,422,47,276,22.3,65.4,1.04
CpG: 17,chr9,121454340,121454592,252,17,156,13.5,61.9,0.7
CpG: 37,chr9,121494280,121494700,420,37,278,17.6,66.2,0.8
CpG: 128,chr9,121641630,121643111,1481,128,970,17.3,65.5,0.81
CpG: 24,chr9,121669388,121669638,250,24,175,19.2,70,0.79
CpG: 54,chr9,121704737,121705299,562,54,385,19.2,68.5,0.83
CpG: 46,chr9,121710259,121710778,519,46,328,17.7,63.2,0.89
CpG: 121,chr9,121718812,121720052,1240,121,732,19.5,59,1.12
CpG: 125,chr9,121759208,121760621,1413,125,899,17.7,63.6,0.88
CpG: 33,chr9,121762634,121763050,416,33,267,15.9,64.2,0.78
CpG: 76,chr9,121777769,121778530,761,76,495,20,65,0.94
CpG: 17,chr9,121788890,121789132,242,17,147,14,60.7,0.81
CpG: 57,chr9,121838954,121839539,585,57,383,19.5,65.5,0.95
CpG: 102,chr9,121857013,121857963,950,102,670,21.5,70.5,0.88
CpG: 43,chr9,121995664,121996058,394,43,293,21.8,74.4,0.8
CpG: 93,chr9,122117183,122117893,710,93,462,26.2,65.1,1.24
CpG: 33,chr9,122166543,122166962,419,33,272,15.8,64.9,0.75
CpG: 59,chr9,122293954,122294592,638,59,434,18.5,68,0.8
CpG: 106,chr9,122351443,122352187,744,106,530,28.5,71.2,1.13
CpG: 92,chr9,122568822,122569788,966,92,666,19,68.9,0.81
CpG: 22,chr9,122571416,122571675,259,22,156,17,60.2,0.94
CpG: 56,chr9,122572205,122572723,518,56,360,21.6,69.5,0.9
CpG: 25,chr9,122747129,122747451,322,25,228,15.5,70.8,0.62
CpG: 31,chr9,122805526,122805858,332,31,215,18.7,64.8,0.89
CpG: 28,chr9,122865758,122866007,249,28,172,22.5,69.1,1
CpG: 47,chr9,122886825,122887174,349,47,241,26.9,69.1,1.15
CpG: 17,chr9,122903301,122903536,235,17,161,14.5,68.5,0.63
CpG: 40,chr9,122922930,122923275,345,40,250,23.2,72.5,0.89
CpG: 60,chr9,122950701,122951318,617,60,394,19.4,63.9,0.96
CpG: 57,chr9,123021110,123021592,482,57,325,23.7,67.4,1.04
CpG: 79,chr9,123112851,123113510,659,79,466,24,70.7,0.96
CpG: 35,chr9,123156818,123157109,291,35,194,24.1,66.7,1.09
CpG: 37,chr9,123215689,123216077,388,37,278,19.1,71.6,0.75
CpG: 157,chr9,123259607,123260965,1358,157,938,23.1,69.1,0.98
CpG: 27,chr9,123366754,123367131,377,27,240,14.3,63.7,0.71
CpG: 74,chr9,123529580,123530197,617,74,442,24,71.6,0.94
CpG: 75,chr9,123678266,123678959,693,75,452,21.6,65.2,1.02
CpG: 37,chr9,123717377,123717806,429,37,257,17.2,59.9,0.96
CpG: 59,chr9,123851491,123852159,668,59,423,17.7,63.3,0.88
CpG: 21,chr9,123923115,123923338,223,21,145,18.8,65,0.89
CpG: 75,chr9,123924689,123925609,920,75,528,16.3,57.4,0.99
CpG: 22,chr9,124422552,124422772,220,22,152,20,69.1,0.86
CpG: 256,chr9,124423168,124426073,2905,256,1746,17.6,60.1,0.99
CpG: 44,chr9,124441650,124442281,631,44,426,13.9,67.5,0.62
CpG: 30,chrX,5467930,5468230,300,30,186,20,62,1.04
CpG: 18,chrX,5468555,5468767,212,18,143,17,67.5,0.75
CpG: 122,chrX,6047291,6048447,1156,122,697,21.1,60.3,1.16
CpG: 99,chrX,6081940,6083368,1428,99,912,13.9,63.9,0.68
CpG: 128,chrX,6172298,6173448,1150,128,716,22.3,62.3,1.15
CpG: 77,chrX,6400082,6400901,819,77,590,18.8,72,0.73
CpG: 80,chrX,7318572,7319439,867,80,590,18.5,68.1,0.8
CpG: 100,chrX,7573383,7574510,1127,100,699,17.7,62,0.92
CpG: 18,chrX,7610126,7610349,223,18,133,16.1,59.6,0.92
CpG: 23,chrX,7638486,7638762,276,23,166,16.7,60.1,0.95
CpG: 19,chrX,7648627,7648856,229,19,157,16.6,68.6,0.71
CpG: 27,chrX,7671176,7671473,297,27,207,18.2,69.7,0.75
CpG: 28,chrX,7697149,7697417,268,28,168,20.9,62.7,1.06
CpG: 46,chrX,7714169,7714593,424,46,288,21.7,67.9,0.94
CpG: 28,chrX,7728374,7728692,318,28,196,17.6,61.6,0.93
CpG: 48,chrX,7750510,7751053,543,48,335,17.7,61.7,0.93
CpG: 43,chrX,7762498,7763008,510,43,344,16.9,67.5,0.75
CpG: 116,chrX,7841567,7842696,1129,116,736,20.5,65.2,0.97
CpG: 65,chrX,7878013,7878789,776,65,497,16.8,64,0.82
CpG: 45,chrX,7884049,7884621,572,45,352,15.7,61.5,0.86
CpG: 43,chrX,7899237,7899651,414,43,269,20.8,65,0.99
CpG: 88,chrX,7922053,7923087,1034,88,688,17,66.5,0.77
CpG: 47,chrX,7947659,7948269,610,47,391,15.4,64.1,0.87
CpG: 85,chrX,8073890,8074841,951,85,558,17.9,58.7,1.09
CpG: 46,chrX,8096486,8096908,422,46,286,21.8,67.8,0.95
CpG: 19,chrX,8129015,8129265,250,19,166,15.2,66.4,0.72
CpG: 57,chrX,8145265,8145872,607,57,380,18.8,62.6,0.96
CpG: 45,chrX,8175668,8176167,499,45,323,18,64.7,0.87
CpG: 25,chrX,8192653,8192922,269,25,178,18.6,66.2,0.85
CpG: 40,chrX,8206309,8206720,411,40,285,19.5,69.3,0.81
CpG: 61,chrX,8892321,8892932,611,61,412,20,67.4,0.88
CpG: 105,chrX,9199822,9200810,988,105,694,21.3,70.2,0.86
CpG: 76,chrX,9272617,9273270,653,76,427,23.3,65.4,1.09
CpG: 21,chrX,9328024,9328246,222,21,153,18.9,68.9,0.8
CpG: 41,chrX,10216402,10216886,484,41,302,16.9,62.4,0.87
CpG: 105,chrX,10717162,10718695,1533,105,918,13.7,59.9,0.76
CpG: 26,chrX,11492064,11492389,325,26,194,16,59.7,0.9
CpG: 70,chrX,11664570,11665341,771,70,493,18.2,63.9,0.89
CpG: 86,chrX,11807041,11807919,878,86,544,19.6,62,1.02
CpG: 48,chrX,11999031,11999458,427,48,304,22.5,71.2,0.89
CpG: 102,chrX,12006280,12007396,1116,102,699,18.3,62.6,0.94
CpG: 407,chrX,12076861,12081915,5054,407,3083,16.1,61,0.87
CpG: 378,chrX,12086982,12092060,5078,378,3159,14.9,62.2,0.77
CpG: 94,chrX,12127757,12128822,1065,94,661,17.7,62.1,0.92
CpG: 47,chrX,12133306,12133812,506,47,338,18.6,66.8,0.84
CpG: 41,chrX,12135572,12136053,481,41,260,17,54.1,1.18
CpG: 69,chrX,12136636,12137563,927,69,583,14.9,62.9,0.75
CpG: 43,chrX,12140168,12140599,431,43,308,20,71.5,0.78
CpG: 21,chrX,12152543,12152829,286,21,166,14.7,58,0.88
CpG: 34,chrX,12155820,12156282,462,34,291,14.7,63,0.75
CpG: 144,chrX,12158454,12160573,2119,144,1278,13.6,60.3,0.76
CpG: 24,chrX,12252439,12252771,332,24,196,14.5,59,0.83
CpG: 61,chrX,12587420,12588165,745,61,477,16.4,64,0.81
CpG: 31,chrX,12673296,12673657,361,31,235,17.2,65.1,0.81
CpG: 106,chrX,12761454,12762429,975,106,661,21.7,67.8,0.96
CpG: 25,chrX,12936819,12937040,221,25,156,22.6,70.6,0.91
CpG: 149,chrX,13071658,13073089,1431,149,962,20.8,67.2,0.92
CpG: 132,chrX,13280833,13282108,1275,132,884,20.7,69.3,0.88
CpG: 40,chrX,13461561,13462055,494,40,319,16.2,64.6,0.78
CpG: 98,chrX,13485964,13486707,743,98,542,26.4,72.9,1
CpG: 128,chrX,13845930,13847105,1175,128,765,21.8,65.1,1.03
CpG: 50,chrX,16618454,16618959,505,50,338,19.8,66.9,0.88
CpG: 157,chrX,18161828,18163568,1740,157,1129,18,64.9,0.86
CpG: 130,chrX,20059887,20061120,1233,130,824,21.1,66.8,0.95
CpG: 53,chrX,20291470,20292021,551,53,374,19.2,67.9,0.86
CpG: 106,chrX,20425211,20426229,1018,106,712,20.8,69.9,0.88
CpG: 92,chrX,20617032,20618390,1358,92,790,13.5,58.2,0.81
CpG: 52,chrX,20688266,20688821,555,52,331,18.7,59.6,1.05
CpG: 52,chrX,20703880,20704574,694,52,427,15,61.5,0.87
CpG: 19,chrX,20848632,20848843,211,19,131,18,62.1,0.96
CpG: 78,chrX,20920388,20921176,788,78,527,19.8,66.9,0.91
CpG: 49,chrX,20961593,20962204,611,49,358,16,58.6,0.94
CpG: 27,chrX,21360815,21361072,257,27,155,21,60.3,1.16
CpG: 24,chrX,23364638,23364890,252,24,169,19,67.1,0.85
CpG: 56,chrX,23692796,23693484,688,56,434,16.3,63.1,0.85
CpG: 79,chrX,35888493,35889392,899,79,605,17.6,67.3,0.78
CpG: 27,chrX,36025584,36025921,337,27,221,16,65.6,0.75
CpG: 52,chrX,36111947,36112448,501,52,363,20.8,72.5,0.81
CpG: 110,chrX,36328331,36329513,1182,110,771,18.6,65.2,0.88
CpG: 26,chrX,36329941,36330273,332,26,205,15.7,61.7,0.83
CpG: 81,chrX,36597987,36598863,876,81,600,18.5,68.5,0.8
CpG: 45,chrX,36644909,36645291,382,45,272,23.6,71.2,0.94
CpG: 32,chrX,36743647,36744050,403,32,288,15.9,71.5,0.63
CpG: 79,chrX,36795484,36796444,960,79,619,16.5,64.5,0.79
CpG: 33,chrX,36807777,36808136,359,33,220,18.4,61.3,0.99
CpG: 32,chrX,36864080,36864444,364,32,199,17.6,54.7,1.18
CpG: 87,chrX,36874238,36875133,895,87,582,19.4,65,0.93
CpG: 102,chrX,37048391,37049821,1430,102,924,14.3,64.6,0.69
CpG: 25,chrX,37085091,37085344,253,25,153,19.8,60.5,1.11
CpG: 35,chrX,37110106,37110559,453,35,266,15.5,58.7,0.92
CpG: 49,chrX,37126928,37127320,392,49,259,25,66.1,1.17
CpG: 82,chrX,37190898,37191746,848,82,535,19.3,63.1,0.97
CpG: 17,chrX,37826912,37827155,243,17,137,14,56.4,0.88
CpG: 17,chrX,37901621,37901864,243,17,138,14,56.8,0.87
CpG: 50,chrX,38121101,38121770,669,50,382,14.9,57.1,0.92
CpG: 30,chrX,38180828,38181252,424,30,267,14.2,63,0.73
CpG: 62,chrX,38189630,38190218,588,62,402,21.1,68.4,0.9
CpG: 51,chrX,38564661,38565174,513,51,363,19.9,70.8,0.81
CpG: 29,chrX,38634977,38635341,364,29,213,15.9,58.5,0.94
CpG: 15,chrX,41401379,41401588,209,15,114,14.4,54.5,1.09
CpG: 74,chrX,41911041,41911984,943,74,569,15.7,60.3,0.86
CpG: 44,chrX,42067966,42068482,516,44,341,17.1,66.1,0.81
CpG: 150,chrX,42148875,42150543,1668,150,1012,18,60.7,0.98
CpG: 24,chrX,44367765,44367980,215,24,154,22.3,71.6,0.9
CpG: 68,chrX,44789364,44790107,743,68,492,18.3,66.2,0.84
CpG: 22,chrX,47892197,47892471,274,22,176,16.1,64.2,0.78
CpG: 25,chrX,47912383,47912670,287,25,177,17.4,61.7,0.92
CpG: 59,chrX,48034217,48034823,606,59,421,19.5,69.5,0.81
CpG: 28,chrX,48256600,48256976,376,28,212,14.9,56.4,0.95
CpG: 38,chrX,48285660,48286068,408,38,282,18.6,69.1,0.82
CpG: 34,chrX,48314668,48315112,444,34,294,15.3,66.2,0.72
CpG: 123,chrX,48340779,48342328,1549,123,897,15.9,57.9,0.95
CpG: 47,chrX,48343642,48344234,592,47,368,15.9,62.2,0.84
CpG: 39,chrX,48345387,48345786,399,39,296,19.5,74.2,0.82
CpG: 29,chrX,48409934,48410363,429,29,275,13.5,64.1,0.66
CpG: 136,chrX,48452905,48454662,1757,136,951,15.5,54.1,1.06
CpG: 39,chrX,48513243,48513650,407,39,267,19.2,65.6,0.92
CpG: 29,chrX,48594101,48594385,284,29,199,20.4,70.1,0.84
CpG: 38,chrX,48694957,48695316,359,38,237,21.2,66,1
CpG: 42,chrX,49493802,49494341,539,42,344,15.6,63.8,0.78
CpG: 26,chrX,50373694,50374012,318,26,180,16.4,56.6,1.02
CpG: 40,chrX,50841308,50841887,579,40,389,13.8,67.2,0.61
CpG: 94,chrX,51017949,51019069,1120,94,645,16.8,57.6,1.02
CpG: 109,chrX,51204809,51206256,1447,109,805,15.1,55.6,0.99
CpG: 151,chrX,51679908,51681589,1681,151,1130,18,67.2,0.8
CpG: 120,chrX,52164145,52165542,1397,120,904,17.2,64.7,0.83
CpG: 16,chrX,52612365,52612567,202,16,126,15.8,62.4,0.82
CpG: 53,chrX,52613529,52614260,731,53,437,14.5,59.8,0.82
CpG: 35,chrX,52744262,52744655,393,35,266,17.8,67.7,0.79
CpG: 18,chrX,52772570,52772774,204,18,116,17.6,56.9,1.1
CpG: 19,chrX,52791109,52791365,256,19,169,14.8,66,0.68
CpG: 66,chrX,52912081,52912673,592,66,408,22.3,68.9,0.94
CpG: 66,chrX,52988002,52988623,621,66,449,21.3,72.3,0.84
CpG: 51,chrX,53056746,53057331,585,51,324,17.4,55.4,1.23
CpG: 40,chrX,53269443,53270006,563,40,356,14.2,63.2,0.72
CpG: 35,chrX,53643106,53643564,458,35,300,15.3,65.5,0.71
CpG: 35,chrX,53669783,53670241,458,35,300,15.3,65.5,0.71
CpG: 36,chrX,53716419,53716738,319,36,219,22.6,68.7,0.96
CpG: 17,chrX,53756476,53756727,251,17,162,13.5,64.5,0.78
CpG: 35,chrX,53974656,53974995,339,35,216,20.6,63.7,1.03
CpG: 18,chrX,55643327,55643560,233,18,161,15.5,69.1,0.65
CpG: 48,chrX,56374455,56374954,499,48,342,19.2,68.5,0.83
CpG: 52,chrX,56455389,56455975,586,52,398,17.7,67.9,0.78
CpG: 45,chrX,56597753,56598227,474,45,302,19,63.7,0.95
CpG: 43,chrX,56609736,56610169,433,43,306,19.9,70.7,0.8
CpG: 92,chrX,56731284,56732129,845,92,546,21.8,64.6,1.07
CpG: 89,chrX,57053169,57054001,832,89,560,21.4,67.3,0.94
CpG: 35,chrX,57392570,57393038,468,35,269,15,57.5,0.92
CpG: 40,chrX,57503513,57503908,395,40,274,20.3,69.4,0.84
CpG: 19,chrX,58018705,58018950,245,19,139,15.5,56.7,0.97
CpG: 17,chrX,58019185,58019416,231,17,141,14.7,61,0.79
CpG: 36,chrX,58030331,58030804,473,36,308,15.2,65.1,0.72
CpG: 42,chrX,58031488,58031908,420,42,279,20,66.4,0.91
CpG: 78,chrX,58038097,58039089,992,78,621,15.7,62.6,0.81
CpG: 70,chrX,59134005,59134821,816,70,490,17.2,60,0.96
CpG: 93,chrX,59567234,59568293,1059,93,629,17.6,59.4,1
CpG: 112,chrX,60403519,60404585,1066,112,666,21,62.5,1.08
CpG: 36,chrX,60547375,60547586,211,36,171,34.1,81,1.07
CpG: 23,chrX,60547892,60548176,284,23,157,16.2,55.3,1.12
CpG: 24,chrX,60890797,60891120,323,24,173,14.9,53.6,1.04
CpG: 225,chrX,60891898,60894539,2641,225,1616,17,61.2,0.92
CpG: 28,chrX,64275774,64276014,240,28,171,23.3,71.2,0.92
CpG: 33,chrX,64276704,64277035,331,33,217,19.9,65.6,0.96
CpG: 117,chrX,68678183,68679412,1229,117,790,19,64.3,0.93
CpG: 35,chrX,68821095,68821401,306,35,227,22.9,74.2,0.84
CpG: 39,chrX,69360457,69360750,293,39,220,26.6,75.1,0.95
CpG: 26,chrX,70364871,70365161,290,26,159,17.9,54.8,1.2
CpG: 27,chrX,70476908,70477210,302,27,181,17.9,59.9,1.03
CpG: 36,chrX,71049980,71050379,399,36,246,18,61.7,0.96
CpG: 21,chrX,71050987,71051289,302,21,179,13.9,59.3,0.79
CpG: 62,chrX,71364633,71365169,536,62,403,23.1,75.2,0.82
CpG: 146,chrX,71555709,71557237,1528,146,872,19.1,57.1,1.18
CpG: 62,chrX,71664218,71664718,500,62,340,24.8,68,1.08
CpG: 64,chrX,71816448,71816991,543,64,371,23.6,68.3,1.02
CpG: 68,chrX,71962283,71963047,764,68,559,17.8,73.2,0.68
CpG: 36,chrX,72274703,72275156,453,36,315,15.9,69.5,0.68
CpG: 39,chrX,72825026,72825488,462,39,311,16.9,67.3,0.75
CpG: 25,chrX,72918211,72918481,270,25,169,18.5,62.6,0.95
CpG: 32,chrX,72987283,72987564,281,32,198,22.8,70.5,0.92
CpG: 83,chrX,73228176,73229138,962,83,665,17.3,69.1,0.72
CpG: 34,chrX,73342542,73342846,304,34,214,22.4,70.4,0.92
CpG: 34,chrX,73353887,73354378,491,34,308,13.8,62.7,0.7
CpG: 37,chrX,73421939,73422448,509,37,311,14.5,61.1,0.78
CpG: 46,chrX,73503078,73503605,527,46,308,17.5,58.4,1.02
CpG: 25,chrX,73637256,73637560,304,25,204,16.4,67.1,0.74
CpG: 67,chrX,73639459,73640416,957,67,605,14,63.2,0.7
CpG: 23,chrX,73659698,73659904,206,23,146,22.3,70.9,0.9
CpG: 42,chrX,73673147,73673484,337,42,249,24.9,73.9,0.92
CpG: 26,chrX,73673792,73674047,255,26,164,20.4,64.3,0.99
CpG: 50,chrX,73716076,73716670,594,50,391,16.8,65.8,0.78
CpG: 54,chrX,73786896,73787489,593,54,381,18.2,64.2,0.89
CpG: 23,chrX,73823442,73823695,253,23,169,18.2,66.8,0.82
CpG: 72,chrX,73824350,73825094,744,72,527,19.4,70.8,0.78
CpG: 62,chrX,73921592,73922345,753,62,469,16.5,62.3,0.85
CpG: 135,chrX,73965822,73967884,2062,135,1235,13.1,59.9,0.74
CpG: 54,chrX,74023384,74023956,572,54,337,18.9,58.9,1.09
CpG: 78,chrX,74085010,74085723,713,78,483,21.9,67.7,0.95
CpG: 71,chrX,74245775,74246710,935,71,568,15.2,60.7,0.82
CpG: 53,chrX,74254576,74255249,673,53,419,15.8,62.3,0.83
CpG: 18,chrX,74270701,74270912,211,18,118,17.1,55.9,1.1
CpG: 42,chrX,74312929,74313457,528,42,302,15.9,57.2,0.97
CpG: 27,chrX,74328942,74329203,261,27,193,20.7,73.9,0.76
CpG: 35,chrX,74368245,74368698,453,35,287,15.5,63.4,0.78
CpG: 29,chrX,74373091,74373440,349,29,228,16.6,65.3,0.81
CpG: 17,chrX,74392977,74393208,231,17,145,14.7,62.8,0.76
CpG: 24,chrX,74428745,74429073,328,24,198,14.6,60.4,0.81
CpG: 30,chrX,75095844,75096237,393,30,220,15.3,56,0.98
CpG: 36,chrX,75130717,75131225,508,36,300,14.2,59.1,0.82
CpG: 45,chrX,75143197,75143602,405,45,282,22.2,69.6,0.92
CpG: 41,chrX,75416284,75416724,440,41,298,18.6,67.7,0.82
CpG: 33,chrX,75475402,75475665,263,33,186,25.1,70.7,1
CpG: 25,chrX,75577766,75578109,343,25,216,14.6,63,0.74
CpG: 42,chrX,75723624,75723957,333,42,246,25.2,73.9,0.92
CpG: 33,chrX,75966479,75966827,348,33,235,19,67.5,0.84
CpG: 18,chrX,77433587,77433797,210,18,137,17.1,65.2,0.81
CpG: 104,chrX,77510719,77511741,1022,104,701,20.4,68.6,0.87
CpG: 80,chrX,77795221,77796090,869,80,574,18.4,66.1,0.85
CpG: 22,chrX,78583589,78583838,249,22,161,17.7,64.7,0.92
CpG: 69,chrX,81070443,81071237,794,69,520,17.4,65.5,0.81
CpG: 86,chrX,85573658,85574475,817,86,573,21.1,70.1,0.87
CpG: 55,chrX,85776538,85777198,660,55,438,16.7,66.4,0.76
CpG: 49,chrX,86191680,86192314,634,49,417,15.5,65.8,0.72
CpG: 23,chrX,93286379,93286608,229,23,147,20.1,64.2,0.98
CpG: 83,chrX,93288436,93289354,918,83,562,18.1,61.2,0.97
CpG: 23,chrX,93294624,93294867,243,23,180,18.9,74.1,0.72
CpG: 40,chrX,93297070,93297442,372,40,265,21.5,71.2,0.85
CpG: 24,chrX,93299077,93299336,259,24,171,18.5,66,0.86
CpG: 44,chrX,93631949,93632435,486,44,301,18.1,61.9,0.95
CpG: 60,chrX,93831877,93832375,498,60,350,24.1,70.3,0.98
CpG: 88,chrX,93922130,93923050,920,88,619,19.1,67.3,0.88
CpG: 43,chrX,93980602,93981076,474,43,286,18.1,60.3,1.01
CpG: 25,chrX,93988676,93988893,217,25,160,23,73.7,0.85
CpG: 180,chrX,94122087,94123678,1591,180,1109,22.6,69.7,0.94
CpG: 17,chrX,94177634,94177877,243,17,145,14,59.7,0.8
CpG: 31,chrX,94177980,94178252,272,31,166,22.8,61,1.26
CpG: 50,chrX,94212660,94213312,652,50,369,15.3,56.6,0.96
CpG: 103,chrX,94234295,94235516,1221,103,769,16.9,63,0.86
CpG: 45,chrX,94366646,94367151,505,45,326,17.8,64.6,0.86
CpG: 78,chrX,94541067,94542086,1019,78,624,15.3,61.2,0.84
CpG: 49,chrX,94636071,94636563,492,49,332,19.9,67.5,0.9
CpG: 165,chrX,94724498,94726531,2033,165,1179,16.2,58,0.97
CpG: 17,chrX,94726670,94726878,208,17,128,16.3,61.5,0.86
CpG: 44,chrX,94773746,94774247,501,44,300,17.6,59.9,1.02
CpG: 17,chrX,94795980,94796188,208,17,128,16.3,61.5,0.86
CpG: 158,chrX,94796327,94798359,2032,158,1146,15.6,56.4,0.98
CpG: 18,chrX,94990585,94990809,224,18,162,16.1,72.3,0.66
CpG: 23,chrX,95026432,95026700,268,23,165,17.2,61.6,0.91
CpG: 16,chrX,95196398,95196632,234,16,151,13.7,64.5,0.66
CpG: 20,chrX,95444298,95444518,220,20,149,18.2,67.7,0.84
CpG: 46,chrX,95711569,95712121,552,46,366,16.7,66.3,0.77
CpG: 26,chrX,95956766,95957085,319,26,192,16.3,60.2,0.92
CpG: 17,chrX,95968348,95968586,238,17,160,14.3,67.2,0.71
CpG: 30,chrX,96095958,96096269,311,30,203,19.3,65.3,0.91
CpG: 16,chrX,97072492,97072696,204,16,138,15.7,67.6,0.69
CpG: 47,chrX,98890404,98891060,656,47,413,14.3,63,0.72
CpG: 32,chrX,98937954,98938199,245,32,170,26.1,69.4,1.09
CpG: 39,chrX,99042589,99043122,533,39,339,14.6,63.6,0.72
CpG: 98,chrX,99136111,99137250,1139,98,741,17.2,65.1,0.84
CpG: 58,chrX,99216696,99217204,508,58,370,22.8,72.8,0.86
CpG: 40,chrX,99470415,99470856,441,40,300,18.1,68,0.79
CpG: 143,chrX,99819862,99821609,1747,143,952,16.4,54.5,1.1
CpG: 35,chrX,99853294,99853737,443,35,312,15.8,70.4,0.64
CpG: 28,chrX,100429023,100429392,369,28,214,15.2,58,0.9
CpG: 45,chrX,100625777,100626269,492,45,301,18.3,61.2,0.98
CpG: 37,chrX,100777002,100777406,404,37,236,18.3,58.4,1.08
CpG: 30,chrX,101059591,101059915,324,30,187,18.5,57.7,1.13
CpG: 35,chrX,101222180,101222590,410,35,244,17.1,59.5,0.98
CpG: 78,chrX,101254032,101255222,1190,78,739,13.1,62.1,0.71
CpG: 23,chrX,101273844,101274103,259,23,168,17.8,64.9,0.85
CpG: 25,chrX,101384706,101385003,297,25,186,16.8,62.6,0.87
CpG: 39,chrX,101419638,101420088,450,39,308,17.3,68.4,0.74
CpG: 42,chrX,101429438,101429960,522,42,318,16.1,60.9,0.87
CpG: 41,chrX,101532486,101533085,599,41,347,13.7,57.9,0.82
CpG: 227,chrX,101695812,101697996,2184,227,1450,20.8,66.4,1.14
CpG: 17,chrX,101698301,101698506,205,17,126,16.6,61.5,0.9
CpG: 16,chrX,101768511,101768712,201,16,121,15.9,60.2,0.88
CpG: 42,chrX,101794171,101794751,580,42,351,14.5,60.5,0.79
CpG: 120,chrX,101849379,101850502,1123,120,795,21.4,70.8,0.86
CpG: 48,chrX,102070951,102071451,500,48,334,19.2,66.8,0.87
CpG: 31,chrX,102157022,102157380,358,31,210,17.3,58.7,1.03
CpG: 33,chrX,102178466,102178786,320,33,215,20.6,67.2,0.93
CpG: 22,chrX,102189190,102189422,232,22,150,19,64.7,0.91
CpG: 198,chrX,102250047,102252330,2283,198,1461,17.3,64,0.85
CpG: 54,chrX,102643877,102644382,505,54,353,21.4,69.9,0.88
CpG: 67,chrX,102933586,102934272,686,67,497,19.5,72.4,0.75
CpG: 53,chrX,103013659,103014383,724,53,444,14.6,61.3,0.78
CpG: 53,chrX,103066551,103067275,724,53,444,14.6,61.3,0.78
CpG: 30,chrX,103165308,103165560,252,30,167,23.8,66.3,1.08
CpG: 17,chrX,103227708,103227930,222,17,133,15.3,59.9,0.85
CpG: 30,chrX,103356256,103356629,373,30,230,16.1,61.7,0.92
CpG: 23,chrX,103447736,103447985,249,23,152,18.5,61,0.99
CpG: 22,chrX,103482090,103482350,260,22,142,16.9,54.6,1.18
CpG: 48,chrX,103493348,103493830,482,48,308,19.9,63.9,0.98
CpG: 19,chrX,103614849,103615104,255,19,161,14.9,63.1,0.77
CpG: 25,chrX,103616838,103617098,260,25,132,19.2,50.8,1.51
CpG: 25,chrX,103623525,103623769,244,25,151,20.5,61.9,1.07
CpG: 42,chrX,103695100,103695616,516,42,350,16.3,67.8,0.73
CpG: 55,chrX,103980676,103981224,548,55,372,20.1,67.9,0.88
CpG: 159,chrX,104199636,104201068,1432,159,937,22.2,65.4,1.04
CpG: 28,chrX,104348236,104348496,260,28,178,21.5,68.5,0.92
CpG: 36,chrX,104413641,104413932,291,36,193,24.7,66.3,1.13
CpG: 16,chrX,104482935,104483161,226,16,135,14.2,59.7,0.8
CpG: 30,chrX,104670705,104670977,272,30,194,22.1,71.3,0.87
CpG: 25,chrX,104856787,104857089,302,25,188,16.6,62.3,0.86
CpG: 25,chrX,105079623,105079843,220,25,139,22.7,63.2,1.14
CpG: 99,chrX,105120300,105121742,1442,99,926,13.7,64.2,0.67
CpG: 25,chrX,105152054,105152335,281,25,194,17.8,69,0.78
CpG: 88,chrX,105764341,105765297,956,88,601,18.4,62.9,0.93
CpG: 92,chrX,105928103,105929197,1094,92,600,16.8,54.8,1.13
CpG: 43,chrX,106011556,106012093,537,43,313,16,58.3,0.95
CpG: 30,chrX,106027092,106027408,316,30,220,19,69.6,0.79
CpG: 34,chrX,106186843,106187324,481,34,256,14.1,53.2,1
CpG: 41,chrX,106219446,106219884,438,41,301,18.7,68.7,0.8
CpG: 16,chrX,106220527,106220757,230,16,119,13.9,51.7,1.07
CpG: 49,chrX,107815894,107816563,669,49,419,14.6,62.6,0.75
CpG: 22,chrX,108834054,108834294,240,22,159,18.3,66.2,0.84
CpG: 24,chrX,109013333,109013641,308,24,175,15.6,56.8,0.97
CpG: 21,chrX,110814703,110814906,203,21,129,20.7,63.5,1.06
CpG: 99,chrX,111462527,111463635,1108,99,768,17.9,69.3,0.75
CpG: 15,chrX,111696959,111697165,206,15,115,14.6,55.8,0.93
CpG: 100,chrX,111894413,111895559,1146,100,637,17.5,55.6,1.14
CpG: 126,chrX,112600487,112601782,1295,126,804,19.5,62.1,1.01
CpG: 18,chrX,119927144,119927352,208,18,137,17.3,65.9,0.82
CpG: 27,chrX,120290331,120290740,409,27,243,13.2,59.4,0.75
CpG: 28,chrX,120292867,120293139,272,28,187,20.6,68.8,0.87
CpG: 65,chrX,129749591,129750362,771,65,470,16.9,61,0.91
CpG: 114,chrX,133686621,133687857,1236,114,827,18.4,66.9,0.82
CpG: 32,chrX,133688630,133689081,451,32,272,14.2,60.3,0.8
CpG: 20,chrX,133898277,133898499,222,20,127,18,57.2,1.1
CpG: 65,chrX,134059097,134059673,576,65,396,22.6,68.8,0.96
CpG: 31,chrX,134307984,134308217,233,31,159,26.6,68.2,1.15
CpG: 120,chrX,134474995,134476624,1629,120,1008,14.7,61.9,0.78
CpG: 25,chrX,134488930,134489161,231,25,165,21.6,71.4,0.86
CpG: 47,chrX,134541430,134541847,417,47,269,22.5,64.5,1.09
CpG: 45,chrX,134585442,134586100,658,45,370,13.7,56.2,0.87
CpG: 57,chrX,134601154,134601915,761,57,406,15,53.4,1.06
CpG: 26,chrX,134625889,134626144,255,26,183,20.4,71.8,0.79
CpG: 25,chrX,134686384,134686627,243,25,173,20.6,71.2,0.83
CpG: 32,chrX,135008815,135009106,291,32,206,22,70.8,0.88
CpG: 18,chrX,135036000,135036213,213,18,139,16.9,65.3,0.81
CpG: 42,chrX,135742430,135742942,512,42,291,16.4,56.8,1.02
CpG: 34,chrX,135796049,135796497,448,34,301,15.2,67.2,0.68
CpG: 25,chrX,135838975,135839299,324,25,216,15.4,66.7,0.7
CpG: 41,chrX,135885798,135886258,460,41,323,17.8,70.2,0.73
CpG: 35,chrX,135993777,135994085,308,35,195,22.7,63.3,1.13
CpG: 36,chrX,136033324,136033632,308,36,196,23.4,63.6,1.15
CpG: 61,chrX,136067851,136068291,440,61,345,27.7,78.4,0.93
CpG: 55,chrX,136138953,136139471,518,55,366,21.2,70.7,0.86
CpG: 54,chrX,136215031,136215549,518,54,366,20.8,70.7,0.85
CpG: 60,chrX,136270160,136270600,440,60,344,27.3,78.2,0.92
CpG: 58,chrX,136741524,136742212,688,58,421,16.9,61.2,0.92
CpG: 23,chrX,136927693,136928019,326,23,174,14.1,53.4,0.99
CpG: 16,chrX,136929522,136929744,222,16,144,14.4,64.9,0.72
CpG: 29,chrX,137038014,137038370,356,29,226,16.3,63.5,0.84
CpG: 41,chrX,137049429,137049890,461,41,302,17.8,65.5,0.84
CpG: 23,chrX,137118148,137118463,315,23,203,14.6,64.4,0.71
CpG: 16,chrX,137118530,137118753,223,16,144,14.3,64.6,0.69
CpG: 56,chrX,137118899,137119282,383,56,282,29.2,73.6,1.16
CpG: 27,chrX,137570910,137571192,282,27,201,19.1,71.3,0.76
CpG: 27,chrX,138914222,138914485,263,27,191,20.5,72.6,0.81
CpG: 16,chrX,139358385,139358594,209,16,137,15.3,65.6,0.73
CpG: 77,chrX,139610568,139611192,624,77,447,24.7,71.6,0.96
CpG: 88,chrX,139870931,139871778,847,88,611,20.8,72.1,0.8
CpG: 176,chrX,140061078,140062743,1665,176,1182,21.1,71,0.87
CpG: 107,chrX,140277530,140278647,1117,107,703,19.2,62.9,0.97
CpG: 45,chrX,140456604,140457251,647,45,381,13.9,58.9,0.84
CpG: 202,chrX,140598209,140600575,2366,202,1365,17.1,57.7,1.04
CpG: 88,chrX,140664735,140665797,1062,88,682,16.6,64.2,0.81
CpG: 50,chrX,141721585,141722154,569,50,358,17.6,62.9,0.89
CpG: 85,chrX,141724517,141725435,918,85,604,18.5,65.8,0.86
CpG: 34,chrX,142305513,142305959,446,34,291,15.2,65.2,0.72
CpG: 67,chrX,142390152,142390858,706,67,487,19,69,0.8
CpG: 58,chrX,142681427,142682016,589,58,453,19.7,76.9,0.69
CpG: 99,chrX,142965784,142967008,1224,99,752,16.2,61.4,0.87
CpG: 127,chrX,144317870,144319407,1537,127,1011,16.5,65.8,0.8
CpG: 24,chrX,144688867,144689186,319,24,223,15,69.9,0.62
CpG: 53,chrX,146962658,146963233,575,53,351,18.4,61,1.01
CpG: 46,chrX,147553565,147554232,667,46,414,13.8,62.1,0.72
CpG: 21,chrX,147940819,147941130,311,21,209,13.5,67.2,0.62
CpG: 22,chrX,149728938,149729249,311,22,210,14.1,67.5,0.64
CpG: 21,chrX,150459023,150459233,210,21,116,20,55.2,1.31
CpG: 24,chrX,150587967,150588263,296,24,182,16.2,61.5,0.86
CpG: 16,chrX,150657143,150657369,226,16,137,14.2,60.6,0.81
CpG: 18,chrX,150812949,150813187,238,18,147,15.1,61.8,0.88
CpG: 23,chrX,151017209,151017453,244,23,159,18.9,65.2,0.89
CpG: 104,chrX,151046838,151047803,965,104,665,21.6,68.9,0.91
CpG: 20,chrX,151096301,151096556,255,20,163,15.7,63.9,0.79
CpG: 50,chrX,151169205,151169700,495,50,309,20.2,62.4,1.04
CpG: 68,chrX,151344157,151344866,709,68,498,19.2,70.2,0.78
CpG: 79,chrX,151520296,151521218,922,79,590,17.1,64,0.84
CpG: 93,chrX,151802982,151803955,973,93,591,19.1,60.7,1.06
CpG: 54,chrX,152016246,152016979,733,54,418,14.7,57,0.91
CpG: 85,chrX,152144159,152145127,968,85,592,17.6,61.2,0.94
CpG: 37,chrX,152233406,152233786,380,37,251,19.5,66.1,0.89
CpG: 19,chrX,152336572,152336832,260,19,162,14.6,62.3,0.76
CpG: 29,chrX,152342255,152342599,344,29,238,16.9,69.2,0.74
CpG: 87,chrX,152769164,152770081,917,87,596,19,65,0.9
CpG: 16,chrX,152782009,152782238,229,16,147,14,64.2,0.69
CpG: 43,chrX,153007094,153007623,529,43,338,16.3,63.9,0.8
CpG: 38,chrX,153037185,153037670,485,38,298,15.7,61.4,0.83
CpG: 29,chrX,153139746,153140122,376,29,243,15.4,64.6,0.74
CpG: 25,chrX,153237843,153238174,331,25,204,15.1,61.6,0.8
CpG: 45,chrX,153498076,153498469,393,45,248,22.9,63.1,1.15
CpG: 28,chrX,155216243,155216590,347,28,213,16.1,61.4,0.86
CpG: 30,chrX,155262398,155262764,366,30,245,16.4,66.9,0.73
CpG: 14,chrX,155305981,155306182,201,14,110,13.9,54.7,0.96
CpG: 41,chrX,155338143,155338553,410,41,248,20,60.5,1.12
CpG: 103,chrX,155622659,155623834,1175,103,756,17.5,64.3,0.85
CpG: 29,chrX,155624648,155624961,313,29,200,18.5,63.9,0.92
CpG: 105,chrX,157491334,157492336,1002,105,631,21,63,1.06
CpG: 25,chrX,157568851,157569111,260,25,134,19.2,51.5,1.45
CpG: 73,chrX,157598158,157598889,731,73,462,20,63.2,1.01
CpG: 150,chrX,158042456,158043904,1448,150,998,20.7,68.9,0.87
CpG: 113,chrX,159255618,159256774,1156,113,805,19.6,69.6,0.84
CpG: 49,chrX,159372189,159372708,519,49,343,18.9,66.1,0.87
CpG: 120,chrX,159414230,159415517,1287,120,822,18.6,63.9,0.93
CpG: 78,chrX,159532471,159533355,884,78,598,17.6,67.6,0.78
CpG: 92,chrX,159626943,159627943,1000,92,588,18.4,58.8,1.06
CpG: 71,chrX,159988070,159988799,729,71,426,19.5,58.4,1.15
CpG: 53,chrX,160137967,160138457,490,53,350,21.6,71.4,0.85
CpG: 24,chrX,160390678,160390977,299,24,198,16.1,66.2,0.77
CpG: 59,chrX,160502101,160502871,770,59,489,15.3,63.5,0.76
CpG: 18,chrX,160765833,160766085,252,18,151,14.3,59.9,0.8
CpG: 80,chrX,160994066,160994966,900,80,583,17.8,64.8,0.86
CpG: 18,chrX,161298256,161298474,218,18,148,16.5,67.9,0.73
CpG: 60,chrX,161717107,161717893,786,60,502,15.3,63.9,0.75
CpG: 71,chrX,161908242,161909235,993,71,608,14.3,61.2,0.76
CpG: 101,chrX,162158816,162160029,1213,101,730,16.7,60.2,0.92
CpG: 45,chrX,162643300,162643817,517,45,303,17.4,58.6,1.03
CpG: 141,chrX,162760089,162761400,1311,141,872,21.5,66.5,0.99
CpG: 86,chrX,162828589,162829742,1153,86,743,14.9,64.4,0.72
CpG: 40,chrX,162888108,162888495,387,40,276,20.7,71.3,0.85
CpG: 20,chrX,163760884,163761112,228,20,137,17.5,60.1,0.97
CpG: 113,chrX,163908583,163909696,1113,113,757,20.3,68,0.89
CpG: 58,chrX,163958203,163958800,597,58,397,19.4,66.5,0.92
CpG: 59,chrX,164075915,164076602,687,59,436,17.2,63.5,0.88
CpG: 39,chrX,164419524,164419983,459,39,280,17,61,0.93
CpG: 23,chrX,166170285,166170559,274,23,172,16.8,62.8,0.92
CpG: 58,chrX,166238827,166239469,642,58,400,18.1,62.3,0.94
CpG: 63,chrX,166440306,166441072,766,63,464,16.4,60.6,0.9
CpG: 19,chrX,166479482,166479739,257,19,151,14.8,58.8,0.87
CpG: 59,chrX,166510067,166510729,662,59,435,17.8,65.7,0.83
CpG: 29,chrX,167382039,167382416,377,29,249,15.4,66,0.71
CpG: 24,chrX,168122986,168123301,315,24,218,15.2,69.2,0.64
CpG: 108,chrX,168673364,168674394,1030,108,715,21,69.4,0.87
CpG: 37,chrX,168796216,168796680,464,37,296,15.9,63.8,0.79
CpG: 103,chrX,169319980,169320710,730,103,519,28.2,71.1,1.13
CpG: 19,chrX,169984924,169985180,256,19,141,14.8,55.1,1.02
CpG: 72,chrX,169986832,169987780,948,72,532,15.2,56.1,0.97
CpG: 52,chrX,169988812,169989299,487,52,317,21.4,65.1,1.02
CpG: 35,chrX,169990109,169990434,325,35,189,21.5,58.2,1.28
CpG: 30,chrX,169994005,169994235,230,30,170,26.1,73.9,1
CpG: 127,chrX,169996954,169998334,1380,127,976,18.4,70.7,0.74
CpG: 38,chrX,170009595,170010167,572,38,310,13.3,54.2,0.96
CpG: 80,chrX,170010677,170011327,650,80,409,24.6,62.9,1.25
CpG: 59,chrX,170018667,170019197,530,59,346,22.3,65.3,1.07
CpG: 49,chrX,170674488,170675049,561,49,405,17.5,72.2,0.69
CpG: 149,chrX,170676257,170677937,1680,149,974,17.7,58,1.06
CpG: 35,chrY,10643592,10644024,432,35,294,16.2,68.1,0.7
CpG: 251,chrY,90741077,90744975,3898,251,2210,12.9,56.7,0.84
CpG: 69,chrY,90761349,90762300,951,69,530,14.5,55.7,0.94
CpG: 52,chrY,90763086,90763573,487,52,317,21.4,65.1,1.02
CpG: 35,chrY,90764383,90764708,325,35,189,21.5,58.2,1.28
CpG: 120,chrY,90771290,90772670,1380,120,909,17.4,65.9,0.81
CpG: 38,chrY,90784511,90785083,572,38,310,13.3,54.2,0.96
CpG: 80,chrY,90785593,90786243,650,80,409,24.6,62.9,1.25
CpG: 59,chrY,90793289,90793819,530,59,346,22.3,65.3,1.07
CpG: 28,chrY,90818329,90818565,236,28,164,23.7,69.5,1.04
CpG: 28,chrY,90824266,90824502,236,28,164,23.7,69.5,1.04
CpG: 273,chrY,90825140,90829322,4182,273,2597,13.1,62.1,0.73
CpG: 221,chr10,22148532,22151691,3159,221,1918,14,60.7,0.76
CpG: 62,chr10,25296719,25297222,503,62,346,24.7,68.8,1.06
CpG: 87,chr10,52690524,52691622,1098,87,744,15.8,67.8,0.69
CpG: 29,chr10,60685947,60686341,394,29,252,14.7,64,0.73
CpG: 190,chr10,120977864,120979758,1894,190,1127,20.1,59.5,1.14
CpG: 78,chr10,3366238,3367166,928,78,584,16.8,62.9,0.85
CpG: 66,chr10,3740269,3741007,738,66,477,17.9,64.6,0.86
CpG: 69,chr10,3973179,3973942,763,69,517,18.1,67.8,0.79
CpG: 40,chr10,4266346,4266776,430,40,293,18.6,68.1,0.8
CpG: 23,chr10,4346779,4347002,223,23,159,20.6,71.3,0.81
CpG: 20,chr10,4369007,4369248,241,20,163,16.6,67.6,0.73
CpG: 145,chr10,4386714,4388128,1414,145,846,20.5,59.8,1.15
CpG: 72,chr10,4432145,4432861,716,72,460,20.1,64.2,0.98
CpG: 56,chr10,4712270,4712922,652,56,419,17.2,64.3,0.84
CpG: 97,chr10,5805008,5806200,1192,97,777,16.3,65.2,0.77
CpG: 76,chr10,5823486,5824386,900,76,596,16.9,66.2,0.78
CpG: 75,chr10,5921701,5922556,855,75,554,17.5,64.8,0.84
CpG: 90,chr10,7211440,7212337,897,90,611,20.1,68.1,0.87
CpG: 227,chr10,7390665,7393815,3150,227,1947,14.4,61.8,0.76
CpG: 126,chr10,7589694,7590651,957,126,708,26.3,74,0.96
CpG: 95,chr10,7662740,7663629,889,95,620,21.4,69.7,0.88
CpG: 114,chr10,7680908,7681860,952,114,684,23.9,71.8,0.93
CpG: 40,chr10,7725876,7726219,343,40,233,23.3,67.9,1.05
CpG: 46,chr10,7780403,7780866,463,46,309,19.9,66.7,0.9
CpG: 41,chr10,7792773,7793063,290,41,200,28.3,69,1.2
CpG: 47,chr10,7867339,7867750,411,47,290,22.9,70.6,0.93
CpG: 156,chr10,7955346,7956908,1562,156,933,20,59.7,1.12
CpG: 80,chr10,8517905,8518786,881,80,623,18.2,70.7,0.73
CpG: 79,chr10,8885737,8886703,966,79,590,16.4,61.1,0.88
CpG: 94,chr10,9674617,9675547,930,94,631,20.2,67.8,0.88
CpG: 104,chr10,9900396,9901332,936,104,636,22.2,67.9,0.97
CpG: 39,chr10,10557825,10558187,362,39,236,21.5,65.2,1.02
CpG: 17,chr10,10689177,10689398,221,17,146,15.4,66.1,0.71
CpG: 65,chr10,11149205,11149869,664,65,458,19.6,69,0.83
CpG: 133,chr10,11280717,11282102,1385,133,850,19.2,61.4,1.03
CpG: 79,chr10,11343296,11343812,516,79,397,30.6,76.9,1.03
CpG: 82,chr10,12868951,12869657,706,82,506,23.2,71.7,0.91
CpG: 41,chr10,12922723,12923133,410,41,257,20,62.7,1.02
CpG: 64,chr10,12941180,12941796,616,64,391,20.8,63.5,1.03
CpG: 66,chr10,12964008,12964687,679,66,459,19.4,67.6,0.85
CpG: 73,chr10,13008301,13009120,819,73,503,17.8,61.4,0.95
CpG: 36,chr10,13060921,13061266,345,36,241,20.9,69.9,0.86
CpG: 72,chr10,13090532,13091299,767,72,512,18.8,66.8,0.84
CpG: 41,chr10,13192788,13193234,446,41,297,18.4,66.6,0.83
CpG: 22,chr10,13323869,13324113,244,22,156,18,63.9,0.88
CpG: 79,chr10,13473745,13474522,777,79,554,20.3,71.3,0.8
CpG: 46,chr10,13552948,13553450,502,46,319,18.3,63.5,0.91
CpG: 58,chr10,13868752,13869155,403,58,290,28.8,72,1.12
CpG: 235,chr10,13964565,13967616,3051,235,1824,15.4,59.8,0.87
CpG: 70,chr10,14544965,14545639,674,70,451,20.8,66.9,0.93
CpG: 35,chr10,14705275,14705582,307,35,207,22.8,67.4,1
CpG: 107,chr10,17723028,17724216,1188,107,797,18,67.1,0.8
CpG: 118,chr10,17947226,17948280,1054,118,639,22.4,60.6,1.22
CpG: 41,chr10,18022557,18023138,581,41,376,14.1,64.7,0.73
CpG: 116,chr10,18055233,18056285,1052,116,665,22.1,63.2,1.11
CpG: 116,chr10,18318272,18319406,1134,116,717,20.5,63.2,1.03
CpG: 21,chr10,18531466,18531761,295,21,187,14.2,63.4,0.72
CpG: 62,chr10,18844886,18845426,540,62,387,23,71.7,0.89
CpG: 56,chr10,19015098,19015597,499,56,343,22.4,68.7,0.95
CpG: 55,chr10,19356883,19357579,696,55,467,15.8,67.1,0.71
CpG: 36,chr10,19591980,19592356,376,36,264,19.1,70.2,0.78
CpG: 23,chr10,19849468,19849700,232,23,152,19.8,65.5,0.93
CpG: 20,chr10,19849982,19850245,263,20,184,15.2,70,0.64
CpG: 109,chr10,19850509,19851710,1201,109,807,18.2,67.2,0.82
CpG: 19,chr10,19872458,19872687,229,19,141,16.6,61.6,0.88
CpG: 59,chr10,19907369,19907747,378,59,273,31.2,72.2,1.2
CpG: 167,chr10,19933613,19935110,1497,167,998,22.3,66.7,1.01
CpG: 106,chr10,20148433,20149349,916,106,544,23.1,59.4,1.33
CpG: 132,chr10,20311946,20313153,1207,132,804,21.9,66.6,0.99
CpG: 50,chr10,20347671,20348038,367,50,249,27.2,67.8,1.21
CpG: 69,chr10,20952416,20952958,542,69,403,25.5,74.4,0.92
CpG: 164,chr10,21158976,21161316,2340,164,1343,14,57.4,0.87
CpG: 77,chr10,21295914,21296647,733,77,465,21,63.4,1.05
CpG: 25,chr10,21882249,21882569,320,25,195,15.6,60.9,0.84
CpG: 94,chr10,21993907,21994913,1006,94,658,18.7,65.4,0.88
CpG: 33,chr10,22058365,22058829,464,33,304,14.2,65.5,0.68
CpG: 36,chr10,22158441,22158777,336,36,238,21.4,70.8,0.86
CpG: 16,chr10,22159928,22160147,219,16,133,14.6,60.7,0.87
CpG: 70,chr10,22273321,22274267,946,70,582,14.8,61.5,0.78
CpG: 29,chr10,22645256,22645505,249,29,172,23.3,69.1,1.03
CpG: 142,chr10,22730666,22732025,1359,142,927,20.9,68.2,0.9
CpG: 40,chr10,22819309,22819799,490,40,323,16.3,65.9,0.75
CpG: 21,chr10,23348465,23348670,205,21,136,20.5,66.3,0.94
CpG: 86,chr10,23349734,23350605,871,86,584,19.7,67,0.88
CpG: 51,chr10,23786957,23787467,510,51,314,20,61.6,1.06
CpG: 27,chr10,23796934,23797208,274,27,187,19.7,68.2,0.85
CpG: 43,chr10,24149290,24149738,448,43,310,19.2,69.2,0.81
CpG: 41,chr10,24223586,24223967,381,41,269,21.5,70.6,0.87
CpG: 57,chr10,24595451,24596086,635,57,430,18,67.7,0.81
CpG: 73,chr10,24711705,24712429,724,73,474,20.2,65.5,0.95
CpG: 40,chr10,24869850,24870388,538,40,335,14.9,62.3,0.77
CpG: 120,chr10,25359584,25360596,1012,120,721,23.7,71.2,0.94
CpG: 52,chr10,25458553,25459221,668,52,391,15.6,58.5,1.03
CpG: 80,chr10,26078147,26078929,782,80,528,20.5,67.5,0.9
CpG: 177,chr10,26373691,26375527,1836,177,977,19.3,53.2,1.38
CpG: 63,chr10,28074518,28075101,583,63,375,21.6,64.3,1.05
CpG: 82,chr10,29146671,29147681,1010,82,626,16.2,62,0.85
CpG: 18,chr10,29148176,29148387,211,18,119,17.1,56.4,1.1
CpG: 70,chr10,29196623,29197487,864,70,530,16.2,61.3,0.86
CpG: 42,chr10,29313242,29313586,344,42,255,24.4,74.1,0.89
CpG: 80,chr10,29361569,29362250,681,80,459,23.5,67.4,1.06
CpG: 31,chr10,29535491,29535850,359,31,243,17.3,67.7,0.78
CpG: 22,chr10,29699160,29699367,207,22,132,21.3,63.8,1.05
CpG: 44,chr10,30200239,30200631,392,44,269,22.4,68.6,0.95
CpG: 39,chr10,30600366,30600787,421,39,289,18.5,68.6,0.8
CpG: 37,chr10,30618238,30618608,370,37,244,20,65.9,0.92
CpG: 93,chr10,30802658,30803453,795,93,589,23.4,74.1,0.86
CpG: 93,chr10,30842340,30843237,897,93,613,20.7,68.3,0.89
CpG: 33,chr10,31313427,31313769,342,33,226,19.3,66.1,0.89
CpG: 45,chr10,31445574,31445999,425,45,282,21.2,66.4,0.96
CpG: 133,chr10,31608595,31609655,1060,133,763,25.1,72,0.97
CpG: 59,chr10,32889855,32890355,500,59,330,23.6,66,1.09
CpG: 19,chr10,33624362,33624567,205,19,139,18.5,67.8,0.81
CpG: 28,chr10,33950923,33951152,229,28,165,24.5,72.1,0.96
CpG: 76,chr10,34019156,34019944,788,76,479,19.3,60.8,1.05
CpG: 34,chr10,34127459,34127727,268,34,183,25.4,68.3,1.09
CpG: 64,chr10,34206827,34207451,624,64,450,20.5,72.1,0.79
CpG: 68,chr10,34282057,34282751,694,68,455,19.6,65.6,0.95
CpG: 24,chr10,34297518,34297820,302,24,194,15.9,64.2,0.77
CpG: 31,chr10,34418214,34418534,320,31,207,19.4,64.7,0.93
CpG: 75,chr10,36506875,36507677,802,75,532,18.7,66.3,0.85
CpG: 118,chr10,36974139,36975258,1119,118,779,21.1,69.6,0.87
CpG: 139,chr10,37136112,37137316,1204,139,732,23.1,60.8,1.25
CpG: 35,chr10,39133882,39134286,404,35,255,17.3,63.1,0.87
CpG: 101,chr10,39369546,39370460,914,101,635,22.1,69.5,0.92
CpG: 197,chr10,39731123,39733134,2011,197,1233,19.6,61.3,1.04
CpG: 34,chr10,39898927,39899287,360,34,236,18.9,65.6,0.89
CpG: 31,chr10,39926751,39927081,330,31,197,18.8,59.7,1.07
CpG: 35,chr10,40024853,40025279,426,35,296,16.4,69.5,0.69
CpG: 76,chr10,40141759,40142438,679,76,471,22.4,69.4,0.93
CpG: 52,chr10,40246729,40247189,460,52,283,22.6,61.5,1.2
CpG: 31,chr10,40257439,40257793,354,31,231,17.5,65.3,0.87
CpG: 170,chr10,40300770,40302743,1973,170,1221,17.2,61.9,0.9
CpG: 117,chr10,40349040,40350160,1120,117,741,20.9,66.2,0.99
CpG: 49,chr10,40683153,40683657,504,49,365,19.4,72.4,0.74
CpG: 133,chr10,40883344,40884526,1182,133,797,22.5,67.4,0.99
CpG: 63,chr10,41070803,41071589,786,63,502,16,63.9,0.79
CpG: 20,chr10,41072162,41072365,203,20,138,19.7,68,0.86
CpG: 37,chr10,41302854,41303319,465,37,320,15.9,68.8,0.67
CpG: 43,chr10,41450337,41450690,353,43,256,24.4,72.5,0.94
CpG: 69,chr10,41490045,41490803,758,69,504,18.2,66.5,0.82
CpG: 130,chr10,41518857,41519970,1113,130,754,23.4,67.7,1.02
CpG: 18,chr10,41809456,41809682,226,18,122,15.9,54,1.09
CpG: 66,chr10,41809870,41810555,685,66,493,19.3,72,0.76
CpG: 52,chr10,41887289,41887698,409,52,284,25.4,69.4,1.06
CpG: 42,chr10,42018033,42018510,477,42,297,17.6,62.3,0.92
CpG: 66,chr10,42196982,42197868,886,66,555,14.9,62.6,0.77
CpG: 332,chr10,42274731,42278553,3822,332,2423,17.4,63.4,0.87
CpG: 39,chr10,42478233,42478658,425,39,279,18.4,65.6,0.85
CpG: 91,chr10,42501838,42502718,880,91,547,20.7,62.2,1.08
CpG: 24,chr10,42572771,42573076,305,24,190,15.7,62.3,0.82
CpG: 28,chr10,42579588,42579891,303,28,211,18.5,69.6,0.77
CpG: 184,chr10,42582007,42584739,2732,184,1628,13.5,59.6,0.76
CpG: 40,chr10,42591529,42591915,386,40,233,20.7,60.4,1.15
CpG: 34,chr10,42614054,42614404,350,34,248,19.4,70.9,0.78
CpG: 24,chr10,42632209,42632456,247,24,170,19.4,68.8,0.89
CpG: 43,chr10,42635778,42636254,476,43,331,18.1,69.5,0.75
CpG: 53,chr10,42678828,42679395,567,53,366,18.7,64.6,0.9
CpG: 88,chr10,42761467,42762322,855,88,517,20.6,60.5,1.13
CpG: 108,chr10,43021060,43022094,1034,108,686,20.9,66.3,0.95
CpG: 154,chr10,43173158,43175099,1941,154,1209,15.9,62.3,0.82
CpG: 72,chr10,43221048,43222034,986,72,615,14.6,62.4,0.75
CpG: 18,chr10,43456275,43456537,262,18,153,13.7,58.4,0.82
CpG: 194,chr10,43478383,43480095,1712,194,1109,22.7,64.8,1.09
CpG: 16,chr10,43510330,43510534,204,16,123,15.7,60.3,0.88
CpG: 29,chr10,43511321,43511645,324,29,210,17.9,64.8,0.86
CpG: 56,chr10,43540494,43541126,632,56,429,17.7,67.9,0.77
CpG: 106,chr10,43578339,43579598,1259,106,765,16.8,60.8,0.91
CpG: 53,chr10,43901301,43901869,568,53,357,18.7,62.9,0.95
CpG: 109,chr10,44003488,44004455,967,109,675,22.5,69.8,0.93
CpG: 47,chr10,44148521,44149102,581,47,396,16.2,68.2,0.7
CpG: 62,chr10,44268176,44268746,570,62,395,21.8,69.3,0.93
CpG: 33,chr10,44458550,44458893,343,33,220,19.2,64.1,0.95
CpG: 32,chr10,44529428,44529809,381,32,228,16.8,59.8,0.94
CpG: 82,chr10,45066902,45067564,662,82,425,24.8,64.2,1.21
CpG: 23,chr10,45158226,45158512,286,23,169,16.1,59.1,0.94
CpG: 64,chr10,45289301,45289796,495,64,361,25.9,72.9,0.97
CpG: 82,chr10,45335481,45336223,742,82,439,22.1,59.2,1.26
CpG: 152,chr10,45485681,45486868,1187,152,757,25.6,63.8,1.26
CpG: 77,chr10,45577766,45578454,688,77,417,22.4,60.6,1.26
CpG: 26,chr10,49783017,49783368,351,26,191,14.8,54.4,1
CpG: 39,chr10,49788483,49788867,384,39,265,20.3,69,0.85
CpG: 63,chr10,50592508,50593018,510,63,351,24.7,68.8,1.09
CpG: 85,chr10,50894242,50895332,1090,85,677,15.6,62.1,0.81
CpG: 30,chr10,50900711,50901152,441,30,257,13.6,58.3,0.8
CpG: 21,chr10,51677775,51678005,230,21,152,18.3,66.1,0.86
CpG: 52,chr10,52022400,52022994,594,52,357,17.5,60.1,0.97
CpG: 62,chr10,52027445,52028039,594,62,437,20.9,73.6,0.79
CpG: 81,chr10,52233394,52234339,945,81,612,17.1,64.8,0.83
CpG: 46,chr10,52381715,52382289,574,46,324,16,56.4,1.02
CpG: 100,chr10,52417383,52418289,906,100,617,22.1,68.1,0.96
CpG: 27,chr10,52545617,52545918,301,27,205,17.9,68.1,0.77
CpG: 15,chr10,53299125,53299341,216,15,119,13.9,55.1,0.93
CpG: 23,chr10,53379252,53379454,202,23,144,22.8,71.3,0.9
CpG: 93,chr10,53596813,53597857,1044,93,569,17.8,54.5,1.2
CpG: 103,chr10,53629430,53630281,851,103,587,24.2,69,1.05
CpG: 86,chr10,53750792,53751465,673,86,497,25.6,73.8,0.95
CpG: 151,chr10,54074629,54076165,1536,151,1061,19.7,69.1,0.82
CpG: 68,chr10,56115144,56115940,796,68,540,17.1,67.8,0.74
CpG: 35,chr10,56228653,56228979,326,35,208,21.5,63.8,1.06
CpG: 84,chr10,57486189,57487019,830,84,466,20.2,56.1,1.28
CpG: 62,chr10,57532018,57532605,587,62,383,21.1,65.2,0.99
CpG: 24,chr10,57632017,57632220,203,24,151,23.6,74.4,0.86
CpG: 25,chr10,57794731,57795000,269,25,189,18.6,70.3,0.78
CpG: 50,chr10,58255344,58255740,396,50,286,25.3,72.2,0.97
CpG: 71,chr10,58323249,58323825,576,71,404,24.7,70.1,1.03
CpG: 95,chr10,58446725,58447449,724,95,505,26.2,69.8,1.09
CpG: 35,chr10,58497863,58498188,325,35,226,21.5,69.5,0.91
CpG: 168,chr10,58812258,58814099,1841,168,1233,18.3,67,0.81
CpG: 138,chr10,59221274,59222787,1513,138,1009,18.2,66.7,0.83
CpG: 15,chr10,59223221,59223431,210,15,123,14.3,58.6,0.83
CpG: 86,chr10,59323026,59323922,896,86,635,19.2,70.9,0.76
CpG: 25,chr10,59395618,59395859,241,25,158,20.7,65.6,0.98
CpG: 55,chr10,59616123,59616735,612,55,371,18,60.6,0.98
CpG: 40,chr10,59702346,59702799,453,40,297,17.7,65.6,0.85
CpG: 75,chr10,59879349,59879981,632,75,422,23.7,66.8,1.06
CpG: 92,chr10,59951231,59952395,1164,92,759,15.8,65.2,0.75
CpG: 53,chr10,60002780,60003293,513,53,350,20.7,68.2,0.89
CpG: 104,chr10,60106380,60107798,1418,104,932,14.7,65.7,0.68
CpG: 65,chr10,60185807,60186648,841,65,526,15.5,62.5,0.79
CpG: 77,chr10,60218758,60219462,704,77,511,21.9,72.6,0.83
CpG: 49,chr10,60277457,60277947,490,49,318,20,64.9,0.95
CpG: 15,chr10,60303323,60303537,214,15,140,14,65.4,0.66
CpG: 26,chr10,60346827,60347059,232,26,168,22.4,72.4,0.86
CpG: 116,chr10,60686587,60687780,1193,116,772,19.4,64.7,0.93
CpG: 27,chr10,60752587,60752945,358,27,244,15.1,68.2,0.67
CpG: 142,chr10,60830546,60831810,1264,142,871,22.5,68.9,0.95
CpG: 22,chr10,61089319,61089587,268,22,193,16.4,72,0.64
CpG: 43,chr10,61146271,61146676,405,43,303,21.2,74.8,0.8
CpG: 67,chr10,61147347,61147967,620,67,441,21.6,71.1,0.88
CpG: 20,chr10,61245891,61246103,212,20,138,18.9,65.1,0.92
CpG: 50,chr10,61273127,61273655,528,50,321,18.9,60.8,1.03
CpG: 55,chr10,61383143,61383688,545,55,391,20.2,71.7,0.8
CpG: 33,chr10,61418357,61418682,325,33,216,20.3,66.5,0.92
CpG: 74,chr10,61452172,61452946,774,74,464,19.1,59.9,1.07
CpG: 61,chr10,61475608,61476237,629,61,433,19.4,68.8,0.82
CpG: 33,chr10,61595130,61595395,265,33,204,24.9,77,0.85
CpG: 72,chr10,61625499,61626247,748,72,496,19.3,66.3,0.88
CpG: 81,chr10,61648390,61649103,713,81,492,22.7,69,0.96
CpG: 73,chr10,61680016,61680739,723,73,488,20.2,67.5,0.91
CpG: 144,chr10,61695440,61696703,1263,144,871,22.8,69,0.96
CpG: 27,chr10,61715274,61715578,304,27,198,17.8,65.1,0.87
CpG: 113,chr10,61783121,61784365,1244,113,822,18.2,66.1,0.83
CpG: 108,chr10,61978049,61979302,1253,108,777,17.2,62,0.9
CpG: 49,chr10,62110704,62111095,391,49,292,25.1,74.7,0.9
CpG: 21,chr10,62132778,62133047,269,21,192,15.6,71.4,0.62
CpG: 28,chr10,62133624,62133888,264,28,166,21.2,62.9,1.08
CpG: 71,chr10,62230649,62231487,838,71,550,16.9,65.6,0.79
CpG: 20,chr10,62269716,62269981,265,20,177,15.1,66.8,0.7
CpG: 42,chr10,62339925,62340434,509,42,346,16.5,68,0.71
CpG: 54,chr10,62449428,62450006,578,54,343,18.7,59.3,1.07
CpG: 88,chr10,62486288,62487334,1046,88,670,16.8,64.1,0.83
CpG: 75,chr10,62577908,62578575,667,75,451,22.5,67.6,0.99
CpG: 49,chr10,62601951,62602436,485,49,320,20.2,66,0.94
CpG: 104,chr10,62650599,62651712,1113,104,723,18.7,65,0.89
CpG: 75,chr10,62725705,62726253,548,75,393,27.4,71.7,1.08
CpG: 100,chr10,62791646,62792545,899,100,608,22.2,67.6,0.98
CpG: 46,chr10,62886788,62887349,561,46,358,16.4,63.8,0.81
CpG: 54,chr10,62920519,62921019,500,54,361,21.6,72.2,0.83
CpG: 54,chr10,62946851,62947246,395,54,285,27.3,72.2,1.09
CpG: 17,chr10,62949130,62949337,207,17,114,16.4,55.1,1.12
CpG: 69,chr10,62980177,62980810,633,69,456,21.8,72,0.84
CpG: 134,chr10,63023021,63024293,1272,134,883,21.1,69.4,0.89
CpG: 33,chr10,63100268,63100498,230,33,165,28.7,71.7,1.12
CpG: 16,chr10,63192434,63192673,239,16,146,13.4,61.1,0.72
CpG: 51,chr10,63243913,63244443,530,51,372,19.2,70.2,0.81
CpG: 130,chr10,63338175,63339425,1250,130,691,20.8,55.3,1.37
CpG: 72,chr10,63429559,63430167,608,72,399,23.7,65.6,1.11
CpG: 19,chr10,63583614,63583875,261,19,144,14.6,55.2,0.98
CpG: 138,chr10,67096180,67097472,1292,138,798,21.4,61.8,1.12
CpG: 109,chr10,67126768,67127451,683,109,527,31.9,77.2,1.08
CpG: 86,chr10,67284764,67285497,733,86,538,23.5,73.4,0.88
CpG: 177,chr10,67535271,67537740,2469,177,1472,14.3,59.6,0.81
CpG: 58,chr10,67538299,67539109,810,58,514,14.3,63.5,0.73
CpG: 150,chr10,67548040,67549252,1212,150,859,24.8,70.9,0.99
CpG: 52,chr10,67912176,67912562,386,52,284,26.9,73.6,1
CpG: 56,chr10,67979442,67980106,664,56,446,16.9,67.2,0.75
CpG: 20,chr10,68041433,68041734,301,20,173,13.3,57.5,0.81
CpG: 29,chr10,68276999,68277311,312,29,206,18.6,66,0.85
CpG: 86,chr10,69212587,69213723,1136,86,721,15.1,63.5,0.76
CpG: 26,chr10,69269942,69270276,334,26,197,15.6,59,0.92
CpG: 29,chr10,69352785,69353086,301,29,199,19.3,66.1,0.88
CpG: 98,chr10,69398413,69399546,1133,98,759,17.3,67,0.77
CpG: 17,chr10,69822209,69822424,215,17,128,15.8,59.5,0.9
CpG: 24,chr10,69994095,69994422,327,24,171,14.7,52.3,1.08
CpG: 111,chr10,70096669,70098012,1343,111,813,16.5,60.5,0.92
CpG: 43,chr10,70189004,70189540,536,43,328,16,61.2,0.92
CpG: 53,chr10,70244923,70245530,607,53,402,17.5,66.2,0.8
CpG: 185,chr10,70598617,70600156,1539,185,1071,24,69.6,1.01
CpG: 95,chr10,71159022,71160060,1038,95,621,18.3,59.8,1.02
CpG: 65,chr10,71237637,71238173,536,65,375,24.3,70,0.99
CpG: 80,chr10,71284732,71285593,861,80,574,18.6,66.7,0.84
CpG: 68,chr10,71344489,71345106,617,68,431,22,69.9,0.91
CpG: 92,chr10,71347544,71348544,1000,92,693,18.4,69.3,0.77
CpG: 28,chr10,71381426,71381799,373,28,204,15,54.7,1.01
CpG: 30,chr10,72654757,72655041,284,30,172,21.1,60.6,1.2
CpG: 112,chr10,73099128,73100203,1075,112,744,20.8,69.2,0.87
CpG: 19,chr10,74925476,74925729,253,19,147,15,58.1,0.9
CpG: 77,chr10,74966903,74967475,572,77,400,26.9,69.9,1.1
CpG: 25,chr10,74991402,74991727,325,25,197,15.4,60.6,0.85
CpG: 31,chr10,75036966,75037300,334,31,218,18.6,65.3,0.87
CpG: 188,chr10,75060384,75062209,1825,188,1192,20.6,65.3,0.97
CpG: 63,chr10,75211904,75212447,543,63,380,23.2,70,0.95
CpG: 84,chr10,75316882,75317710,828,84,574,20.3,69.3,0.86
CpG: 44,chr10,75517048,75517590,542,44,363,16.2,67,0.76
CpG: 24,chr10,75518027,75518346,319,24,183,15,57.4,0.93
CpG: 51,chr10,75559849,75560355,506,51,312,20.2,61.7,1.06
CpG: 71,chr10,75667304,75668076,772,71,526,18.4,68.1,0.8
CpG: 47,chr10,75764077,75764516,439,47,294,21.4,67,0.96
CpG: 22,chr10,75837191,75837515,324,22,194,13.6,59.9,0.77
CpG: 53,chr10,75859672,75860340,668,53,439,15.9,65.7,0.73
CpG: 38,chr10,75893226,75893591,365,38,252,20.8,69,0.87
CpG: 86,chr10,75921139,75921943,804,86,533,21.4,66.3,0.97
CpG: 40,chr10,75935823,75936353,530,40,349,15.1,65.8,0.7
CpG: 46,chr10,76032488,76032854,366,46,270,25.1,73.8,0.95
CpG: 30,chr10,76237755,76238153,398,30,239,15.1,60.1,0.84
CpG: 88,chr10,76344761,76345569,808,88,561,21.8,69.4,0.91
CpG: 20,chr10,76374961,76375235,274,20,175,14.6,63.9,0.72
CpG: 77,chr10,76442295,76443091,796,77,508,19.3,63.8,0.97
CpG: 49,chr10,76468675,76469198,523,49,325,18.7,62.1,0.97
CpG: 42,chr10,76531329,76531728,399,42,289,21.1,72.4,0.81
CpG: 37,chr10,76596334,76596785,451,37,287,16.4,63.6,0.81
CpG: 20,chr10,76614377,76614626,249,20,152,16.1,61,0.86
CpG: 23,chr10,76623280,76623496,216,23,162,21.3,75,0.8
CpG: 59,chr10,76961630,76962132,502,59,356,23.5,70.9,0.94
CpG: 69,chr10,77032479,77033477,998,69,620,13.8,62.1,0.74
CpG: 52,chr10,77165549,77166182,633,52,401,16.4,63.3,0.83
CpG: 94,chr10,77258906,77259845,939,94,633,20,67.4,0.88
CpG: 17,chr10,77265782,77266000,218,17,136,15.6,62.4,0.81
CpG: 87,chr10,77417770,77418534,764,87,423,22.8,55.4,1.49
CpG: 63,chr10,77515559,77516095,536,63,353,23.5,65.9,1.08
CpG: 57,chr10,77581577,77582125,548,57,373,20.8,68.1,0.9
CpG: 106,chr10,77605948,77606817,869,106,590,24.4,67.9,1.08
CpG: 85,chr10,77622079,77622864,785,85,505,21.7,64.3,1.05
CpG: 26,chr10,77664269,77664587,318,26,203,16.4,63.8,0.8
CpG: 25,chr10,77677773,77678017,244,25,155,20.5,63.5,1.02
CpG: 45,chr10,77902087,77902537,450,45,310,20,68.9,0.85
CpG: 55,chr10,77978272,77978826,554,55,360,19.9,65,0.95
CpG: 57,chr10,78009316,78009964,648,57,440,17.6,67.9,0.77
CpG: 19,chr10,78018870,78019131,261,19,156,14.6,59.8,0.82
CpG: 24,chr10,78034427,78034693,266,24,177,18,66.5,0.82
CpG: 25,chr10,78043411,78043683,272,25,172,18.4,63.2,0.92
CpG: 66,chr10,78069113,78069840,727,66,493,18.2,67.8,0.79
CpG: 37,chr10,78169446,78169876,430,37,298,17.2,69.3,0.73
CpG: 32,chr10,78184986,78185294,308,32,200,20.8,64.9,1.06
CpG: 58,chr10,78244166,78244843,677,58,364,17.1,53.8,1.19
CpG: 73,chr10,78351909,78352525,616,73,352,23.7,57.1,1.45
CpG: 55,chr10,78412629,78413121,492,55,321,22.4,65.2,1.05
CpG: 27,chr10,78425633,78425967,334,27,229,16.2,68.6,0.69
CpG: 52,chr10,78464507,78465077,570,52,385,18.2,67.5,0.8
CpG: 30,chr10,78481998,78482372,374,30,240,16,64.2,0.78
CpG: 25,chr10,78574239,78574462,223,25,133,22.4,59.6,1.35
CpG: 24,chr10,78574701,78575039,338,24,203,14.2,60.1,0.82
CpG: 59,chr10,78752389,78752951,562,59,386,21,68.7,0.89
CpG: 31,chr10,78780348,78780675,327,31,212,19,64.8,0.91
CpG: 42,chr10,79533372,79533914,542,42,370,15.5,68.3,0.67
CpG: 82,chr10,79554454,79555255,801,82,489,20.5,61,1.1
CpG: 18,chr10,79612281,79612492,211,18,148,17.1,70.1,0.7
CpG: 46,chr10,79613778,79614090,312,46,232,29.5,74.4,1.07
CpG: 114,chr10,79637188,79638095,907,114,669,25.1,73.8,0.92
CpG: 76,chr10,79669306,79669972,666,76,442,22.8,66.4,1.04
CpG: 41,chr10,79675402,79675878,476,41,319,17.2,67,0.77
CpG: 93,chr10,79681693,79682348,655,93,473,28.4,72.2,1.09
CpG: 47,chr10,79704238,79704674,436,47,287,21.6,65.8,1
CpG: 169,chr10,79716261,79718040,1779,169,1155,19,64.9,0.91
CpG: 26,chr10,79724468,79724789,321,26,178,16.2,55.5,1.05
CpG: 114,chr10,79735082,79736163,1081,114,766,21.1,70.9,0.86
CpG: 26,chr10,79739313,79739593,280,26,187,18.6,66.8,0.85
CpG: 27,chr10,79746471,79746713,242,27,169,22.3,69.8,0.92
CpG: 33,chr10,79755008,79755296,288,33,206,22.9,71.5,0.9
CpG: 116,chr10,79766462,79767766,1304,116,806,17.8,61.8,0.94
CpG: 26,chr10,79777133,79777458,325,26,200,16,61.5,0.85
CpG: 35,chr10,79779936,79780219,283,35,196,24.7,69.3,1.04
CpG: 49,chr10,79793476,79793852,376,49,246,26.1,65.4,1.22
CpG: 17,chr10,79818987,79819210,223,17,145,15.2,65,0.72
CpG: 22,chr10,79819404,79819707,303,22,202,14.5,66.7,0.69
CpG: 143,chr10,79854072,79855349,1277,143,852,22.4,66.7,1.01
CpG: 62,chr10,79874255,79874713,458,62,339,27.1,74,0.99
CpG: 19,chr10,79882061,79882289,228,19,145,16.7,63.6,0.85
CpG: 19,chr10,79899175,79899424,249,19,162,15.3,65.1,0.72
CpG: 24,chr10,79903012,79903288,276,24,174,17.4,63,0.88
CpG: 23,chr10,79908717,79908920,203,23,120,22.7,59.1,1.52
CpG: 35,chr10,79916807,79917184,377,35,265,18.6,70.3,0.76
CpG: 76,chr10,79921030,79921988,958,76,600,15.9,62.6,0.81
CpG: 99,chr10,79926584,79927836,1252,99,744,15.8,59.4,0.9
CpG: 60,chr10,79959868,79960557,689,60,441,17.4,64,0.86
CpG: 52,chr10,79970818,79971364,546,52,367,19,67.2,0.84
CpG: 89,chr10,79976783,79977771,988,89,692,18,70,0.74
CpG: 25,chr10,79978323,79978597,274,25,194,18.2,70.8,0.75
CpG: 55,chr10,79988381,79988831,450,55,321,24.4,71.3,0.96
CpG: 23,chr10,80013618,80013938,320,23,210,14.4,65.6,0.67
CpG: 44,chr10,80039500,80039885,385,44,254,22.9,66,1.06
CpG: 100,chr10,80053311,80054212,901,100,619,22.2,68.7,0.95
CpG: 20,chr10,80057643,80057877,234,20,150,17.1,64.1,0.85
CpG: 56,chr10,80102314,80102764,450,56,324,24.9,72,0.97
CpG: 172,chr10,80115340,80116940,1600,172,1029,21.5,64.3,1.04
CpG: 19,chr10,80117184,80117392,208,19,134,18.3,64.4,0.96
CpG: 76,chr10,80131424,80132234,810,76,534,18.8,65.9,0.86
CpG: 86,chr10,80138769,80139545,776,86,532,22.2,68.6,0.94
CpG: 28,chr10,80141353,80141614,261,28,183,21.5,70.1,0.88
CpG: 38,chr10,80142295,80142611,316,38,215,24.1,68,1.08
CpG: 218,chr10,80148175,80151035,2860,218,1805,15.2,63.1,0.76
CpG: 41,chr10,80159825,80160230,405,41,275,20.2,67.9,0.88
CpG: 31,chr10,80164584,80164862,278,31,203,22.3,73,0.84
CpG: 89,chr10,80167530,80168342,812,89,529,21.9,65.1,1.04
CpG: 23,chr10,80171798,80172032,234,23,165,19.7,70.5,0.8
CpG: 42,chr10,80179294,80179676,382,42,239,22,62.6,1.13
CpG: 26,chr10,80186652,80186972,320,26,211,16.2,65.9,0.76
CpG: 39,chr10,80190441,80190743,302,39,210,25.8,69.5,1.07
CpG: 20,chr10,80208858,80209094,236,20,145,16.9,61.4,0.9
CpG: 73,chr10,80226336,80226932,596,73,455,24.5,76.3,0.89
CpG: 25,chr10,80249313,80249552,239,25,154,20.9,64.4,1.06
CpG: 28,chr10,80260736,80261097,361,28,222,15.5,61.5,0.85
CpG: 72,chr10,80264662,80265278,616,72,373,23.4,60.6,1.3
CpG: 65,chr10,80292310,80292903,593,65,400,21.9,67.5,0.96
CpG: 27,chr10,80304774,80305091,317,27,207,17,65.3,0.83
CpG: 25,chr10,80306170,80306497,327,25,213,15.3,65.1,0.72
CpG: 57,chr10,80312493,80313377,884,57,574,12.9,64.9,0.61
CpG: 42,chr10,80315008,80315553,545,42,363,15.4,66.6,0.71
CpG: 48,chr10,80320132,80320614,482,48,313,19.9,64.9,0.98
CpG: 64,chr10,80322999,80323834,835,64,576,15.3,69,0.66
CpG: 15,chr10,80335482,80335689,207,15,143,14.5,69.1,0.62
CpG: 116,chr10,80341167,80343018,1851,116,1185,12.5,64,0.62
CpG: 35,chr10,80348380,80348711,331,35,240,21.1,72.5,0.81
CpG: 24,chr10,80349019,80349330,311,24,218,15.4,70.1,0.71
CpG: 69,chr10,80356390,80357035,645,69,420,21.4,65.1,1.02
CpG: 79,chr10,80381560,80382565,1005,79,676,15.7,67.3,0.7
CpG: 131,chr10,80386626,80387907,1281,131,751,20.5,58.6,1.19
CpG: 23,chr10,80395296,80395621,325,23,195,14.2,60,0.79
CpG: 122,chr10,80398725,80400066,1341,122,818,18.2,61,0.99
CpG: 18,chr10,80406713,80406914,201,18,120,17.9,59.7,1.01
CpG: 98,chr10,80433050,80434213,1163,98,669,16.9,57.5,1.02
CpG: 24,chr10,80471872,80472160,288,24,197,16.7,68.4,0.72
CpG: 55,chr10,80475224,80475700,476,55,319,23.1,67,1.04
CpG: 32,chr10,80491184,80491434,250,32,177,25.6,70.8,1.04
CpG: 123,chr10,80494785,80496182,1397,123,833,17.6,59.6,0.99
CpG: 88,chr10,80560936,80561887,951,88,600,18.5,63.1,0.93
CpG: 28,chr10,80568989,80569260,271,28,182,20.7,67.2,0.95
CpG: 132,chr10,80576864,80578064,1200,132,848,22,70.7,0.89
CpG: 16,chr10,80583842,80584060,218,16,132,14.7,60.6,0.8
CpG: 43,chr10,80586522,80586986,464,43,293,18.5,63.1,0.93
CpG: 36,chr10,80589946,80590414,468,36,250,15.4,53.4,1.08
CpG: 49,chr10,80602805,80603198,393,49,262,24.9,66.7,1.14
CpG: 34,chr10,80606488,80606948,460,34,318,14.8,69.1,0.62
CpG: 108,chr10,80621976,80623110,1134,108,641,19,56.5,1.23
CpG: 20,chr10,80634309,80634553,244,20,151,16.4,61.9,0.9
CpG: 27,chr10,80638388,80638765,377,27,234,14.3,62.1,0.74
CpG: 32,chr10,80656107,80656330,223,32,163,28.7,73.1,1.07
CpG: 101,chr10,80675777,80676863,1086,101,673,18.6,62,0.97
CpG: 27,chr10,80691139,80691432,293,27,181,18.4,61.8,0.97
CpG: 46,chr10,80701707,80702117,410,46,291,22.4,71,0.89
CpG: 30,chr10,80702540,80702862,322,30,219,18.6,68,0.84
CpG: 43,chr10,80741803,80742148,345,43,245,24.9,71,0.99
CpG: 91,chr10,80754885,80755679,794,91,484,22.9,61,1.24
CpG: 146,chr10,80797686,80799049,1363,146,863,21.4,63.3,1.07
CpG: 65,chr10,80807029,80807650,621,65,436,20.9,70.2,0.85
CpG: 95,chr10,80826254,80827237,983,95,590,19.3,60,1.07
CpG: 145,chr10,80834349,80836042,1693,145,1122,17.1,66.3,0.78
CpG: 57,chr10,80843648,80844303,655,57,411,17.4,62.7,0.89
CpG: 80,chr10,80854966,80855743,777,80,511,20.6,65.8,0.97
CpG: 35,chr10,80888241,80888574,333,35,228,21,68.5,0.9
CpG: 32,chr10,80897899,80898248,349,32,231,18.3,66.2,0.84
CpG: 79,chr10,80900135,80901004,869,79,557,18.2,64.1,0.91
CpG: 56,chr10,80917873,80918303,430,56,295,26,68.6,1.11
CpG: 25,chr10,80928679,80928886,207,25,150,24.2,72.5,0.93
CpG: 70,chr10,80929720,80930661,941,70,558,14.9,59.3,0.85
CpG: 18,chr10,80932193,80932449,256,18,153,14.1,59.8,0.83
CpG: 25,chr10,80985711,80986034,323,25,218,15.5,67.5,0.69
CpG: 20,chr10,81014881,81015142,261,20,175,15.3,67,0.71
CpG: 45,chr10,81021813,81022391,578,45,354,15.6,61.2,0.84
CpG: 43,chr10,81031112,81031665,553,43,370,15.6,66.9,0.7
CpG: 39,chr10,81059875,81060305,430,39,267,18.1,62.1,0.96
CpG: 46,chr10,81069901,81070295,394,46,266,23.4,67.5,1.03
CpG: 23,chr10,81079911,81080224,313,23,197,14.7,62.9,0.75
CpG: 69,chr10,81105725,81106291,566,69,402,24.4,71,0.97
CpG: 25,chr10,81135307,81135560,253,25,176,19.8,69.6,0.82
CpG: 194,chr10,81136019,81138167,2148,194,1379,18.1,64.2,0.88
CpG: 91,chr10,81143965,81144997,1032,91,688,17.6,66.7,0.79
CpG: 45,chr10,81147994,81148594,600,45,320,15,53.3,1.06
CpG: 76,chr10,81153378,81154366,988,76,615,15.4,62.2,0.79
CpG: 55,chr10,81167490,81167973,483,55,344,22.8,71.2,0.95
CpG: 70,chr10,81176456,81177055,599,70,411,23.4,68.6,0.99
CpG: 33,chr10,81182870,81183179,309,33,193,21.4,62.5,1.14
CpG: 40,chr10,81190014,81190475,461,40,282,17.4,61.2,0.93
CpG: 100,chr10,81192359,81193075,716,100,522,27.9,72.9,1.06
CpG: 18,chr10,81194489,81194691,202,18,132,17.8,65.3,0.9
CpG: 32,chr10,81233023,81233302,279,32,203,22.9,72.8,0.89
CpG: 26,chr10,81239944,81240211,267,26,197,19.5,73.8,0.73
CpG: 51,chr10,81257266,81257857,591,51,394,17.3,66.7,0.78
CpG: 38,chr10,81266602,81266974,372,38,247,20.4,66.4,0.93
CpG: 45,chr10,81285716,81286098,382,45,262,23.6,68.6,1
CpG: 80,chr10,81292797,81293513,716,80,482,22.3,67.3,0.99
CpG: 21,chr10,81320246,81320558,312,21,184,13.5,59,0.85
CpG: 55,chr10,81320669,81321281,612,55,384,18,62.7,0.93
CpG: 20,chr10,81322538,81322776,238,20,162,16.8,68.1,0.73
CpG: 51,chr10,81325244,81325950,706,51,433,14.4,61.3,0.77
CpG: 67,chr10,81332456,81333187,731,67,497,18.3,68,0.79
CpG: 40,chr10,81337880,81338283,403,40,228,19.9,56.6,1.29
CpG: 57,chr10,81342975,81343543,568,57,366,20.1,64.4,0.97
CpG: 53,chr10,81346554,81347061,507,53,343,20.9,67.7,0.91
CpG: 63,chr10,81350076,81350696,620,63,402,20.3,64.8,0.99
CpG: 81,chr10,81357375,81357954,579,81,424,28,73.2,1.05
CpG: 70,chr10,81363994,81364952,958,70,555,14.6,57.9,0.87
CpG: 82,chr10,81378147,81379056,909,82,590,18,64.9,0.86
CpG: 44,chr10,81384188,81384648,460,44,278,19.1,60.4,1.05
CpG: 43,chr10,81420266,81420785,519,43,328,16.6,63.2,0.84
CpG: 139,chr10,81430029,81431239,1210,139,780,23,64.5,1.11
CpG: 39,chr10,81464207,81464741,534,39,373,14.6,69.9,0.65
CpG: 44,chr10,81482358,81482796,438,44,269,20.1,61.4,1.09
CpG: 61,chr10,81496043,81496501,458,61,316,26.6,69,1.12
CpG: 25,chr10,81499183,81499537,354,25,235,14.1,66.4,0.64
CpG: 38,chr10,81502810,81503100,290,38,196,26.2,67.6,1.15
CpG: 105,chr10,81544537,81545375,838,105,555,25.1,66.2,1.14
CpG: 24,chr10,81570859,81571092,233,24,158,20.6,67.8,0.96
CpG: 27,chr10,81575172,81575397,225,27,172,24,76.4,0.82
CpG: 27,chr10,81587685,81588086,401,27,262,13.5,65.3,0.63
CpG: 19,chr10,81600962,81601183,221,19,145,17.2,65.6,0.8
CpG: 26,chr10,81627410,81627647,237,26,148,21.9,62.4,1.14
CpG: 75,chr10,81643291,81643935,644,75,437,23.3,67.9,1.02
CpG: 36,chr10,81649033,81649387,354,36,239,20.3,67.5,0.91
CpG: 38,chr10,81687361,81687748,387,38,255,19.6,65.9,0.93
CpG: 32,chr10,81704878,81705157,279,32,191,22.9,68.5,0.98
CpG: 30,chr10,81770844,81771138,294,30,190,20.4,64.6,0.99
CpG: 38,chr10,81812129,81812504,375,38,252,20.3,67.2,0.92
CpG: 38,chr10,81846465,81846852,387,38,255,19.6,65.9,0.93
CpG: 32,chr10,81863987,81864266,279,32,191,22.9,68.5,0.98
CpG: 30,chr10,81930182,81930476,294,30,190,20.4,64.6,0.99
CpG: 39,chr10,81978620,81978995,375,39,253,20.8,67.5,0.94
CpG: 32,chr10,81997095,81997374,279,32,191,22.9,68.5,0.98
CpG: 29,chr10,82048213,82048478,265,29,180,21.9,67.9,0.95
CpG: 32,chr10,82083367,82083670,303,32,198,21.1,65.3,1
CpG: 39,chr10,82127959,82128352,393,39,261,19.8,66.4,0.93
CpG: 28,chr10,82178292,82178540,248,28,167,22.6,67.3,1.01
CpG: 25,chr10,82354365,82354618,253,25,163,19.8,64.4,0.96
CpG: 53,chr10,82622660,82623248,588,53,392,18,66.7,0.81
CpG: 83,chr10,82629705,82630318,613,83,448,27.1,73.1,1.01
CpG: 95,chr10,82698982,82699824,842,95,595,22.6,70.7,0.91
CpG: 87,chr10,82763362,82764321,959,87,511,18.1,53.3,1.28
CpG: 50,chr10,82811956,82812375,419,50,312,23.9,74.5,0.87
CpG: 40,chr10,82858991,82859430,439,40,279,18.2,63.6,0.93
CpG: 43,chr10,82860219,82860691,472,43,310,18.2,65.7,0.86
CpG: 35,chr10,82954363,82954671,308,35,231,22.7,75,0.81
CpG: 67,chr10,82985164,82985876,712,67,452,18.8,63.5,0.94
CpG: 32,chr10,83191291,83191713,422,32,253,15.2,60,0.86
CpG: 86,chr10,83337154,83337977,823,86,520,20.9,63.2,1.06
CpG: 79,chr10,83360008,83360820,812,79,554,19.5,68.2,0.85
CpG: 65,chr10,83543760,83544352,592,65,375,22,63.3,1.1
CpG: 50,chr10,83648461,83648917,456,50,338,21.9,74.1,0.8
CpG: 50,chr10,83722674,83723229,555,50,345,18,62.2,0.94
CpG: 113,chr10,84440223,84441455,1232,113,824,18.3,66.9,0.83
CpG: 63,chr10,84533767,84534328,561,63,372,22.5,66.3,1.03
CpG: 82,chr10,84576273,84577460,1187,82,729,13.8,61.4,0.73
CpG: 38,chr10,84622230,84622676,446,38,271,17,60.8,0.93
CpG: 32,chr10,84754839,84755076,237,32,174,27,73.4,1
CpG: 32,chr10,84758991,84759369,378,32,225,16.9,59.5,0.96
CpG: 25,chr10,84760085,84760328,243,25,165,20.6,67.9,0.91
CpG: 46,chr10,84917514,84917973,459,46,289,20,63,1.02
CpG: 77,chr10,85102420,85103238,818,77,493,18.8,60.3,1.04
CpG: 167,chr10,85184251,85185490,1239,167,887,27,71.6,1.05
CpG: 133,chr10,85386746,85388256,1510,133,956,17.6,63.3,0.88
CpG: 15,chr10,85388358,85388559,201,15,122,14.9,60.7,0.84
CpG: 23,chr10,85598645,85598868,223,23,149,20.6,66.8,0.93
CpG: 35,chr10,85829330,85829651,321,35,225,21.8,70.1,0.89
CpG: 46,chr10,85871823,85872309,486,46,321,18.9,66,0.87
CpG: 97,chr10,85916422,85917222,800,97,585,24.2,73.1,0.92
CpG: 64,chr10,85928425,85928918,493,64,338,26,68.6,1.1
CpG: 43,chr10,85957403,85957884,481,43,305,17.9,63.4,0.89
CpG: 80,chr10,86021770,86022417,647,80,457,24.7,70.6,0.99
CpG: 52,chr10,86300264,86300837,573,52,360,18.2,62.8,0.92
CpG: 37,chr10,86685463,86685798,335,37,228,22.1,68.1,0.96
CpG: 93,chr10,86704861,86705966,1105,93,691,16.8,62.5,0.87
CpG: 49,chr10,86779015,86779531,516,49,290,19,56.2,1.2
CpG: 31,chr10,86908739,86909118,379,31,251,16.4,66.2,0.86
CpG: 25,chr10,87058383,87058611,228,25,166,21.9,72.8,0.83
CpG: 138,chr10,87492445,87493953,1508,138,936,18.3,62.1,0.95
CpG: 55,chr10,88146618,88147197,579,55,370,19,63.9,0.93
CpG: 47,chr10,88356816,88357303,487,47,299,19.3,61.4,1.03
CpG: 85,chr10,88379072,88379755,683,85,501,24.9,73.4,0.93
CpG: 34,chr10,88459494,88459991,497,34,329,13.7,66.2,0.67
CpG: 36,chr10,88730607,88731150,543,36,298,13.3,54.9,0.88
CpG: 78,chr10,88731275,88732090,815,78,530,19.1,65,0.92
CpG: 37,chr10,88826481,88826892,411,37,265,18,64.5,0.88
CpG: 59,chr10,88885817,88886555,738,59,468,16,63.4,0.8
CpG: 58,chr10,89344623,89345135,512,58,374,22.7,73,0.85
CpG: 64,chr10,89685735,89686433,698,64,488,18.3,69.9,0.75
CpG: 37,chr10,89732032,89732462,430,37,239,17.2,55.6,1.11
CpG: 94,chr10,89744948,89745809,861,94,589,21.8,68.4,0.93
CpG: 60,chr10,89873018,89873556,538,60,387,22.3,71.9,0.87
CpG: 30,chr10,90049795,90050172,377,30,218,15.9,57.8,0.95
CpG: 27,chr10,90135095,90135391,296,27,207,18.2,69.9,0.75
CpG: 111,chr10,90828917,90829902,985,111,643,22.5,65.3,1.06
CpG: 29,chr10,90969903,90970147,244,29,174,23.8,71.3,0.95
CpG: 99,chr10,91082300,91083380,1080,99,723,18.3,66.9,0.82
CpG: 21,chr10,91101978,91102217,239,21,122,17.6,51,1.37
CpG: 82,chr10,91123427,91124193,766,82,535,21.4,69.8,0.88
CpG: 165,chr10,91170701,91172103,1402,165,939,23.5,67,1.05
CpG: 55,chr10,91181499,91182011,512,55,316,21.5,61.7,1.14
CpG: 46,chr10,92722069,92722472,403,46,273,22.8,67.7,1
CpG: 135,chr10,93160440,93161666,1226,135,820,22,66.9,0.99
CpG: 37,chr10,93310112,93310563,451,37,305,16.4,67.6,0.73
CpG: 50,chr10,93453370,93453888,518,50,342,19.3,66,0.93
CpG: 21,chr10,93539787,93539997,210,21,147,20,70,0.84
CpG: 54,chr10,93589243,93589698,455,54,289,23.7,63.5,1.18
CpG: 77,chr10,93640822,93641527,705,77,498,21.8,70.6,0.89
CpG: 78,chr10,93833670,93834392,722,78,499,21.6,69.1,0.92
CpG: 38,chr10,93845880,93846433,553,38,298,13.7,53.9,0.95
CpG: 58,chr10,93889173,93889865,692,58,426,16.8,61.6,0.89
CpG: 128,chr10,94035339,94036559,1220,128,822,21,67.4,0.93
CpG: 63,chr10,94147799,94148388,589,63,419,21.4,71.1,0.85
CpG: 26,chr10,94198898,94199118,220,26,148,23.6,67.3,1.05
CpG: 50,chr10,94311884,94312475,591,50,394,16.9,66.7,0.76
CpG: 102,chr10,94514696,94515538,842,102,628,24.2,74.6,0.87
CpG: 95,chr10,94688296,94689126,830,95,591,22.9,71.2,0.9
CpG: 185,chr10,94943600,94945566,1966,185,1201,18.8,61.1,1.01
CpG: 43,chr10,95323488,95324002,514,43,310,16.7,60.3,0.93
CpG: 210,chr10,95414386,95417095,2709,210,1699,15.5,62.7,0.79
CpG: 27,chr10,95501716,95501973,257,27,167,21,65,1.01
CpG: 141,chr10,95514662,95515893,1231,141,833,22.9,67.7,1
CpG: 117,chr10,95563245,95564357,1112,117,705,21,63.4,1.05
CpG: 88,chr10,95940560,95941332,772,88,535,22.8,69.3,0.95
CpG: 128,chr10,96616484,96617784,1300,128,844,19.7,64.9,0.94
CpG: 17,chr10,96618035,96618239,204,17,108,16.7,52.9,1.2
CpG: 222,chr10,98913833,98915907,2074,222,1317,21.4,63.5,1.06
CpG: 106,chr10,99106781,99107741,960,106,652,22.1,67.9,0.96
CpG: 195,chr10,99261496,99264181,2685,195,1555,14.5,57.9,0.87
CpG: 97,chr10,100015456,100016640,1184,97,777,16.4,65.6,0.77
CpG: 58,chr10,100487147,100487810,663,58,429,17.5,64.7,0.84
CpG: 31,chr10,100588950,100589339,389,31,246,15.9,63.2,0.8
CpG: 39,chr10,103028165,103028662,497,39,309,15.7,62.2,0.81
CpG: 19,chr10,103367568,103367772,204,19,149,18.6,73,0.7
CpG: 79,chr10,105573440,105574450,1010,79,552,15.6,54.7,1.07
CpG: 21,chr10,105574850,105575058,208,21,122,20.2,58.7,1.24
CpG: 25,chr10,105799833,105800159,326,25,195,15.3,59.8,0.87
CpG: 78,chr10,105841082,105841866,784,78,516,19.9,65.8,0.92
CpG: 55,chr10,107271870,107272607,737,55,497,14.9,67.4,0.66
CpG: 149,chr10,108161582,108162873,1291,149,888,23.1,68.8,0.98
CpG: 152,chr10,108332143,108333308,1165,152,824,26.1,70.7,1.04
CpG: 49,chr10,110455608,110456050,442,49,248,22.2,56.1,1.41
CpG: 88,chr10,110744922,110745773,851,88,532,20.7,62.5,1.06
CpG: 58,chr10,110919752,110920283,531,58,357,21.8,67.2,0.97
CpG: 104,chr10,111009455,111010438,983,104,618,21.2,62.9,1.07
CpG: 113,chr10,111164482,111165676,1194,113,806,18.9,67.5,0.84
CpG: 41,chr10,111298434,111298840,406,41,272,20.2,67,0.9
CpG: 95,chr10,111472968,111473826,858,95,572,22.1,66.7,1.01
CpG: 84,chr10,111506137,111506897,760,84,506,22.1,66.6,1
CpG: 49,chr10,111972630,111973268,638,49,382,15.4,59.9,0.87
CpG: 25,chr10,112270163,112270423,260,25,181,19.2,69.6,0.79
CpG: 42,chr10,112271836,112272249,413,42,279,20.3,67.6,0.89
CpG: 40,chr10,112928728,112929096,368,40,230,21.7,62.5,1.13
CpG: 150,chr10,114800439,114802201,1762,150,1133,17,64.3,0.82
CpG: 58,chr10,115251058,115251685,627,58,393,18.5,62.7,0.94
CpG: 52,chr10,115315154,115315707,553,52,318,18.8,57.5,1.15
CpG: 44,chr10,115362064,115362593,529,44,302,16.6,57.1,1.02
CpG: 156,chr10,115384251,115385961,1710,156,1096,18.2,64.1,0.89
CpG: 44,chr10,115587398,115587909,511,44,344,17.2,67.3,0.76
CpG: 65,chr10,116113438,116114341,903,65,576,14.4,63.8,0.72
CpG: 24,chr10,116301376,116301579,203,24,132,23.6,65,1.14
CpG: 20,chr10,116418100,116418397,297,20,185,13.5,62.3,0.7
CpG: 123,chr10,116472993,116474365,1372,123,789,17.9,57.5,1.09
CpG: 120,chr10,116581167,116582169,1002,120,684,24,68.3,1.04
CpG: 112,chr10,116949738,116950599,861,112,582,26,67.6,1.14
CpG: 59,chr10,117063294,117063896,602,59,406,19.6,67.4,0.86
CpG: 18,chr10,117073886,117074092,206,18,123,17.5,59.7,0.99
CpG: 103,chr10,117147828,117148852,1024,103,686,20.1,67,0.91
CpG: 59,chr10,117224057,117224549,492,59,342,24,69.5,0.99
CpG: 156,chr10,117375820,117377176,1356,156,890,23,65.6,1.07
CpG: 76,chr10,117629216,117629990,774,76,527,19.6,68.1,0.85
CpG: 15,chr10,117667882,117668099,217,15,111,13.8,51.2,1.08
CpG: 109,chr10,117709874,117710932,1058,109,637,20.6,60.2,1.14
CpG: 52,chr10,117746137,117746486,349,52,248,29.8,71.1,1.2
CpG: 68,chr10,117792294,117793054,760,68,482,17.9,63.4,0.89
CpG: 71,chr10,117845802,117846391,589,71,348,24.1,59.1,1.41
CpG: 80,chr10,118141542,118142296,754,80,516,21.2,68.4,0.93
CpG: 155,chr10,118867982,118869486,1504,155,943,20.6,62.7,1.05
CpG: 135,chr10,119239198,119240393,1195,135,851,22.6,71.2,0.9
CpG: 145,chr10,119453410,119454752,1342,145,937,21.6,69.8,0.89
CpG: 20,chr10,120089622,120089870,248,20,151,16.1,60.9,0.87
CpG: 23,chr10,120105431,120105744,313,23,178,14.7,56.9,0.93
CpG: 53,chr10,120112608,120113331,723,53,425,14.7,58.8,0.85
CpG: 65,chr10,120201290,120201968,678,65,438,19.2,64.6,0.92
CpG: 27,chr10,120208701,120208952,251,27,167,21.5,66.5,0.99
CpG: 54,chr10,120226998,120227574,576,54,380,18.8,66,0.87
CpG: 20,chr10,120414651,120414898,247,20,138,16.2,55.9,1.05
CpG: 214,chr10,120474919,120477610,2691,214,1585,15.9,58.9,0.92
CpG: 61,chr10,120552439,120553188,749,61,488,16.3,65.2,0.8
CpG: 100,chr10,120898367,120899190,823,100,592,24.3,71.9,0.94
CpG: 23,chr10,121033870,121034143,273,23,167,16.8,61.2,0.94
CpG: 78,chr10,121310231,121311024,793,78,549,19.7,69.2,0.83
CpG: 69,chr10,121351001,121351542,541,69,395,25.5,73,0.96
CpG: 67,chr10,121364966,121365648,682,67,460,19.6,67.4,0.87
CpG: 113,chr10,121475503,121476794,1291,113,860,17.5,66.6,0.81
CpG: 21,chr10,121586242,121586510,268,21,155,15.7,57.8,0.99
CpG: 45,chr10,121586706,121587024,318,45,230,28.3,72.3,1.09
CpG: 18,chr10,121606018,121606232,214,18,137,16.8,64,0.88
CpG: 19,chr10,121606892,121607129,237,19,133,16,56.1,1.04
CpG: 94,chr10,121625915,121626707,792,94,557,23.7,70.3,0.96
CpG: 64,chr10,121641588,121642085,497,64,343,25.8,69,1.1
CpG: 45,chr10,121739650,121740164,514,45,324,17.5,63,0.88
CpG: 78,chr10,122047373,122047900,527,78,385,29.6,73.1,1.11
CpG: 67,chr10,122096631,122097215,584,67,401,22.9,68.7,0.98
CpG: 67,chr10,122448598,122449321,723,67,468,18.5,64.7,0.88
CpG: 99,chr10,122678629,122679478,849,99,625,23.3,73.6,0.86
CpG: 28,chr10,122802275,122802612,337,28,223,16.6,66.2,0.76
CpG: 141,chr10,122985224,122986608,1384,141,771,20.4,55.7,1.33
CpG: 59,chr10,123076025,123076570,545,59,349,21.7,64,1.06
CpG: 102,chr10,123196325,123197341,1016,102,645,20.1,63.5,1
CpG: 133,chr10,123264440,123265789,1349,133,894,19.7,66.3,0.9
CpG: 36,chr10,125388967,125389366,399,36,254,18,63.7,0.92
CpG: 97,chr10,125966085,125966921,836,97,581,23.2,69.5,0.96
CpG: 54,chr10,126900951,126901454,503,54,372,21.5,74,0.79
CpG: 25,chr10,126905771,126906066,295,25,165,16.9,55.9,1.08
CpG: 29,chr10,126928336,126928636,300,29,218,19.3,72.7,0.73
CpG: 176,chr10,126978410,126980162,1752,176,1195,20.1,68.2,0.87
CpG: 35,chr10,127030576,127030856,280,35,202,25,72.1,0.99
CpG: 93,chr10,127040964,127042234,1270,93,809,14.6,63.7,0.72
CpG: 21,chr10,127049020,127049263,243,21,141,17.3,58,1.03
CpG: 102,chr10,127059284,127060460,1176,102,659,17.3,56,1.1
CpG: 20,chr10,127063628,127063839,211,20,145,19,68.7,0.81
CpG: 80,chr10,127079603,127080375,772,80,564,20.7,73.1,0.78
CpG: 26,chr10,127081526,127081730,204,26,153,25.5,75,0.94
CpG: 88,chr10,127090960,127091967,1007,88,674,17.5,66.9,0.78
CpG: 20,chr10,127121033,127121283,250,20,152,16,60.8,0.91
CpG: 135,chr10,127164980,127166258,1278,135,896,21.1,70.1,0.86
CpG: 49,chr10,127170598,127171211,613,49,398,16,64.9,0.78
CpG: 23,chr10,127180239,127180475,236,23,170,19.5,72,0.76
CpG: 37,chr10,127188512,127188857,345,37,262,21.4,75.9,0.78
CpG: 23,chr10,127189837,127190100,263,23,191,17.5,72.6,0.67
CpG: 33,chr10,127195381,127195717,336,33,242,19.6,72,0.76
CpG: 57,chr10,127211218,127211758,540,57,357,21.1,66.1,0.97
CpG: 20,chr10,127239295,127239520,225,20,135,17.8,60,0.99
CpG: 30,chr10,127262819,127263131,312,30,203,19.2,65.1,0.93
CpG: 61,chr10,127266238,127266876,638,61,442,19.1,69.3,0.87
CpG: 37,chr10,127288692,127289174,482,37,274,15.4,56.8,0.95
CpG: 37,chr10,127290360,127290708,348,37,240,21.3,69,0.93
CpG: 56,chr10,127311492,127312038,546,56,337,20.5,61.7,1.08
CpG: 77,chr10,127326332,127327247,915,77,605,16.8,66.1,0.77
CpG: 50,chr10,127380387,127380653,266,50,210,37.6,78.9,1.26
CpG: 38,chr10,127511688,127512121,433,38,281,17.6,64.9,0.84
CpG: 31,chr10,127512785,127513196,411,31,245,15.1,59.6,0.85
CpG: 60,chr10,127526221,127526946,725,60,473,16.6,65.2,0.78
CpG: 33,chr10,127534110,127534472,362,33,243,18.2,67.1,0.82
CpG: 26,chr10,127535010,127535219,209,26,148,24.9,70.8,0.99
CpG: 18,chr10,127544437,127544693,256,18,159,14.1,62.1,0.75
CpG: 19,chr10,127593772,127593990,218,19,129,17.4,59.2,1
CpG: 18,chr10,127621648,127621902,254,18,169,14.2,66.5,0.64
CpG: 65,chr10,127666490,127667185,695,65,386,18.7,55.5,1.24
CpG: 57,chr10,127676862,127677409,547,57,364,20.8,66.5,0.99
CpG: 44,chr10,127739625,127740040,415,44,263,21.2,63.4,1.06
CpG: 95,chr10,128035278,128036310,1032,95,659,18.4,63.9,0.9
CpG: 129,chr10,128058706,128059869,1163,129,782,22.2,67.2,0.99
CpG: 57,chr10,128083247,128083990,743,57,461,15.3,62,0.8
CpG: 54,chr10,128092858,128093472,614,54,427,17.6,69.5,0.76
CpG: 82,chr10,128096761,128097485,724,82,541,22.7,74.7,0.81
CpG: 115,chr10,128194009,128195213,1204,115,827,19.1,68.7,0.82
CpG: 20,chr10,128211740,128211946,206,20,125,19.4,60.7,1.06
CpG: 19,chr10,128213199,128213400,201,19,122,18.9,60.7,1.03
CpG: 46,chr10,128232070,128232435,365,46,262,25.2,71.8,1
CpG: 38,chr10,128270359,128270771,412,38,267,18.4,64.8,0.89
CpG: 23,chr10,128303133,128303455,322,23,179,14.3,55.6,0.92
CpG: 32,chr10,128322413,128322847,434,32,281,14.7,64.7,0.72
CpG: 47,chr10,128337602,128338095,493,47,340,19.1,69,0.8
CpG: 66,chr10,128368484,128369261,777,66,450,17,57.9,1.02
CpG: 83,chr10,128376744,128377541,797,83,548,20.8,68.8,0.88
CpG: 18,chr10,128409748,128409952,204,18,137,17.6,67.2,0.81
CpG: 42,chr10,128411345,128411845,500,42,330,16.8,66,0.78
CpG: 95,chr10,128458564,128459458,894,95,550,21.3,61.5,1.13
CpG: 19,chr10,128459651,128459860,209,19,128,18.2,61.2,0.97
CpG: 58,chr10,128525060,128525800,740,58,490,15.7,66.2,0.72
CpG: 56,chr10,128547283,128548018,735,56,462,15.2,62.9,0.77
CpG: 31,chr10,128548861,128549223,362,31,214,17.1,59.1,0.99
CpG: 92,chr10,128565283,128566452,1169,92,729,15.7,62.4,0.81
CpG: 19,chr10,128570120,128570359,239,19,149,15.9,62.3,0.82
CpG: 81,chr10,128589595,128590569,974,81,606,16.6,62.2,0.86
CpG: 37,chr10,128626155,128626554,399,37,240,18.5,60.2,1.04
CpG: 19,chr10,128645754,128645956,202,19,138,18.8,68.3,0.83
CpG: 35,chr10,128668967,128669418,451,35,284,15.5,63,0.79
CpG: 20,chr10,128673785,128673993,208,20,129,19.2,62,1.02
CpG: 28,chr10,128695892,128696208,316,28,232,17.7,73.4,0.7
CpG: 61,chr10,128704529,128705218,689,61,459,17.7,66.6,0.81
CpG: 37,chr10,128743785,128744155,370,37,263,20,71.1,0.8
CpG: 63,chr10,128747783,128748685,902,63,543,14,60.2,0.77
CpG: 71,chr10,128804987,128805758,771,71,510,18.4,66.1,0.84
CpG: 46,chr10,128821444,128822073,629,46,374,14.6,59.5,0.83
CpG: 57,chr10,128891065,128891677,612,57,400,18.6,65.4,0.88
CpG: 66,chr10,128909881,128910349,468,66,359,28.2,76.7,1.01
CpG: 38,chr10,128923104,128923546,442,38,297,17.2,67.2,0.77
CpG: 42,chr10,128933615,128934211,596,42,374,14.1,62.8,0.73
CpG: 18,chr10,130444795,130445008,213,18,143,16.9,67.1,0.75
CpG: 33,chr10,130470357,130470638,281,33,202,23.5,71.9,0.91
CpG: 99,chr11,6291320,6292275,955,99,635,20.7,66.5,0.94
CpG: 93,chr11,4848796,4849787,991,93,648,18.8,65.4,0.88
CpG: 61,chr11,59506008,59506805,797,61,496,15.3,62.2,0.8
CpG: 69,chr11,73137871,73138390,519,69,373,26.6,71.9,1.03
CpG: 52,chr11,78511866,78512482,616,52,365,16.9,59.3,0.97
CpG: 46,chr11,96861685,96862289,604,46,371,15.2,61.4,0.81
CpG: 57,chr11,106036775,106037324,549,57,368,20.8,67,0.93
CpG: 170,chr11,108920190,108922170,1980,170,1220,17.2,61.6,0.91
CpG: 40,chr11,3123323,3123768,445,40,293,18,65.8,0.88
CpG: 54,chr11,3192997,3193699,702,54,421,15.4,60,0.86
CpG: 91,chr11,3202282,3203193,911,91,581,20,63.8,0.98
CpG: 80,chr11,3265989,3266686,697,80,484,23,69.4,0.95
CpG: 19,chr11,3288696,3288937,241,19,139,15.8,57.7,0.95
CpG: 164,chr11,3289165,3291061,1896,164,1210,17.3,63.8,0.86
CpG: 72,chr11,3331816,3332496,680,72,474,21.2,69.7,0.88
CpG: 53,chr11,3408802,3409339,537,53,363,19.7,67.6,0.88
CpG: 48,chr11,3452179,3452683,504,48,312,19,61.9,1
CpG: 21,chr11,3517025,3517261,236,21,158,17.8,66.9,0.8
CpG: 26,chr11,3535666,3535984,318,26,226,16.4,71.1,0.65
CpG: 45,chr11,3628951,3629564,613,45,390,14.7,63.6,0.73
CpG: 107,chr11,3648596,3649551,955,107,601,22.4,62.9,1.14
CpG: 25,chr11,3705400,3705644,244,25,161,20.5,66,0.94
CpG: 90,chr11,3761708,3762351,643,90,467,28,72.6,1.06
CpG: 40,chr11,3774664,3775008,344,40,256,23.3,74.4,0.84
CpG: 28,chr11,3863606,3863857,251,28,170,22.3,67.7,0.97
CpG: 55,chr11,3894617,3895477,860,55,499,12.8,58,0.77
CpG: 57,chr11,3913417,3913970,553,57,372,20.6,67.3,0.92
CpG: 79,chr11,3997985,3998819,834,79,517,18.9,62,0.99
CpG: 35,chr11,4096554,4096905,351,35,220,19.9,62.7,1.02
CpG: 34,chr11,4118464,4118842,378,34,255,18,67.5,0.79
CpG: 31,chr11,4135223,4135533,310,31,171,20,55.2,1.34
CpG: 42,chr11,4160219,4160617,398,42,267,21.1,67.1,0.94
CpG: 65,chr11,4186642,4187203,561,65,405,23.2,72.2,0.9
CpG: 46,chr11,4218123,4218614,491,46,342,18.7,69.7,0.77
CpG: 56,chr11,4266612,4267106,494,56,347,22.7,70.2,0.92
CpG: 79,chr11,4594212,4594952,740,79,524,21.4,70.8,0.86
CpG: 26,chr11,4637621,4637919,298,26,206,17.4,69.1,0.74
CpG: 100,chr11,4745938,4746987,1049,100,662,19.1,63.1,0.96
CpG: 43,chr11,4895282,4895833,551,43,345,15.6,62.6,0.8
CpG: 165,chr11,4946996,4948241,1245,165,923,26.5,74.1,0.97
CpG: 48,chr11,4986840,4987274,434,48,291,22.1,67.1,1.01
CpG: 69,chr11,5057945,5058535,590,69,419,23.4,71,0.93
CpG: 21,chr11,5059843,5060049,206,21,135,20.4,65.5,0.95
CpG: 76,chr11,5061391,5062326,935,76,654,16.3,69.9,0.67
CpG: 23,chr11,5063952,5064258,306,23,202,15,66,0.7
CpG: 30,chr11,5065018,5065397,379,30,243,15.8,64.1,0.77
CpG: 132,chr11,5098460,5099696,1236,132,845,21.4,68.4,0.91
CpG: 56,chr11,5151984,5152559,575,56,383,19.5,66.6,0.88
CpG: 86,chr11,5261162,5262087,925,86,535,18.6,57.8,1.12
CpG: 145,chr11,5443960,5445415,1455,145,895,19.9,61.5,1.07
CpG: 88,chr11,5520598,5521782,1184,88,696,14.9,58.8,0.87
CpG: 72,chr11,5541743,5542349,606,72,428,23.8,70.6,0.95
CpG: 63,chr11,5707307,5707799,492,63,367,25.6,74.6,0.92
CpG: 24,chr11,5716858,5717201,343,24,215,14,62.7,0.73
CpG: 68,chr11,5740728,5741332,604,68,457,22.5,75.7,0.79
CpG: 60,chr11,5762028,5762460,432,60,304,27.8,70.4,1.13
CpG: 60,chr11,5788219,5788827,608,60,398,19.7,65.5,0.92
CpG: 57,chr11,5837355,5838079,724,57,460,15.7,63.5,0.78
CpG: 55,chr11,5861773,5862357,584,55,410,18.8,70.2,0.8
CpG: 50,chr11,5878003,5878493,490,50,336,20.4,68.6,0.9
CpG: 31,chr11,5902021,5902327,306,31,199,20.3,65,0.96
CpG: 53,chr11,5955545,5956093,548,53,348,19.3,63.5,0.96
CpG: 23,chr11,5972162,5972405,243,23,158,18.9,65,0.9
CpG: 113,chr11,6064996,6066085,1089,113,626,20.8,57.5,1.26
CpG: 55,chr11,6199825,6200401,576,55,375,19.1,65.1,0.9
CpG: 35,chr11,6267407,6267896,489,35,295,14.3,60.3,0.79
CpG: 18,chr11,6274191,6274450,259,18,145,13.9,56,0.89
CpG: 30,chr11,6274673,6275009,336,30,206,17.9,61.3,1
CpG: 29,chr11,6389594,6389970,376,29,261,15.4,69.4,0.64
CpG: 106,chr11,6415425,6416451,1026,106,687,20.7,67,0.92
CpG: 72,chr11,6444021,6444762,741,72,452,19.4,61,1.06
CpG: 22,chr11,6447281,6447509,228,22,118,19.3,51.8,1.57
CpG: 83,chr11,6474938,6475777,839,83,462,19.8,55.1,1.31
CpG: 37,chr11,6528548,6528932,384,37,254,19.3,66.1,0.88
CpG: 25,chr11,6547034,6547252,218,25,146,22.9,67,1.02
CpG: 30,chr11,6605463,6605768,305,30,216,19.7,70.8,0.79
CpG: 61,chr11,6625740,6626394,654,61,426,18.7,65.1,0.88
CpG: 51,chr11,7063695,7064250,555,51,379,18.4,68.3,0.79
CpG: 107,chr11,7213334,7214110,776,107,557,27.6,71.8,1.09
CpG: 60,chr11,8624300,8624839,539,60,358,22.3,66.4,1.01
CpG: 59,chr11,8664109,8664649,540,59,377,21.9,69.8,0.91
CpG: 41,chr11,9010914,9011323,409,41,282,20,68.9,0.84
CpG: 25,chr11,9150400,9150646,246,25,145,20.3,58.9,1.17
CpG: 51,chr11,11113908,11114582,674,51,457,15.1,67.8,0.66
CpG: 85,chr11,11115678,11116517,839,85,573,20.3,68.3,0.87
CpG: 45,chr11,11461979,11462326,347,45,222,25.9,64,1.27
CpG: 132,chr11,11685304,11686481,1177,132,776,22.4,65.9,1.04
CpG: 51,chr11,11808710,11809131,421,51,286,24.2,67.9,1.05
CpG: 81,chr11,12025554,12026332,778,81,491,20.8,63.1,1.05
CpG: 134,chr11,12036489,12038108,1619,134,840,16.6,51.9,1.23
CpG: 48,chr11,12464568,12464924,356,48,260,27,73,1.01
CpG: 44,chr11,16257539,16257942,403,44,275,21.8,68.2,0.94
CpG: 42,chr11,16507843,16508363,520,42,326,16.2,62.7,0.87
CpG: 80,chr11,16752214,16753080,866,80,578,18.5,66.7,0.83
CpG: 25,chr11,16951076,16951424,348,25,204,14.4,58.6,0.84
CpG: 106,chr11,17159070,17159983,913,106,613,23.2,67.1,1.05
CpG: 19,chr11,17208409,17208620,211,19,141,18,66.8,0.82
CpG: 40,chr11,17211326,17211726,400,40,251,20,62.8,1.03
CpG: 33,chr11,17257527,17257808,281,33,183,23.5,65.1,1.11
CpG: 68,chr11,17953288,17953984,696,68,459,19.5,65.9,0.91
CpG: 42,chr11,18871459,18871945,486,42,327,17.3,67.3,0.76
CpG: 28,chr11,19018884,19019289,405,28,236,13.8,58.3,0.81
CpG: 42,chr11,19019691,19020072,381,42,264,22,69.3,0.92
CpG: 20,chr11,19020492,19020766,274,20,168,14.6,61.3,0.8
CpG: 36,chr11,19027297,19027611,314,36,216,22.9,68.8,0.98
CpG: 64,chr11,19919955,19920594,639,64,427,20,66.8,0.9
CpG: 131,chr11,19924379,19925902,1523,131,982,17.2,64.5,0.83
CpG: 49,chr11,20020717,20021262,545,49,319,18,58.5,1.05
CpG: 83,chr11,20112370,20113193,823,83,539,20.2,65.5,0.94
CpG: 82,chr11,20201018,20201921,903,82,593,18.2,65.7,0.86
CpG: 95,chr11,20248921,20249712,791,95,565,24,71.4,0.95
CpG: 84,chr11,20332037,20333104,1067,84,689,15.7,64.6,0.76
CpG: 22,chr11,20455179,20455490,311,22,182,14.1,58.5,0.83
CpG: 28,chr11,20532162,20532553,391,28,255,14.3,65.2,0.74
CpG: 126,chr11,20542499,20543770,1271,126,848,19.8,66.7,0.92
CpG: 71,chr11,20631785,20632570,785,71,521,18.1,66.4,0.84
CpG: 110,chr11,20740857,20741948,1091,110,715,20.2,65.5,0.94
CpG: 94,chr11,20830500,20831349,849,94,550,22.1,64.8,1.06
CpG: 71,chr11,21091237,21091960,723,71,410,19.6,56.7,1.22
CpG: 96,chr11,21238584,21239663,1079,96,604,17.8,56,1.14
CpG: 94,chr11,21370442,21371489,1047,94,707,18,67.5,0.8
CpG: 48,chr11,21571824,21572470,646,48,386,14.9,59.8,0.83
CpG: 101,chr11,21992870,21993891,1021,101,678,19.8,66.4,0.9
CpG: 44,chr11,21996655,21997043,388,44,264,22.7,68,0.99
CpG: 113,chr11,22000852,22002260,1408,113,887,16.1,63,0.81
CpG: 26,chr11,22002804,22003059,255,26,157,20.4,61.6,1.09
CpG: 20,chr11,22003780,22004051,271,20,171,14.8,63.1,0.74
CpG: 67,chr11,22286516,22287124,608,67,442,22,72.7,0.91
CpG: 67,chr11,22512236,22512873,637,67,449,21,70.5,0.85
CpG: 122,chr11,22858860,22859999,1139,122,789,21.4,69.3,0.89
CpG: 25,chr11,22860385,22860709,324,25,211,15.4,65.1,0.73
CpG: 76,chr11,22971974,22972993,1019,76,581,14.9,57,0.92
CpG: 35,chr11,22981956,22982373,417,35,279,16.8,66.9,0.75
CpG: 55,chr11,22990520,22991100,580,55,355,19,61.2,1.02
CpG: 39,chr11,23008253,23008693,440,39,283,17.7,64.3,0.88
CpG: 47,chr11,23067721,23068189,468,47,308,20.1,65.8,0.94
CpG: 93,chr11,23255140,23256357,1217,93,716,15.3,58.8,0.89
CpG: 134,chr11,23305844,23307266,1422,134,801,18.8,56.3,1.21
CpG: 49,chr11,23497515,23497931,416,49,296,23.6,71.2,0.93
CpG: 20,chr11,23498117,23498359,242,20,164,16.5,67.8,0.79
CpG: 86,chr11,23633135,23633766,631,86,453,27.3,71.8,1.06
CpG: 75,chr11,23665437,23666438,1001,75,589,15,58.8,0.87
CpG: 101,chr11,23770520,23771541,1021,101,607,19.8,59.5,1.12
CpG: 56,chr11,23894646,23895356,710,56,467,15.8,65.8,0.74
CpG: 109,chr11,24076383,24077912,1529,109,972,14.3,63.6,0.71
CpG: 67,chr11,24079023,24079963,940,67,529,14.3,56.3,0.9
CpG: 60,chr11,24081328,24082155,827,60,508,14.5,61.4,0.77
CpG: 52,chr11,24164174,24164882,708,52,452,14.7,63.8,0.72
CpG: 76,chr11,26210158,26210727,569,76,384,26.7,67.5,1.19
CpG: 38,chr11,26387147,26387495,348,38,226,21.8,64.9,1.04
CpG: 39,chr11,26593361,26593788,427,39,300,18.3,70.3,0.75
CpG: 57,chr11,28583291,28583837,546,57,363,20.9,66.5,0.94
CpG: 27,chr11,29130675,29130955,280,27,186,19.3,66.4,0.88
CpG: 123,chr11,29172125,29173524,1399,123,848,17.6,60.6,0.96
CpG: 45,chr11,29247060,29247529,469,45,298,19.2,63.5,0.95
CpG: 100,chr11,29373357,29374184,827,100,583,24.2,70.5,0.97
CpG: 27,chr11,29514876,29515194,318,27,214,17,67.3,0.76
CpG: 23,chr11,29526389,29526598,209,23,143,22,68.4,0.96
CpG: 55,chr11,29547429,29548012,583,55,339,18.9,58.1,1.13
CpG: 94,chr11,29692881,29693945,1064,94,656,17.7,61.7,0.93
CpG: 75,chr11,29824791,29825496,705,75,479,21.3,67.9,0.92
CpG: 49,chr11,30024479,30024998,519,49,346,18.9,66.7,0.85
CpG: 26,chr11,30025815,30026104,289,26,193,18,66.8,0.83
CpG: 25,chr11,30198340,30198612,272,25,171,18.4,62.9,0.93
CpG: 104,chr11,30267515,30268545,1030,104,701,20.2,68.1,0.87
CpG: 38,chr11,30649110,30649612,502,38,315,15.1,62.7,0.77
CpG: 65,chr11,30754898,30755478,580,65,419,22.4,72.2,0.86
CpG: 71,chr11,30771621,30772484,863,71,490,16.5,56.8,1.02
CpG: 34,chr11,30885287,30885607,320,34,232,21.2,72.5,0.84
CpG: 23,chr11,30953846,30954096,250,23,169,18.4,67.6,0.81
CpG: 36,chr11,30954309,30954643,334,36,228,21.6,68.3,0.93
CpG: 128,chr11,31368610,31370299,1689,128,1030,15.2,61,0.82
CpG: 38,chr11,31371323,31371818,495,38,318,15.4,64.2,0.74
CpG: 59,chr11,31671346,31672009,663,59,397,17.8,59.9,1
CpG: 58,chr11,31870662,31871460,798,58,459,14.5,57.5,0.88
CpG: 43,chr11,31965601,31966053,452,43,321,19,71,0.76
CpG: 47,chr11,32205054,32205668,614,47,379,15.3,61.7,0.8
CpG: 20,chr11,32213278,32213481,203,20,132,19.7,65,0.94
CpG: 92,chr11,32221590,32222474,884,92,593,20.8,67.1,0.93
CpG: 44,chr11,32226389,32226811,422,44,291,20.9,69,0.88
CpG: 44,chr11,32267338,32267732,394,44,280,22.3,71.1,0.89
CpG: 47,chr11,32347832,32348181,349,47,255,26.9,73.1,1.04
CpG: 126,chr11,32454567,32456177,1610,126,910,15.7,56.5,0.98
CpG: 85,chr11,32532758,32533545,787,85,521,21.6,66.2,1
CpG: 75,chr11,32642317,32643180,863,75,476,17.4,55.2,1.14
CpG: 14,chr11,32726473,32726688,215,14,128,13,59.5,0.77
CpG: 40,chr11,33122877,33123337,460,40,319,17.4,69.3,0.73
CpG: 132,chr11,33146776,33148198,1422,132,873,18.6,61.4,1
CpG: 91,chr11,33162421,33163415,994,91,643,18.3,64.7,0.9
CpG: 304,chr11,33200452,33204334,3882,304,2352,15.7,60.6,0.85
CpG: 98,chr11,33513021,33513849,828,98,572,23.7,69.1,1
CpG: 18,chr11,33680415,33680640,225,18,126,16,56,1.02
CpG: 43,chr11,33843429,33843784,355,43,272,24.2,76.6,0.83
CpG: 43,chr11,34833362,34833910,548,43,317,15.7,57.8,0.95
CpG: 83,chr11,35120996,35122006,1010,83,632,16.4,62.6,0.84
CpG: 19,chr11,35707932,35708133,201,19,126,18.9,62.7,0.97
CpG: 74,chr11,35769295,35770092,797,74,540,18.6,67.8,0.81
CpG: 99,chr11,35797511,35798675,1164,99,674,17,57.9,1.01
CpG: 35,chr11,35834278,35834641,363,35,243,19.3,66.9,0.86
CpG: 89,chr11,35979922,35980712,790,89,553,22.5,70,0.92
CpG: 19,chr11,36008262,36008488,226,19,141,16.8,62.4,0.86
CpG: 18,chr11,36027176,36027405,229,18,137,15.7,59.8,0.88
CpG: 33,chr11,36047223,36047650,427,33,246,15.5,57.6,0.95
CpG: 17,chr11,36139498,36139733,235,17,134,14.5,57,0.91
CpG: 51,chr11,37236272,37236935,663,51,371,15.4,56,0.99
CpG: 43,chr11,40692329,40692747,418,43,299,20.6,71.5,0.82
CpG: 22,chr11,40694730,40694957,227,22,134,19.4,59,1.11
CpG: 41,chr11,40733648,40734143,495,41,304,16.6,61.4,0.88
CpG: 36,chr11,40754907,40755393,486,36,314,14.8,64.6,0.71
CpG: 31,chr11,43433682,43433979,297,31,188,20.9,63.3,1.07
CpG: 22,chr11,43463300,43463559,259,22,160,17,61.8,0.89
CpG: 22,chr11,43490907,43491181,274,22,155,16.1,56.6,1.01
CpG: 93,chr11,43528462,43529487,1025,93,693,18.1,67.6,0.81
CpG: 108,chr11,43681870,43682698,828,108,585,26.1,70.7,1.05
CpG: 17,chr11,43705280,43705531,251,17,144,13.5,57.4,0.83
CpG: 28,chr11,43747719,43748045,326,28,197,17.2,60.4,0.98
CpG: 29,chr11,43766965,43767263,298,29,191,19.5,64.1,0.96
CpG: 46,chr11,43775819,43776340,521,46,339,17.7,65.1,0.84
CpG: 26,chr11,43836436,43836673,237,26,171,21.9,72.2,0.84
CpG: 70,chr11,44470111,44470811,700,70,465,20,66.4,0.91
CpG: 89,chr11,44518688,44519302,614,89,454,29,73.9,1.07
CpG: 47,chr11,44618233,44618626,393,47,273,23.9,69.5,1
CpG: 21,chr11,44620335,44620646,311,21,193,13.5,62.1,0.7
CpG: 84,chr11,45851701,45852544,843,84,510,19.9,60.5,1.09
CpG: 94,chr11,45944310,45945125,815,94,587,23.1,72,0.89
CpG: 30,chr11,45955163,45955536,373,30,225,16.1,60.3,0.91
CpG: 91,chr11,45980057,45980944,887,91,569,20.5,64.1,1
CpG: 31,chr11,46056019,46056350,331,31,217,18.7,65.6,0.89
CpG: 36,chr11,46166194,46166601,407,36,289,17.7,71,0.7
CpG: 62,chr11,46311664,46312458,794,62,520,15.6,65.5,0.73
CpG: 67,chr11,46436915,46437654,739,67,462,18.1,62.5,0.93
CpG: 86,chr11,47988408,47989172,764,86,562,22.5,73.6,0.84
CpG: 16,chr11,48753673,48753878,205,16,127,15.6,62,0.93
CpG: 37,chr11,48800313,48800763,450,37,272,16.4,60.4,0.9
CpG: 81,chr11,48816685,48817551,866,81,596,18.7,68.8,0.8
CpG: 73,chr11,48837390,48838030,640,73,451,22.8,70.5,0.92
CpG: 18,chr11,48849541,48849747,206,18,132,17.5,64.1,0.85
CpG: 25,chr11,48855410,48855755,345,25,195,14.5,56.5,0.92
CpG: 51,chr11,49169118,49169636,518,51,343,19.7,66.2,0.9
CpG: 47,chr11,49203383,49203838,455,47,317,20.7,69.7,0.85
CpG: 53,chr11,49243871,49244453,582,53,415,18.2,71.3,0.73
CpG: 32,chr11,49250478,49250859,381,32,258,16.8,67.7,0.75
CpG: 51,chr11,49609732,49610329,597,51,401,17.1,67.2,0.76
CpG: 30,chr11,49633991,49634401,410,30,254,14.6,62,0.76
CpG: 109,chr11,49712022,49712957,935,109,637,23.3,68.1,1.04
CpG: 57,chr11,49794161,49794992,831,57,537,13.7,64.6,0.66
CpG: 72,chr11,49846399,49847272,873,72,578,16.5,66.2,0.76
CpG: 100,chr11,49901582,49902260,678,100,513,29.5,75.7,1.07
CpG: 97,chr11,50024908,50025754,846,97,518,22.9,61.2,1.22
CpG: 60,chr11,50131269,50131721,452,60,327,26.5,72.3,1.03
CpG: 27,chr11,50174662,50175016,354,27,235,15.3,66.4,0.73
CpG: 58,chr11,50210277,50210941,664,58,436,17.5,65.7,0.82
CpG: 40,chr11,50225175,50225450,275,40,210,29.1,76.4,1.04
CpG: 20,chr11,50225692,50225946,254,20,173,15.7,68.1,0.69
CpG: 31,chr11,50230966,50231322,356,31,232,17.4,65.2,0.82
CpG: 20,chr11,50234755,50234978,223,20,159,17.9,71.3,0.71
CpG: 94,chr11,50236431,50237500,1069,94,710,17.6,66.4,0.8
CpG: 98,chr11,50291634,50292618,984,98,594,19.9,60.4,1.09
CpG: 83,chr11,50325269,50325990,721,83,492,23,68.2,1.01
CpG: 73,chr11,50359091,50359865,774,73,498,18.9,64.3,0.91
CpG: 143,chr11,50376899,50378597,1698,143,1043,16.8,61.4,0.9
CpG: 54,chr11,50430636,50431171,535,54,292,20.2,54.6,1.37
CpG: 156,chr11,50601699,50603537,1838,156,1138,17,61.9,0.89
CpG: 36,chr11,50827446,50827820,374,36,255,19.3,68.2,0.86
CpG: 80,chr11,50851006,50851671,665,80,470,24.1,70.7,0.97
CpG: 29,chr11,50859621,50860057,436,29,266,13.3,61,0.75
CpG: 46,chr11,50915715,50916245,530,46,359,17.4,67.7,0.76
CpG: 25,chr11,51059272,51059496,224,25,155,22.3,69.2,0.96
CpG: 91,chr11,51262870,51263730,860,91,575,21.2,66.9,0.95
CpG: 96,chr11,51289767,51290464,697,96,535,27.5,76.8,0.94
CpG: 54,chr11,51584496,51585010,514,54,343,21,66.7,0.94
CpG: 137,chr11,51605992,51607098,1106,137,682,24.8,61.7,1.33
CpG: 40,chr11,51619750,51620108,358,40,230,22.3,64.2,1.1
CpG: 51,chr11,51635615,51636047,432,51,293,23.6,67.8,1.03
CpG: 84,chr11,51650412,51651139,727,84,524,23.1,72.1,0.89
CpG: 47,chr11,51688626,51689166,540,47,339,17.4,62.8,0.88
CpG: 87,chr11,51755967,51756822,855,87,603,20.4,70.5,0.82
CpG: 22,chr11,51763603,51763846,243,22,165,18.1,67.9,0.82
CpG: 146,chr11,51856327,51858489,2162,146,1239,13.5,57.3,0.84
CpG: 46,chr11,51967566,51967897,331,46,234,27.8,70.7,1.12
CpG: 61,chr11,52000148,52000809,661,61,427,18.5,64.6,0.89
CpG: 32,chr11,52004136,52004446,310,32,215,20.6,69.4,0.86
CpG: 137,chr11,52098536,52099647,1111,137,810,24.7,72.9,0.93
CpG: 33,chr11,52167784,52168135,351,33,253,18.8,72.1,0.73
CpG: 80,chr11,52231742,52232473,731,80,501,21.9,68.5,0.93
CpG: 80,chr11,52282634,52283389,755,80,491,21.2,65,1
CpG: 18,chr11,52314224,52314447,223,18,121,16.1,54.3,1.12
CpG: 111,chr11,52360504,52361866,1362,111,853,16.3,62.6,0.83
CpG: 52,chr11,52396333,52396823,490,52,315,21.2,64.3,1.04
CpG: 91,chr11,52764518,52765273,755,91,547,24.1,72.5,0.92
CpG: 124,chr11,53299618,53300762,1144,124,766,21.7,67,0.97
CpG: 17,chr11,53324604,53324817,213,17,136,16,63.8,0.79
CpG: 110,chr11,53350332,53351295,963,110,641,22.8,66.6,1.03
CpG: 69,chr11,53430470,53431262,792,69,492,17.4,62.1,0.93
CpG: 49,chr11,53457053,53457547,494,49,340,19.8,68.8,0.84
CpG: 62,chr11,53463320,53463960,640,62,428,19.4,66.9,0.87
CpG: 32,chr11,53466421,53466896,475,32,298,13.5,62.7,0.69
CpG: 155,chr11,53478603,53480059,1456,155,1010,21.3,69.4,0.88
CpG: 58,chr11,53519746,53520270,524,58,341,22.1,65.1,1.06
CpG: 62,chr11,53567249,53567852,603,62,421,20.6,69.8,0.86
CpG: 33,chr11,53636240,53636498,258,33,183,25.6,70.9,1.02
CpG: 67,chr11,53706712,53707411,699,67,449,19.2,64.2,0.93
CpG: 93,chr11,53769896,53770657,761,93,502,24.4,66,1.13
CpG: 40,chr11,53859024,53859418,394,40,266,20.3,67.5,0.89
CpG: 82,chr11,53891079,53892061,982,82,634,16.7,64.6,0.8
CpG: 91,chr11,53979550,53980496,946,91,624,19.2,66,0.89
CpG: 70,chr11,54027694,54028576,882,70,567,15.9,64.3,0.77
CpG: 59,chr11,54100795,54101372,577,59,353,20.5,61.2,1.09
CpG: 49,chr11,54303909,54304468,559,49,370,17.5,66.2,0.8
CpG: 89,chr11,54437986,54438657,671,89,495,26.5,73.8,0.98
CpG: 78,chr11,54522424,54523171,747,78,470,20.9,62.9,1.06
CpG: 96,chr11,54787032,54787948,916,96,643,21,70.2,0.85
CpG: 28,chr11,54860578,54860923,345,28,203,16.2,58.8,0.94
CpG: 98,chr11,54866335,54866984,649,98,478,30.2,73.7,1.12
CpG: 21,chr11,54902772,54903033,261,21,171,16.1,65.5,0.75
CpG: 56,chr11,54955743,54956304,561,56,373,20,66.5,0.9
CpG: 27,chr11,55033250,55033507,257,27,181,21,70.4,0.85
CpG: 28,chr11,55098016,55098287,271,28,183,20.7,67.5,0.91
CpG: 22,chr11,55204242,55204518,276,22,160,15.9,58,1.01
CpG: 35,chr11,55460934,55461289,355,35,239,19.7,67.3,0.87
CpG: 74,chr11,55469637,55470162,525,74,389,28.2,74.1,1.03
CpG: 24,chr11,56459335,56459598,263,24,170,18.3,64.6,0.88
CpG: 64,chr11,57518235,57518873,638,64,433,20.1,67.9,0.87
CpG: 17,chr11,57559258,57559478,220,17,134,15.5,60.9,0.91
CpG: 74,chr11,57644953,57645735,782,74,507,18.9,64.8,0.92
CpG: 88,chr11,57801485,57802434,949,88,520,18.5,54.8,1.25
CpG: 59,chr11,57827496,57828164,668,59,429,17.7,64.2,0.86
CpG: 28,chr11,57829424,57829675,251,28,173,22.3,68.9,0.95
CpG: 25,chr11,57831407,57831734,327,25,215,15.3,65.7,0.71
CpG: 29,chr11,57836965,57837255,290,29,170,20,58.6,1.18
CpG: 21,chr11,58008615,58008827,212,21,152,19.8,71.7,0.78
CpG: 133,chr11,58009211,58010092,881,133,673,30.2,76.4,1.05
CpG: 33,chr11,58097728,58098142,414,33,277,15.9,66.9,0.71
CpG: 79,chr11,58103779,58104705,926,79,595,17.1,64.3,0.84
CpG: 64,chr11,58168157,58168612,455,64,331,28.1,72.7,1.06
CpG: 15,chr11,58171829,58172043,214,15,128,14,59.8,0.79
CpG: 22,chr11,58239459,58239764,305,22,191,14.4,62.6,0.76
CpG: 20,chr11,58302795,58303044,249,20,151,16.1,60.6,0.9
CpG: 62,chr11,58307031,58307679,648,62,440,19.1,67.9,0.83
CpG: 51,chr11,58322902,58323440,538,51,358,19,66.5,0.86
CpG: 57,chr11,58330129,58330888,759,57,397,15,52.3,1.11
CpG: 26,chr11,58640474,58640762,288,26,200,18.1,69.4,0.75
CpG: 19,chr11,58847137,58847375,238,19,147,16,61.8,0.84
CpG: 22,chr11,58867173,58867417,244,22,161,18,66,0.83
CpG: 25,chr11,58904039,58904304,265,25,181,18.9,68.3,0.84
CpG: 49,chr11,58938387,58938749,362,49,257,27.1,71,1.07
CpG: 30,chr11,58949026,58949335,309,30,196,19.4,63.4,0.97
CpG: 85,chr11,58953894,58955059,1165,85,649,14.6,55.7,0.94
CpG: 46,chr11,58961795,58962215,420,46,274,21.9,65.2,1.03
CpG: 31,chr11,58977273,58977598,325,31,206,19.1,63.4,0.95
CpG: 76,chr11,58977895,58978696,801,76,512,19,63.9,0.93
CpG: 16,chr11,59106300,59106530,230,16,158,13.9,68.7,0.63
CpG: 146,chr11,59134522,59136358,1836,146,1142,15.9,62.2,0.82
CpG: 48,chr11,59163310,59163770,460,48,297,20.9,64.6,1.01
CpG: 101,chr11,59176424,59177354,930,101,654,21.7,70.3,0.89
CpG: 55,chr11,59191614,59192134,520,55,350,21.2,67.3,0.98
CpG: 45,chr11,59202288,59202800,512,45,325,17.6,63.5,0.88
CpG: 62,chr11,59208189,59208715,526,62,349,23.6,66.3,1.1
CpG: 118,chr11,59227397,59228536,1139,118,769,20.7,67.5,0.91
CpG: 30,chr11,59249720,59250030,310,30,189,19.4,61,1.04
CpG: 47,chr11,59264061,59264621,560,47,334,16.8,59.6,0.94
CpG: 133,chr11,59288913,59290817,1904,133,1154,14,60.6,0.76
CpG: 119,chr11,59306411,59307671,1260,119,726,18.9,57.6,1.15
CpG: 66,chr11,59449869,59450691,822,66,526,16.1,64,0.79
CpG: 24,chr11,59472154,59472406,252,24,165,19,65.5,0.89
CpG: 94,chr11,59662147,59663016,869,94,540,21.6,62.1,1.12
CpG: 51,chr11,59787190,59787738,548,51,383,18.6,69.9,0.76
CpG: 40,chr11,59809709,59810059,350,40,242,22.9,69.1,0.96
CpG: 54,chr11,59839162,59839858,696,54,463,15.5,66.5,0.71
CpG: 63,chr11,59847975,59848407,432,63,323,29.2,74.8,1.05
CpG: 29,chr11,59963850,59964242,392,29,231,14.8,58.9,0.86
CpG: 53,chr11,59964486,59965170,684,53,416,15.5,60.8,0.84
CpG: 35,chr11,60046140,60046531,391,35,251,17.9,64.2,0.9
CpG: 154,chr11,60104878,60106468,1590,154,1014,19.4,63.8,0.96
CpG: 39,chr11,60115124,60115553,429,39,282,18.2,65.7,0.85
CpG: 82,chr11,60139740,60140546,806,82,507,20.3,62.9,1.03
CpG: 17,chr11,60140708,60140913,205,17,126,16.6,61.5,0.92
CpG: 153,chr11,60175701,60177316,1615,153,1064,18.9,65.9,0.88
CpG: 51,chr11,60210359,60210771,412,51,287,24.8,69.7,1.04
CpG: 39,chr11,60220321,60220640,319,39,216,24.5,67.7,1.08
CpG: 27,chr11,60222754,60222963,209,27,150,25.8,71.8,1.02
CpG: 43,chr11,60352655,60353120,465,43,312,18.5,67.1,0.85
CpG: 111,chr11,60416740,60417985,1245,111,754,17.8,60.6,0.99
CpG: 35,chr11,60454468,60454895,427,35,249,16.4,58.3,0.98
CpG: 35,chr11,60476668,60477169,501,35,304,14,60.7,0.76
CpG: 200,chr11,60537128,60539182,2054,200,1278,19.5,62.2,1.01
CpG: 21,chr11,60575380,60575667,287,21,177,14.6,61.7,0.77
CpG: 22,chr11,60683995,60684282,287,22,178,15.3,62,0.8
CpG: 55,chr11,60699694,60700071,377,55,267,29.2,70.8,1.17
CpG: 47,chr11,60726841,60727264,423,47,292,22.2,69,0.93
CpG: 41,chr11,60728252,60728662,410,41,269,20,65.6,0.93
CpG: 70,chr11,60776788,60777767,979,70,573,14.3,58.5,0.84
CpG: 22,chr11,60811138,60811369,231,22,162,19,70.1,0.82
CpG: 115,chr11,60878256,60879169,913,115,649,25.2,71.1,1.01
CpG: 73,chr11,60913451,60913949,498,73,356,29.3,71.5,1.15
CpG: 76,chr11,60931508,60932362,854,76,562,17.8,65.8,0.82
CpG: 118,chr11,61022205,61023254,1049,118,740,22.5,70.5,0.91
CpG: 20,chr11,61069179,61069425,246,20,143,16.3,58.1,0.96
CpG: 39,chr11,61147233,61147649,416,39,280,18.8,67.3,0.83
CpG: 71,chr11,61174540,61175466,926,71,563,15.3,60.8,0.84
CpG: 50,chr11,61266868,61267493,625,50,401,16,64.2,0.78
CpG: 59,chr11,61342437,61342941,504,59,351,23.4,69.6,0.97
CpG: 30,chr11,61377876,61378155,279,30,205,21.5,73.5,0.81
CpG: 72,chr11,61407999,61408727,728,72,499,19.8,68.5,0.86
CpG: 75,chr11,61493529,61494492,963,75,596,15.6,61.9,0.82
CpG: 44,chr11,61504782,61505327,545,44,334,16.1,61.3,0.87
CpG: 91,chr11,61578944,61579804,860,91,595,21.2,69.2,0.88
CpG: 99,chr11,61683994,61685104,1110,99,706,17.8,63.6,0.88
CpG: 38,chr11,61761841,61762135,294,38,215,25.9,73.1,0.97
CpG: 154,chr11,61854074,61855390,1316,154,942,23.4,71.6,0.91
CpG: 62,chr11,61929786,61930447,661,62,418,18.8,63.2,0.96
CpG: 62,chr11,61956737,61957371,634,62,446,19.6,70.3,0.8
CpG: 52,chr11,62076923,62077355,432,52,304,24.1,70.4,0.99
CpG: 83,chr11,62248497,62249444,947,83,638,17.5,67.4,0.77
CpG: 91,chr11,62281244,62281934,690,91,450,26.4,65.2,1.24
CpG: 106,chr11,62456785,62457797,1012,106,677,20.9,66.9,0.96
CpG: 31,chr11,62458276,62458613,337,31,219,18.4,65,0.87
CpG: 114,chr11,62538501,62539437,936,114,639,24.4,68.3,1.06
CpG: 88,chr11,62550912,62551819,907,88,533,19.4,58.8,1.14
CpG: 29,chr11,62560692,62561019,327,29,201,17.7,61.5,0.94
CpG: 55,chr11,62602622,62603171,549,55,351,20,63.9,0.98
CpG: 107,chr11,62648021,62648943,922,107,626,23.2,67.9,1.03
CpG: 27,chr11,62664811,62665169,358,27,196,15.1,54.7,1.01
CpG: 40,chr11,62731581,62731967,386,40,273,20.7,70.7,0.85
CpG: 29,chr11,62756846,62757139,293,29,207,19.8,70.6,0.79
CpG: 18,chr11,62789402,62789619,217,18,129,16.6,59.4,0.94
CpG: 36,chr11,62879330,62879688,358,36,247,20.1,69,0.85
CpG: 21,chr11,63131384,63131600,216,21,152,19.4,70.4,0.82
CpG: 71,chr11,63132414,63133262,848,71,586,16.7,69.1,0.7
CpG: 58,chr11,63889137,63889678,541,58,361,21.4,66.7,0.97
CpG: 26,chr11,63919238,63919458,220,26,154,23.6,70,0.97
CpG: 169,chr11,63920509,63922450,1941,169,1238,17.4,63.8,0.86
CpG: 28,chr11,63923390,63923670,280,28,180,20,64.3,0.97
CpG: 20,chr11,63924379,63924667,288,20,168,13.9,58.3,0.85
CpG: 31,chr11,63925176,63925579,403,31,271,15.4,67.2,0.68
CpG: 37,chr11,64079259,64079688,429,37,268,17.2,62.5,0.88
CpG: 135,chr11,64435072,64436635,1563,135,1063,17.3,68,0.75
CpG: 54,chr11,64520264,64520799,535,54,355,20.2,66.4,0.92
CpG: 59,chr11,64978825,64979382,557,59,374,21.2,67.1,0.95
CpG: 63,chr11,65162384,65162983,599,63,438,21,73.1,0.79
CpG: 31,chr11,65269835,65270263,428,31,273,14.5,63.8,0.71
CpG: 85,chr11,65787616,65788397,781,85,522,21.8,66.8,0.98
CpG: 41,chr11,65807181,65807498,317,41,223,25.9,70.3,1.09
CpG: 40,chr11,66168092,66168506,414,40,288,19.3,69.6,0.8
CpG: 180,chr11,66525225,66526886,1661,180,1015,21.7,61.1,1.16
CpG: 40,chr11,67052534,67052950,416,40,283,19.2,68,0.83
CpG: 22,chr11,67094542,67094772,230,22,153,19.1,66.5,0.88
CpG: 23,chr11,67298328,67298643,315,23,199,14.6,63.2,0.75
CpG: 109,chr11,67454957,67455972,1015,109,712,21.5,70.1,0.87
CpG: 23,chr11,67695538,67695753,215,23,128,21.4,59.5,1.21
CpG: 91,chr11,67921482,67922542,1060,91,644,17.2,60.8,0.93
CpG: 18,chr11,68212866,68213077,211,18,147,17.1,69.7,0.79
CpG: 197,chr11,68384928,68386726,1798,197,1212,21.9,67.4,0.97
CpG: 21,chr11,68387050,68387294,244,21,161,17.2,66,0.83
CpG: 101,chr11,68399534,68400614,1080,101,708,18.7,65.6,0.87
CpG: 20,chr11,68432018,68432252,234,20,168,17.1,71.8,0.66
CpG: 23,chr11,68556007,68556275,268,23,178,17.2,66.4,0.78
CpG: 74,chr11,68691299,68692234,935,74,622,15.8,66.5,0.72
CpG: 79,chr11,68852493,68853283,790,79,566,20,71.6,0.78
CpG: 46,chr11,68901414,68901898,484,46,306,19,63.2,0.95
CpG: 41,chr11,68967717,68968283,566,41,353,14.5,62.4,0.76
CpG: 28,chr11,69008297,69008533,236,28,150,23.7,63.6,1.18
CpG: 37,chr11,69039956,69040362,406,37,249,18.2,61.3,0.98
CpG: 40,chr11,69045640,69046110,470,40,302,17,64.3,0.82
CpG: 156,chr11,69059293,69060850,1557,156,1045,20,67.1,0.89
CpG: 36,chr11,69070706,69071062,356,36,228,20.2,64,0.99
CpG: 70,chr11,69088413,69089149,736,70,460,19,62.5,0.98
CpG: 16,chr11,69095156,69095360,204,16,126,15.7,61.8,0.9
CpG: 28,chr11,69117977,69118214,237,28,176,23.6,74.3,0.9
CpG: 95,chr11,69122148,69123102,954,95,687,19.9,72,0.77
CpG: 25,chr11,69134239,69134576,337,25,203,14.8,60.2,0.83
CpG: 73,chr11,69235602,69236622,1020,73,670,14.3,65.7,0.66
CpG: 36,chr11,69323596,69324008,412,36,257,17.5,62.4,0.92
CpG: 48,chr11,69326279,69326842,563,48,370,17.1,65.7,0.82
CpG: 20,chr11,69332081,69332319,238,20,144,16.8,60.5,0.92
CpG: 93,chr11,69340313,69341045,732,93,518,25.4,70.8,1.01
CpG: 23,chr11,69346555,69346800,245,23,172,18.8,70.2,0.76
CpG: 83,chr11,69368462,69369239,777,83,521,21.4,67.1,0.96
CpG: 70,chr11,69395199,69396220,1021,70,572,13.7,56,0.89
CpG: 38,chr11,69399725,69400065,340,38,248,22.4,72.9,0.84
CpG: 129,chr11,69409903,69411877,1974,129,1190,13.1,60.3,0.73
CpG: 24,chr11,69417984,69418322,338,24,208,14.2,61.5,0.75
CpG: 37,chr11,69546513,69546913,400,37,270,18.5,67.5,0.82
CpG: 41,chr11,69560008,69560394,386,41,279,21.2,72.3,0.82
CpG: 29,chr11,69579019,69579349,330,29,202,17.6,61.2,0.94
CpG: 26,chr11,69581407,69581695,288,26,171,18.1,59.4,1.02
CpG: 78,chr11,69604946,69605847,901,78,560,17.3,62.2,0.9
CpG: 67,chr11,69632775,69633566,791,67,455,16.9,57.5,1.03
CpG: 25,chr11,69655467,69655754,287,25,179,17.4,62.4,0.9
CpG: 29,chr11,69662547,69662797,250,29,169,23.2,67.6,1.05
CpG: 131,chr11,69671234,69672624,1390,131,909,18.8,65.4,0.9
CpG: 67,chr11,69681401,69682147,746,67,423,18,56.7,1.12
CpG: 87,chr11,69758113,69759319,1206,87,671,14.4,55.6,0.93
CpG: 41,chr11,69766014,69766578,564,41,365,14.5,64.7,0.71
CpG: 44,chr11,69795499,69796039,540,44,353,16.3,65.4,0.77
CpG: 58,chr11,69800877,69801634,757,58,498,15.3,65.8,0.71
CpG: 71,chr11,69803625,69804428,803,71,533,17.7,66.4,0.8
CpG: 37,chr11,69834023,69834340,317,37,228,23.3,71.9,0.91
CpG: 68,chr11,69837088,69837859,771,68,547,17.6,70.9,0.71
CpG: 34,chr11,69846305,69846671,366,34,263,18.6,71.9,0.72
CpG: 36,chr11,69881010,69881431,421,36,281,17.1,66.7,0.77
CpG: 89,chr11,69901313,69902309,996,89,546,17.9,54.8,1.19
CpG: 70,chr11,69913830,69914564,734,70,492,19.1,67,0.85
CpG: 127,chr11,69920525,69921795,1270,127,837,20,65.9,0.99
CpG: 101,chr11,69935339,69936437,1098,101,682,18.4,62.1,0.98
CpG: 23,chr11,69947925,69948236,311,23,185,14.8,59.5,0.84
CpG: 107,chr11,69965385,69966864,1479,107,927,14.5,62.7,0.74
CpG: 32,chr11,69981202,69981639,437,32,243,14.6,55.6,0.96
CpG: 37,chr11,69991472,69991848,376,37,240,19.7,63.8,0.97
CpG: 154,chr11,69995572,69997527,1955,154,1298,15.8,66.4,0.81
CpG: 59,chr11,70000405,70000989,584,59,379,20.2,64.9,0.99
CpG: 20,chr11,70021527,70021792,265,20,174,15.1,65.7,0.84
CpG: 21,chr11,70026854,70027135,281,21,195,14.9,69.4,0.64
CpG: 73,chr11,70213813,70214761,948,73,645,15.4,68,0.67
CpG: 21,chr11,70220439,70220681,242,21,156,17.4,64.5,0.87
CpG: 30,chr11,70226432,70226878,446,30,254,13.5,57,0.84
CpG: 35,chr11,70228975,70229457,482,35,271,14.5,56.2,0.92
CpG: 15,chr11,70229717,70229932,215,15,135,14,62.8,0.73
CpG: 28,chr11,70230341,70230660,319,28,204,17.6,63.9,0.86
CpG: 85,chr11,70237525,70238413,888,85,599,19.1,67.5,0.84
CpG: 16,chr11,70239632,70239850,218,16,141,14.7,64.7,0.72
CpG: 17,chr11,70255144,70255347,203,17,132,16.7,65,0.8
CpG: 60,chr11,70409591,70410278,687,60,459,17.5,66.8,0.79
CpG: 58,chr11,70432434,70432891,457,58,342,25.4,74.8,0.99
CpG: 38,chr11,70451835,70452269,434,38,278,17.5,64.1,0.86
CpG: 25,chr11,70459543,70459769,226,25,160,22.1,70.8,0.88
CpG: 20,chr11,70465891,70466104,213,20,144,18.8,67.6,0.86
CpG: 48,chr11,70520033,70520530,497,48,334,19.3,67.2,0.86
CpG: 46,chr11,70540111,70540507,396,46,297,23.2,75,0.83
CpG: 72,chr11,70562702,70563196,494,72,383,29.1,77.5,0.97
CpG: 28,chr11,70615352,70615727,375,28,226,14.9,60.3,0.82
CpG: 50,chr11,70646812,70647305,493,50,312,20.3,63.3,1.02
CpG: 196,chr11,70653725,70656236,2511,196,1539,15.6,61.3,0.83
CpG: 56,chr11,70669158,70669846,688,56,423,16.3,61.5,0.87
CpG: 55,chr11,70687654,70688177,523,55,373,21,71.3,0.85
CpG: 76,chr11,70699967,70700890,923,76,522,16.5,56.6,1.03
CpG: 67,chr11,70764079,70764602,523,67,374,25.6,71.5,1.03
CpG: 47,chr11,70844721,70845054,333,47,255,28.2,76.6,0.97
CpG: 41,chr11,70969564,70970021,457,41,289,17.9,63.2,0.9
CpG: 59,chr11,70982639,70983116,477,59,347,24.7,72.7,0.95
CpG: 67,chr11,71003871,71004619,748,67,482,17.9,64.4,0.87
CpG: 81,chr11,71019066,71019976,910,81,578,17.8,63.5,0.88
CpG: 23,chr11,71033181,71033484,303,23,194,15.2,64,0.74
CpG: 106,chr11,71750622,71751672,1050,106,722,20.2,68.8,0.86
CpG: 19,chr11,72042198,72042405,207,19,131,18.4,63.3,0.96
CpG: 34,chr11,72051015,72051352,337,34,231,20.2,68.5,0.86
CpG: 59,chr11,72135300,72135760,460,59,347,25.7,75.4,0.9
CpG: 65,chr11,72206712,72207669,957,65,582,13.6,60.8,0.75
CpG: 67,chr11,72214904,72215645,741,67,466,18.1,62.9,0.92
CpG: 78,chr11,72266199,72267320,1121,78,682,13.9,60.8,0.75
CpG: 28,chr11,72314388,72314632,244,28,182,23,74.6,0.83
CpG: 24,chr11,72361870,72362178,308,24,173,15.6,56.2,1
CpG: 85,chr11,72411131,72411894,763,85,559,22.3,73.3,0.83
CpG: 39,chr11,72441058,72441539,481,39,286,16.2,59.5,0.92
CpG: 107,chr11,72488845,72490209,1364,107,843,15.7,61.8,0.82
CpG: 177,chr11,72607025,72608501,1476,177,1082,24,73.3,0.91
CpG: 46,chr11,72689802,72690332,530,46,331,17.4,62.5,0.89
CpG: 125,chr11,72795423,72796848,1425,125,872,17.5,61.2,0.94
CpG: 56,chr11,72961075,72961596,521,56,381,21.5,73.1,0.81
CpG: 89,chr11,73018706,73019727,1021,89,676,17.4,66.2,0.81
CpG: 79,chr11,73047667,73048396,729,79,503,21.7,69,0.94
CpG: 37,chr11,73160238,73160574,336,37,242,22,72,0.85
CpG: 103,chr11,73176552,73177718,1166,103,774,17.7,66.4,0.8
CpG: 35,chr11,73199334,73199761,427,35,278,16.4,65.1,0.77
CpG: 24,chr11,73329494,73329751,257,24,162,18.7,63,0.95
CpG: 85,chr11,74522360,74523429,1069,85,597,15.9,55.8,1.02
CpG: 76,chr11,74589731,74590417,686,76,469,22.2,68.4,0.98
CpG: 33,chr11,74610776,74611087,311,33,207,21.2,66.6,0.98
CpG: 63,chr11,74619243,74620034,791,63,468,15.9,59.2,0.91
CpG: 71,chr11,74637963,74638687,724,71,485,19.6,67,0.87
CpG: 100,chr11,74649241,74650013,772,100,555,25.9,71.9,1.01
CpG: 125,chr11,74723409,74724703,1294,125,819,19.3,63.3,0.97
CpG: 35,chr11,74770764,74771134,370,35,225,18.9,60.8,1.03
CpG: 177,chr11,74829899,74832413,2514,177,1526,14.1,60.7,0.77
CpG: 90,chr11,74837648,74838752,1104,90,718,16.3,65,0.78
CpG: 154,chr11,74896412,74898204,1792,154,1161,17.2,64.8,0.82
CpG: 92,chr11,74925445,74926404,959,92,594,19.2,61.9,1
CpG: 316,chr11,75165307,75169327,4020,316,2649,15.7,65.9,0.72
CpG: 31,chr11,75170259,75170615,356,31,244,17.4,68.5,0.75
CpG: 138,chr11,75172338,75173855,1517,138,1000,18.2,65.9,0.84
CpG: 26,chr11,75178612,75178864,252,26,175,20.6,69.4,0.86
CpG: 175,chr11,75193256,75195382,2126,175,1361,16.5,64,0.81
CpG: 20,chr11,75213819,75214066,247,20,166,16.2,67.2,0.73
CpG: 58,chr11,75348086,75348599,513,58,354,22.6,69,0.95
CpG: 31,chr11,75445298,75445783,485,31,302,12.8,62.3,0.66
CpG: 28,chr11,75454450,75454767,317,28,214,17.7,67.5,0.79
CpG: 56,chr11,75461507,75462316,809,56,528,13.8,65.3,0.7
CpG: 52,chr11,75486650,75487238,588,52,379,17.7,64.5,0.85
CpG: 54,chr11,75510203,75510808,605,54,421,17.9,69.6,0.74
CpG: 17,chr11,75515372,75515591,219,17,149,15.5,68,0.67
CpG: 92,chr11,75531101,75532171,1070,92,677,17.2,63.3,0.88
CpG: 73,chr11,75587972,75588609,637,73,467,22.9,73.3,0.92
CpG: 53,chr11,75630686,75631233,547,53,354,19.4,64.7,0.93
CpG: 49,chr11,75651485,75652026,541,49,368,18.1,68,0.79
CpG: 73,chr11,75655664,75656365,701,73,489,20.8,69.8,0.86
CpG: 71,chr11,75679121,75679708,587,71,433,24.2,73.8,0.89
CpG: 112,chr11,75732637,75733672,1035,112,710,21.6,68.6,0.95
CpG: 135,chr11,75794962,75796258,1296,135,792,20.8,61.1,1.12
CpG: 81,chr11,75966272,75967184,912,81,601,17.8,65.9,0.83
CpG: 29,chr11,75999940,76000210,270,29,175,21.5,64.8,1.05
CpG: 122,chr11,76027028,76028044,1016,122,763,24,75.1,0.86
CpG: 32,chr11,76179501,76179921,420,32,267,15.2,63.6,0.76
CpG: 65,chr11,76201857,76202461,604,65,393,21.5,65.1,1.02
CpG: 52,chr11,76217134,76217718,584,52,380,17.8,65.1,0.85
CpG: 60,chr11,76243391,76243955,564,60,376,21.3,66.7,0.96
CpG: 77,chr11,76398442,76399292,850,77,545,18.1,64.1,0.88
CpG: 20,chr11,76407105,76407373,268,20,168,14.9,62.7,0.76
CpG: 19,chr11,76436955,76437213,258,19,168,14.7,65.1,0.69
CpG: 70,chr11,76494492,76495221,729,70,512,19.2,70.2,0.78
CpG: 47,chr11,76571045,76571566,521,47,343,18,65.8,0.84
CpG: 29,chr11,76601278,76601611,333,29,209,17.4,62.8,0.89
CpG: 151,chr11,76622237,76623850,1613,151,1057,18.7,65.5,0.88
CpG: 28,chr11,76666332,76666609,277,28,179,20.2,64.6,0.97
CpG: 54,chr11,76672704,76673210,506,54,338,21.3,66.8,0.96
CpG: 85,chr11,76846181,76847047,866,85,501,19.6,57.9,1.18
CpG: 51,chr11,76945520,76946099,579,51,392,17.6,67.7,0.78
CpG: 21,chr11,76997416,76997717,301,21,196,14,65.1,0.67
CpG: 42,chr11,76998402,76998840,438,42,265,19.2,60.5,1.06
CpG: 49,chr11,77078209,77078687,478,49,303,20.5,63.4,1.02
CpG: 71,chr11,77216004,77216692,688,71,473,20.6,68.8,0.89
CpG: 56,chr11,77348100,77348664,564,56,378,19.9,67,0.89
CpG: 64,chr11,77462258,77462799,541,64,381,23.7,70.4,0.96
CpG: 23,chr11,77467158,77467375,217,23,156,21.2,71.9,0.83
CpG: 18,chr11,77467785,77468042,257,18,168,14,65.4,0.66
CpG: 23,chr11,77471490,77471726,236,23,161,19.5,68.2,0.85
CpG: 67,chr11,77489423,77490134,711,67,403,18.8,56.7,1.17
CpG: 17,chr11,77491710,77491914,204,17,126,16.7,61.8,0.88
CpG: 27,chr11,77493028,77493336,308,27,185,17.5,60.1,0.97
CpG: 40,chr11,77493562,77493993,431,40,249,18.6,57.8,1.15
CpG: 59,chr11,77512827,77513621,794,59,446,14.9,56.2,0.95
CpG: 102,chr11,77514905,77515988,1083,102,745,18.8,68.8,0.8
CpG: 82,chr11,77607212,77608155,943,82,598,17.4,63.4,0.87
CpG: 91,chr11,77686950,77687833,883,91,581,20.6,65.8,0.96
CpG: 64,chr11,77763052,77763636,584,64,413,21.9,70.7,0.88
CpG: 19,chr11,77766609,77766836,227,19,139,16.7,61.2,0.9
CpG: 78,chr11,77930886,77931638,752,78,499,20.7,66.4,0.96
CpG: 101,chr11,77982422,77983362,940,101,682,21.5,72.6,0.82
CpG: 32,chr11,77983936,77984392,456,32,287,14,62.9,0.71
CpG: 83,chr11,78032008,78032768,760,83,508,21.8,66.8,0.98
CpG: 25,chr11,78037972,78038225,253,25,188,19.8,74.3,0.72
CpG: 30,chr11,78080086,78080429,343,30,216,17.5,63,0.88
CpG: 87,chr11,78164980,78165865,885,87,611,19.7,69,0.83
CpG: 50,chr11,78176583,78177296,713,50,380,14,53.3,0.99
CpG: 80,chr11,78178213,78179010,797,80,523,20.1,65.6,0.94
CpG: 21,chr11,78183303,78183539,236,21,151,17.8,64,0.91
CpG: 97,chr11,78188606,78189478,872,97,630,22.2,72.2,0.86
CpG: 38,chr11,78245771,78246299,528,38,306,14.4,58,0.87
CpG: 107,chr11,78261417,78262363,946,107,640,22.6,67.7,0.99
CpG: 33,chr11,78301498,78301859,361,33,211,18.3,58.4,1.1
CpG: 55,chr11,78328302,78328825,523,55,360,21,68.8,0.89
CpG: 49,chr11,78343381,78343848,467,49,308,21,66,1.01
CpG: 17,chr11,78397416,78397652,236,17,141,14.4,59.7,0.82
CpG: 38,chr11,78465658,78466108,450,38,298,16.9,66.2,0.77
CpG: 26,chr11,78487826,78488120,294,26,191,17.7,65,0.84
CpG: 62,chr11,78490642,78491181,539,62,366,23,67.9,1.01
CpG: 48,chr11,78497021,78497463,442,48,306,21.7,69.2,0.91
CpG: 62,chr11,78536006,78536748,742,62,465,16.7,62.7,0.85
CpG: 54,chr11,78550432,78551076,644,54,413,16.8,64.1,0.82
CpG: 41,chr11,78697066,78697572,506,41,309,16.2,61.1,0.87
CpG: 44,chr11,78751365,78751795,430,44,282,20.5,65.6,0.95
CpG: 47,chr11,78826446,78826855,409,47,299,23,73.1,0.89
CpG: 46,chr11,78924996,78925388,392,46,278,23.5,70.9,0.95
CpG: 25,chr11,79044836,79045184,348,25,232,14.4,66.7,0.7
CpG: 94,chr11,79145639,79146666,1027,94,642,18.3,62.5,0.94
CpG: 84,chr11,79254019,79254912,893,84,579,18.8,64.8,0.9
CpG: 81,chr11,79339192,79340229,1037,81,586,15.6,56.5,0.99
CpG: 72,chr11,79590882,79591553,671,72,410,21.5,61.1,1.15
CpG: 68,chr11,79660415,79661069,654,68,463,20.8,70.8,0.83
CpG: 57,chr11,79704083,79704602,519,57,359,22,69.2,0.93
CpG: 137,chr11,79710878,79712224,1346,137,899,20.4,66.8,0.93
CpG: 16,chr11,79732308,79732509,201,16,131,15.9,65.2,0.78
CpG: 39,chr11,79962139,79962682,543,39,309,14.4,56.9,0.91
CpG: 27,chr11,79974224,79974486,262,27,176,20.6,67.2,0.92
CpG: 111,chr11,79992475,79993854,1379,111,792,16.1,57.4,0.98
CpG: 41,chr11,80080766,80081053,287,41,217,28.6,75.6,1.07
CpG: 40,chr11,80089321,80089678,357,40,239,22.4,66.9,1.01
CpG: 60,chr11,80154031,80154685,654,60,456,18.3,69.7,0.76
CpG: 52,chr11,80209067,80209554,487,52,342,21.4,70.2,0.87
CpG: 103,chr11,80300847,80301762,915,103,665,22.5,72.7,0.85
CpG: 23,chr11,80377885,80378102,217,23,147,21.2,67.7,1.02
CpG: 21,chr11,80383121,80383356,235,21,149,17.9,63.4,0.89
CpG: 87,chr11,80428468,80429282,814,87,574,21.4,70.5,0.88
CpG: 153,chr11,80476520,80478056,1536,153,960,19.9,62.5,1.02
CpG: 73,chr11,80779562,80780232,670,73,446,21.8,66.6,0.98
CpG: 40,chr11,80810173,80810620,447,40,305,17.9,68.2,0.78
CpG: 182,chr11,81151715,81153722,2007,182,1339,18.1,66.7,0.82
CpG: 26,chr11,81968539,81968876,337,26,205,15.4,60.8,0.83
CpG: 239,chr11,82387062,82389805,2743,239,1794,17.4,65.4,0.82
CpG: 71,chr11,82434243,82435083,840,71,495,16.9,58.9,0.98
CpG: 66,chr11,82763856,82764791,935,66,564,14.1,60.3,0.78
CpG: 64,chr11,82781015,82781677,662,64,415,19.3,62.7,0.98
CpG: 59,chr11,82870804,82871362,558,59,410,21.1,73.5,0.8
CpG: 19,chr11,82890524,82890733,209,19,137,18.2,65.6,0.85
CpG: 56,chr11,82907990,82908509,519,56,351,21.6,67.6,0.96
CpG: 114,chr11,82931232,82932122,890,114,547,25.6,61.5,1.64
CpG: 43,chr11,83298725,83299157,432,43,280,19.9,64.8,0.95
CpG: 45,chr11,83302595,83303278,683,45,392,13.2,57.4,0.82
CpG: 63,chr11,83409394,83410102,708,63,463,17.8,65.4,0.85
CpG: 42,chr11,83418494,83418898,404,42,270,20.8,66.8,0.93
CpG: 46,chr11,83440353,83440750,397,46,275,23.2,69.3,0.98
CpG: 19,chr11,83442694,83442918,224,19,150,17,67,0.76
CpG: 32,chr11,83444820,83445050,230,32,157,27.8,68.3,1.19
CpG: 43,chr11,83462693,83463141,448,43,330,19.2,73.7,0.71
CpG: 103,chr11,83472621,83473763,1142,103,733,18,64.2,0.88
CpG: 38,chr11,83753679,83754018,339,38,233,22.4,68.7,0.95
CpG: 27,chr11,83851151,83851457,306,27,204,17.6,66.7,0.79
CpG: 24,chr11,83852036,83852340,304,24,189,15.8,62.2,0.82
CpG: 20,chr11,83853230,83853459,229,20,147,17.5,64.2,0.85
CpG: 46,chr11,83941927,83942374,447,46,267,20.6,59.7,1.15
CpG: 42,chr11,83964325,83964792,467,42,234,18,50.1,1.44
CpG: 63,chr11,84068107,84068552,445,63,336,28.3,75.5,1
CpG: 28,chr11,84129616,84129832,216,28,156,25.9,72.2,0.99
CpG: 110,chr11,84179323,84180418,1095,110,742,20.1,67.8,0.88
CpG: 55,chr11,84513298,84513787,489,55,312,22.5,63.8,1.11
CpG: 34,chr11,84520172,84520513,341,34,218,19.9,63.9,0.98
CpG: 21,chr11,84522678,84522898,220,21,145,19.1,65.9,0.88
CpG: 85,chr11,84524913,84525813,900,85,567,18.9,63,0.95
CpG: 20,chr11,84525952,84526193,241,20,150,16.6,62.2,0.86
CpG: 62,chr11,84642361,84642927,566,62,370,21.9,65.4,1.03
CpG: 72,chr11,84818709,84819636,927,72,612,15.5,66,0.72
CpG: 58,chr11,84828697,84829305,608,58,414,19.1,68.1,0.83
CpG: 118,chr11,84869568,84870994,1426,118,897,16.5,62.9,0.85
CpG: 87,chr11,84879780,84880511,731,87,538,23.8,73.6,0.89
CpG: 22,chr11,84916161,84916363,202,22,133,21.8,65.8,1.09
CpG: 43,chr11,84957719,84958248,529,43,343,16.3,64.8,0.78
CpG: 83,chr11,85139455,85140483,1028,83,611,16.1,59.4,0.95
CpG: 102,chr11,85234511,85235274,763,102,527,26.7,69.1,1.13
CpG: 18,chr11,85310616,85310817,201,18,113,17.9,56.2,1.16
CpG: 108,chr11,85311035,85312038,1003,108,637,21.5,63.5,1.07
CpG: 43,chr11,85352647,85353248,601,43,360,14.3,59.9,0.8
CpG: 27,chr11,85829287,85829622,335,27,235,16.1,70.1,0.66
CpG: 124,chr11,85832089,85833596,1507,124,925,16.5,61.4,0.88
CpG: 39,chr11,85836894,85837410,516,39,330,15.1,64,0.75
CpG: 69,chr11,85837772,85838448,676,69,491,20.4,72.6,0.78
CpG: 21,chr11,85840797,85841085,288,21,201,14.6,69.8,0.6
CpG: 40,chr11,85841844,85842181,337,40,237,23.7,70.3,0.96
CpG: 44,chr11,85844092,85844605,513,44,329,17.2,64.1,0.84
CpG: 25,chr11,85886267,85886603,336,25,241,14.9,71.7,0.6
CpG: 71,chr11,86200936,86201792,856,71,504,16.6,58.9,0.96
CpG: 22,chr11,86257125,86257397,272,22,166,16.2,61,0.87
CpG: 23,chr11,86257542,86257773,231,23,136,19.9,58.9,1.18
CpG: 89,chr11,86357279,86358424,1145,89,640,15.5,55.9,1
CpG: 81,chr11,86484203,86485180,977,81,595,16.6,60.9,0.9
CpG: 74,chr11,86544200,86544986,786,74,538,18.8,68.4,0.84
CpG: 48,chr11,86683637,86684148,511,48,317,18.8,62,0.98
CpG: 75,chr11,86757414,86758221,807,75,533,18.6,66,0.86
CpG: 55,chr11,86807302,86807795,493,55,329,22.3,66.7,1.01
CpG: 96,chr11,86993023,86993951,928,96,655,20.7,70.6,0.84
CpG: 35,chr11,87073962,87074244,282,35,196,24.8,69.5,1.03
CpG: 34,chr11,87086373,87086794,421,34,267,16.2,63.4,0.82
CpG: 16,chr11,87108724,87108930,206,16,114,15.5,55.3,1.06
CpG: 40,chr11,87109443,87109935,492,40,304,16.3,61.8,0.87
CpG: 99,chr11,87126795,87127706,911,99,600,21.7,65.9,1
CpG: 86,chr11,87358131,87359274,1143,86,617,15,54,1.03
CpG: 53,chr11,87404207,87404735,528,53,315,20.1,59.7,1.13
CpG: 53,chr11,87442786,87443229,443,53,288,23.9,65,1.2
CpG: 52,chr11,87448176,87448619,443,52,287,23.5,64.8,1.18
CpG: 47,chr11,87461893,87462278,385,47,252,24.4,65.5,1.23
CpG: 47,chr11,87470939,87471360,421,47,269,22.3,63.9,1.17
CpG: 29,chr11,87578373,87578695,322,29,230,18,71.4,0.71
CpG: 62,chr11,87591597,87592378,781,62,500,15.9,64,0.78
CpG: 36,chr11,87595487,87595850,363,36,272,19.8,74.9,0.71
CpG: 89,chr11,87616902,87617970,1068,89,657,16.7,61.5,0.88
CpG: 28,chr11,87639236,87639459,223,28,160,25.1,71.7,0.99
CpG: 24,chr11,87736695,87737001,306,24,166,15.7,54.2,1.07
CpG: 69,chr11,87737251,87737907,656,69,435,21,66.3,0.96
CpG: 59,chr11,87764081,87764839,758,59,499,15.6,65.8,0.72
CpG: 24,chr11,87817142,87817416,274,24,167,17.5,60.9,0.96
CpG: 28,chr11,87853132,87853340,208,28,144,26.9,69.2,1.12
CpG: 19,chr11,87871383,87871613,230,19,140,16.5,60.9,0.92
CpG: 97,chr11,87986772,87987654,882,97,606,22,68.7,0.95
CpG: 156,chr11,88047189,88048653,1464,156,924,21.3,63.1,1.07
CpG: 121,chr11,88067845,88069300,1455,121,829,16.6,57,1.03
CpG: 101,chr11,88099079,88099957,878,101,579,23,65.9,1.06
CpG: 32,chr11,88169646,88170072,426,32,279,15,65.5,0.7
CpG: 32,chr11,88193457,88193898,441,32,284,14.5,64.4,0.72
CpG: 40,chr11,88204160,88204603,443,40,288,18.1,65,0.86
CpG: 20,chr11,88294375,88294588,213,20,143,18.8,67.1,0.84
CpG: 138,chr11,88717840,88719127,1287,138,871,21.4,67.7,0.94
CpG: 98,chr11,88863935,88864835,900,98,623,21.8,69.2,0.92
CpG: 28,chr11,88955227,88955513,286,28,178,19.6,62.2,1.01
CpG: 45,chr11,88973826,88974336,510,45,306,17.6,60,0.98
CpG: 65,chr11,88999234,89000002,768,65,493,16.9,64.2,0.83
CpG: 92,chr11,89060000,89060939,939,92,635,19.6,67.6,0.86
CpG: 36,chr11,89298363,89298738,375,36,238,19.2,63.5,0.96
CpG: 18,chr11,89299253,89299456,203,18,136,17.7,67,0.86
CpG: 134,chr11,89301374,89302842,1468,134,964,18.3,65.7,0.85
CpG: 22,chr11,90002757,90003019,262,22,177,16.8,67.6,0.76
CpG: 55,chr11,90249224,90249822,598,55,365,18.4,61,0.99
CpG: 21,chr11,90389629,90389855,226,21,143,18.6,63.3,0.96
CpG: 40,chr11,90390735,90391186,451,40,263,17.7,58.3,1.06
CpG: 34,chr11,90417919,90418286,367,34,220,18.5,59.9,1.05
CpG: 88,chr11,90637769,90638673,904,88,610,19.5,67.5,0.87
CpG: 39,chr11,90687348,90687819,471,39,319,16.6,67.7,0.73
CpG: 129,chr11,93098299,93100196,1897,129,1091,13.6,57.5,0.83
CpG: 176,chr11,93884846,93886590,1744,176,1141,20.2,65.4,0.94
CpG: 59,chr11,93955400,93956062,662,59,437,17.8,66,0.82
CpG: 44,chr11,93996308,93996727,419,44,298,21,71.1,0.85
CpG: 47,chr11,94148914,94149388,474,47,304,19.8,64.1,0.97
CpG: 172,chr11,94210243,94212093,1850,172,1236,18.6,66.8,0.84
CpG: 80,chr11,94321399,94322144,745,80,524,21.5,70.3,0.91
CpG: 28,chr11,94328295,94328652,357,28,243,15.7,68.1,0.68
CpG: 105,chr11,94473317,94474632,1315,105,882,16,67.1,0.71
CpG: 25,chr11,94485985,94486306,321,25,200,15.6,62.3,0.8
CpG: 44,chr11,94491101,94491484,383,44,276,23,72.1,0.9
CpG: 18,chr11,94499808,94500041,233,18,155,15.5,66.5,0.7
CpG: 33,chr11,94521255,94521557,302,33,200,21.9,66.2,1.02
CpG: 43,chr11,94548858,94549288,430,43,290,20,67.4,0.88
CpG: 29,chr11,94601622,94601864,242,29,161,24,66.5,1.1
CpG: 46,chr11,94629603,94630167,564,46,318,16.3,56.4,1.03
CpG: 22,chr11,94653727,94654003,276,22,169,15.9,61.2,0.9
CpG: 56,chr11,94676970,94677581,611,56,368,18.3,60.2,1.02
CpG: 17,chr11,94979093,94979302,209,17,135,16.3,64.6,0.79
CpG: 204,chr11,94990898,94992990,2092,204,1433,19.5,68.5,0.83
CpG: 66,chr11,95009815,95010566,751,66,437,17.6,58.2,1.1
CpG: 40,chr11,95019904,95020272,368,40,254,21.7,69,0.94
CpG: 44,chr11,95041096,95041507,411,44,277,21.4,67.4,0.95
CpG: 92,chr11,95076076,95077153,1077,92,665,17.1,61.7,0.9
CpG: 24,chr11,95118223,95118488,265,24,191,18.1,72.1,0.71
CpG: 141,chr11,95120006,95121863,1857,141,1090,15.2,58.7,0.89
CpG: 20,chr11,95143138,95143388,250,20,157,16,62.8,0.81
CpG: 95,chr11,95145051,95146306,1255,95,792,15.1,63.1,0.76
CpG: 40,chr11,95202090,95202479,389,40,249,20.6,64,1
CpG: 32,chr11,95223393,95223687,294,32,206,21.8,70.1,0.91
CpG: 96,chr11,95258592,95259657,1065,96,661,18,62.1,0.95
CpG: 62,chr11,95309551,95310258,707,62,441,17.5,62.4,0.9
CpG: 61,chr11,95336959,95337612,653,61,443,18.7,67.8,0.88
CpG: 51,chr11,95384422,95385054,632,51,366,16.1,57.9,0.98
CpG: 31,chr11,95413810,95414131,321,31,180,19.3,56.1,1.23
CpG: 135,chr11,95513408,95514993,1585,135,1070,17,67.5,0.75
CpG: 33,chr11,95577976,95578405,429,33,265,15.4,61.8,0.81
CpG: 23,chr11,95585240,95585487,247,23,157,18.6,63.6,0.94
CpG: 36,chr11,95586294,95586774,480,36,300,15,62.5,0.77
CpG: 21,chr11,95645547,95645803,256,21,184,16.4,71.9,0.66
CpG: 86,chr11,95712598,95713525,927,86,525,18.6,56.6,1.18
CpG: 39,chr11,95796604,95796890,286,39,216,27.3,75.5,0.96
CpG: 78,chr11,95823997,95824710,713,78,506,21.9,71,0.87
CpG: 83,chr11,95830487,95831358,871,83,544,19.1,62.5,0.98
CpG: 81,chr11,95858763,95859843,1080,81,607,15,56.2,0.95
CpG: 47,chr11,95914481,95915069,588,47,380,16,64.6,0.78
CpG: 26,chr11,95991314,95991594,280,26,209,18.6,74.6,0.67
CpG: 265,chr11,96004570,96007818,3248,265,2024,16.3,62.3,0.85
CpG: 23,chr11,96034863,96035086,223,23,131,20.6,58.7,1.25
CpG: 77,chr11,96064603,96065527,924,77,554,16.7,60,0.94
CpG: 21,chr11,96075794,96076044,250,21,138,16.8,55.2,1.11
CpG: 25,chr11,96124323,96124578,255,25,177,19.6,69.4,0.81
CpG: 15,chr11,96175527,96175728,201,15,104,14.9,51.7,1.18
CpG: 35,chr11,96203263,96203720,457,35,271,15.3,59.3,0.87
CpG: 47,chr11,96251535,96252033,498,47,318,18.9,63.9,0.93
CpG: 17,chr11,96269588,96269814,226,17,118,15,52.2,1.14
CpG: 136,chr11,96271055,96272795,1740,136,1091,15.6,62.7,0.8
CpG: 44,chr11,96282928,96283401,473,44,304,18.6,64.3,0.92
CpG: 44,chr11,96283989,96284651,662,44,386,13.3,58.3,0.79
CpG: 66,chr11,96286677,96287449,772,66,479,17.1,62,0.9
CpG: 59,chr11,96299099,96299616,517,59,346,22.8,66.9,1.03
CpG: 71,chr11,96303201,96304121,920,71,541,15.4,58.8,0.94
CpG: 26,chr11,96304905,96305224,319,26,191,16.3,59.9,0.93
CpG: 35,chr11,96314539,96314989,450,35,251,15.6,55.8,1
CpG: 45,chr11,96318807,96319262,455,45,299,19.8,65.7,0.94
CpG: 32,chr11,96320042,96320393,351,32,235,18.2,67,0.81
CpG: 57,chr11,96332715,96333268,553,57,396,20.6,71.6,0.81
CpG: 28,chr11,96340802,96341102,300,28,203,18.7,67.7,0.82
CpG: 33,chr11,96341937,96342320,383,33,242,17.2,63.2,0.89
CpG: 26,chr11,96344089,96344429,340,26,228,15.3,67.1,0.68
CpG: 55,chr11,96345653,96346273,620,55,411,17.7,66.3,0.82
CpG: 61,chr11,96352944,96353489,545,61,370,22.4,67.9,0.97
CpG: 26,chr11,96365874,96366265,391,26,252,13.3,64.5,0.64
CpG: 20,chr11,96366801,96367021,220,20,134,18.2,60.9,0.98
CpG: 41,chr11,96777424,96777830,406,41,274,20.2,67.5,0.9
CpG: 83,chr11,96789045,96789802,757,83,475,21.9,62.7,1.16
CpG: 86,chr11,96829375,96830471,1096,86,700,15.7,63.9,0.79
CpG: 42,chr11,96849886,96850425,539,42,360,15.6,66.8,0.73
CpG: 55,chr11,96916116,96916803,687,55,435,16,63.3,0.8
CpG: 21,chr11,96943705,96943914,209,21,138,20.1,66,0.93
CpG: 62,chr11,96977227,96977733,506,62,389,24.5,76.9,0.86
CpG: 30,chr11,96997301,96997682,381,30,265,15.7,69.6,0.66
CpG: 55,chr11,97018645,97019200,555,55,375,19.8,67.6,0.88
CpG: 88,chr11,97021450,97022581,1131,88,746,15.6,66,0.72
CpG: 33,chr11,97041351,97041751,400,33,242,16.5,60.5,0.9
CpG: 88,chr11,97114566,97115340,774,88,543,22.7,70.2,0.92
CpG: 39,chr11,97138644,97139034,390,39,277,20,71,0.8
CpG: 111,chr11,97150598,97151802,1204,111,722,18.4,60,1.05
CpG: 144,chr11,97187128,97188611,1483,144,865,19.4,58.3,1.15
CpG: 62,chr11,97279782,97280525,743,62,419,16.7,56.4,1.05
CpG: 40,chr11,97315596,97315893,297,40,205,26.9,69,1.16
CpG: 18,chr11,97338899,97339134,235,18,150,15.3,63.8,0.79
CpG: 126,chr11,97362007,97363418,1411,126,895,17.9,63.4,0.89
CpG: 66,chr11,97415371,97416107,736,66,523,17.9,71.1,0.71
CpG: 64,chr11,97440045,97440716,671,64,421,19.1,62.7,0.99
CpG: 21,chr11,97463387,97463606,219,21,117,19.2,53.4,1.35
CpG: 103,chr11,97500137,97500979,842,103,573,24.5,68.1,1.06
CpG: 29,chr11,97531828,97532060,232,29,162,25,69.8,1.03
CpG: 90,chr11,97534456,97535279,823,90,555,21.9,67.4,0.97
CpG: 32,chr11,97536298,97536690,392,32,245,16.3,62.5,0.84
CpG: 88,chr11,97546385,97547238,853,88,553,20.6,64.8,0.99
CpG: 22,chr11,97551754,97551983,229,22,163,19.2,71.2,0.77
CpG: 45,chr11,97575034,97575455,421,45,218,21.4,51.8,1.61
CpG: 190,chr11,97628255,97629965,1710,190,1211,22.2,70.8,0.89
CpG: 65,chr11,97660038,97660553,515,65,349,25.2,67.8,1.11
CpG: 35,chr11,97685701,97686005,304,35,220,23,72.4,0.88
CpG: 152,chr11,97698897,97700716,1819,152,1106,16.7,60.8,0.9
CpG: 105,chr11,97744163,97745386,1223,105,777,17.2,63.5,0.85
CpG: 74,chr11,97781776,97782601,825,74,520,17.9,63,0.91
CpG: 78,chr11,97799345,97800236,891,78,615,17.5,69,0.74
CpG: 56,chr11,97883595,97884422,827,56,465,13.5,56.2,0.88
CpG: 54,chr11,97986198,97986573,375,54,289,28.8,77.1,0.98
CpG: 66,chr11,98021944,98022805,861,66,522,15.3,60.6,0.86
CpG: 89,chr11,98026476,98027413,937,89,586,19,62.5,0.97
CpG: 113,chr11,98052232,98053422,1190,113,816,19,68.6,0.81
CpG: 151,chr11,98149083,98150647,1564,151,1070,19.3,68.4,0.83
CpG: 50,chr11,98192824,98193404,580,50,382,17.2,65.9,0.8
CpG: 98,chr11,98202611,98203726,1115,98,727,17.6,65.2,0.84
CpG: 45,chr11,98294557,98294981,424,45,281,21.2,66.3,0.97
CpG: 15,chr11,98314046,98314251,205,15,111,14.6,54.1,1.02
CpG: 177,chr11,98327044,98328778,1734,177,1176,20.4,67.8,0.89
CpG: 21,chr11,98329544,98329756,212,21,145,19.8,68.4,0.86
CpG: 29,chr11,98334399,98334742,343,29,242,16.9,70.6,0.68
CpG: 48,chr11,98338527,98338926,399,48,291,24.1,72.9,0.91
CpG: 67,chr11,98348383,98349199,816,67,558,16.4,68.4,0.71
CpG: 51,chr11,98358248,98358736,488,51,344,20.9,70.5,0.86
CpG: 16,chr11,98384216,98384438,222,16,153,14.4,68.9,0.61
CpG: 19,chr11,98386680,98386882,202,19,128,18.8,63.4,0.94
CpG: 34,chr11,98400166,98400505,339,34,219,20.1,64.6,0.96
CpG: 83,chr11,98412307,98413135,828,83,589,20,71.1,0.8
CpG: 34,chr11,98438655,98439061,406,34,269,16.7,66.3,0.76
CpG: 66,chr11,98457502,98458295,793,66,503,16.6,63.4,0.83
CpG: 62,chr11,98545679,98546118,439,62,315,28.2,71.8,1.1
CpG: 42,chr11,98550936,98551392,456,42,312,18.4,68.4,0.79
CpG: 38,chr11,98587032,98587434,402,38,272,18.9,67.7,0.84
CpG: 45,chr11,98682576,98682998,422,45,296,21.3,70.1,0.88
CpG: 65,chr11,98741717,98742336,619,65,431,21,69.6,0.87
CpG: 27,chr11,98768144,98768493,349,27,221,15.5,63.3,0.78
CpG: 28,chr11,98773805,98774126,321,28,215,17.4,67,0.78
CpG: 143,chr11,98794754,98796475,1721,143,972,16.6,56.5,1.04
CpG: 56,chr11,98809562,98810137,575,56,340,19.5,59.1,1.13
CpG: 61,chr11,98836760,98837394,634,61,471,19.2,74.3,0.7
CpG: 48,chr11,98863489,98864070,581,48,355,16.5,61.1,0.92
CpG: 43,chr11,98907613,98908088,475,43,293,18.1,61.7,1.02
CpG: 25,chr11,98936171,98936439,268,25,180,18.7,67.2,0.9
CpG: 69,chr11,98937354,98938138,784,69,534,17.6,68.1,0.77
CpG: 36,chr11,98959604,98960112,508,36,323,14.2,63.6,0.71
CpG: 46,chr11,98960434,98961001,567,46,368,16.2,64.9,0.77
CpG: 110,chr11,98982168,98983029,861,110,606,25.6,70.4,1.03
CpG: 31,chr11,99023929,99024182,253,31,166,24.5,65.6,1.15
CpG: 77,chr11,99041011,99041815,804,77,577,19.2,71.8,0.75
CpG: 105,chr11,99230172,99231095,923,105,628,22.8,68,0.98
CpG: 31,chr11,99932028,99932303,275,31,195,22.5,70.9,0.91
CpG: 15,chr11,99932545,99932746,201,15,109,14.9,54.2,1.02
CpG: 38,chr11,100145310,100145807,497,38,316,15.3,63.6,0.77
CpG: 17,chr11,100265543,100265746,203,17,126,16.7,62.1,0.94
CpG: 90,chr11,100319667,100320531,864,90,595,20.8,68.9,0.88
CpG: 71,chr11,100355313,100356174,861,71,565,16.5,65.6,0.77
CpG: 18,chr11,100356431,100356663,232,18,136,15.5,58.6,0.93
CpG: 61,chr11,100397194,100397946,752,61,504,16.2,67,0.72
CpG: 92,chr11,100414049,100414856,807,92,572,22.8,70.9,0.91
CpG: 44,chr11,100440746,100441142,396,44,283,22.2,71.5,0.9
CpG: 90,chr11,100471920,100472886,966,90,580,18.6,60,1.04
CpG: 55,chr11,100527205,100527972,767,55,483,14.3,63,0.72
CpG: 30,chr11,100574880,100575100,220,30,169,27.3,76.8,0.93
CpG: 21,chr11,100576356,100576618,262,21,161,16,61.5,0.85
CpG: 65,chr11,100619084,100619840,756,65,505,17.2,66.8,0.77
CpG: 23,chr11,100622804,100623050,246,23,173,18.7,70.3,0.76
CpG: 56,chr11,100640049,100640608,559,56,369,20,66,0.92
CpG: 19,chr11,100708535,100708742,207,19,127,18.4,61.4,0.98
CpG: 31,chr11,100713863,100714278,415,31,262,14.9,63.1,0.75
CpG: 38,chr11,100738077,100738578,501,38,316,15.2,63.1,0.76
CpG: 55,chr11,100759516,100760117,601,55,401,18.3,66.7,0.83
CpG: 26,chr11,100761801,100762094,293,26,195,17.7,66.6,0.81
CpG: 101,chr11,100850085,100850960,875,101,570,23.1,65.1,1.13
CpG: 38,chr11,100860284,100860610,326,38,230,23.3,70.6,0.94
CpG: 28,chr11,100939185,100939423,238,28,176,23.5,73.9,0.87
CpG: 77,chr11,100958575,100959309,734,77,482,21,65.7,0.99
CpG: 115,chr11,100969157,100970672,1515,115,994,15.2,65.6,0.71
CpG: 19,chr11,101009431,101009638,207,19,113,18.4,54.6,1.32
CpG: 60,chr11,101069883,101070493,610,60,425,19.7,69.7,0.82
CpG: 27,chr11,101079716,101080050,334,27,218,16.2,65.3,0.76
CpG: 22,chr11,101082454,101082790,336,22,181,13.1,53.9,0.9
CpG: 42,chr11,101087188,101087620,432,42,291,19.4,67.4,0.88
CpG: 41,chr11,101095192,101095716,524,41,332,15.6,63.4,0.78
CpG: 74,chr11,101119528,101120199,671,74,456,22.1,68,0.96
CpG: 33,chr11,101155841,101156193,352,33,233,18.8,66.2,0.86
CpG: 60,chr11,101164012,101164528,516,60,380,23.3,73.6,0.86
CpG: 68,chr11,101170343,101171334,991,68,631,13.7,63.7,0.69
CpG: 58,chr11,101173668,101174298,630,58,416,18.4,66,0.85
CpG: 56,chr11,101225891,101226550,659,56,415,17,63,0.88
CpG: 49,chr11,101246227,101246682,455,49,320,21.5,70.3,0.87
CpG: 34,chr11,101253628,101254071,443,34,288,15.3,65,0.73
CpG: 36,chr11,101260496,101260867,371,36,267,19.4,72,0.75
CpG: 17,chr11,101263778,101263994,216,17,125,15.7,57.9,0.96
CpG: 26,chr11,101265148,101265442,294,26,193,17.7,65.6,0.85
CpG: 46,chr11,101301859,101302400,541,46,354,17,65.4,0.79
CpG: 34,chr11,101315820,101316232,412,34,259,16.5,62.9,0.84
CpG: 48,chr11,101417026,101417491,465,48,300,20.6,64.5,0.99
CpG: 77,chr11,101424972,101425717,745,77,488,20.7,65.5,0.99
CpG: 37,chr11,101442488,101442853,365,37,236,20.3,64.7,0.97
CpG: 78,chr11,101465636,101466362,726,78,490,21.5,67.5,0.94
CpG: 33,chr11,101467815,101468159,344,33,238,19.2,69.2,0.82
CpG: 21,chr11,101551776,101551977,201,21,120,20.9,59.7,1.18
CpG: 38,chr11,101641432,101641745,313,38,201,24.3,64.2,1.26
CpG: 38,chr11,101645932,101646246,314,38,201,24.2,64,1.26
CpG: 27,chr11,101657969,101658235,266,27,161,20.3,60.5,1.19
CpG: 38,chr11,101665482,101665851,369,38,243,20.6,65.9,0.99
CpG: 36,chr11,101732722,101733107,385,36,234,18.7,60.8,1.01
CpG: 66,chr11,101784509,101785248,739,66,473,17.9,64,0.87
CpG: 19,chr11,101937436,101937648,212,19,146,17.9,68.9,0.82
CpG: 55,chr11,101963804,101964286,482,55,300,22.8,62.2,1.18
CpG: 59,chr11,101984403,101984969,566,59,402,20.8,71,0.83
CpG: 50,chr11,102026466,102026950,484,50,353,20.7,72.9,0.78
CpG: 38,chr11,102087178,102087735,557,38,354,13.6,63.6,0.69
CpG: 32,chr11,102088448,102088829,381,32,224,16.8,58.8,0.98
CpG: 18,chr11,102107141,102107345,204,18,141,17.6,69.1,0.74
CpG: 50,chr11,102145529,102146014,485,50,336,20.6,69.3,0.86
CpG: 27,chr11,102156162,102156447,285,27,177,18.9,62.1,0.99
CpG: 48,chr11,102184903,102185342,439,48,291,21.9,66.3,1
CpG: 22,chr11,102224734,102225039,305,22,193,14.4,63.3,0.75
CpG: 72,chr11,102229651,102230283,632,72,421,22.8,66.6,1.03
CpG: 45,chr11,102248721,102249264,543,45,338,16.6,62.2,0.87
CpG: 23,chr11,102276504,102276728,224,23,157,20.5,70.1,0.84
CpG: 21,chr11,102284740,102284981,241,21,139,17.4,57.7,1.05
CpG: 135,chr11,102295921,102297391,1470,135,803,18.4,54.6,1.24
CpG: 37,chr11,102308956,102309471,515,37,323,14.4,62.7,0.73
CpG: 274,chr11,102316660,102319603,2943,274,1719,18.6,58.4,1.11
CpG: 27,chr11,102319886,102320237,351,27,203,15.4,57.8,0.93
CpG: 41,chr11,102393274,102393802,528,41,330,15.5,62.5,0.8
CpG: 37,chr11,102399569,102400020,451,37,300,16.4,66.5,0.76
CpG: 64,chr11,102407257,102407856,599,64,408,21.4,68.1,0.94
CpG: 19,chr11,102408346,102408573,227,19,139,16.7,61.2,0.92
CpG: 155,chr11,102437373,102438878,1505,155,996,20.6,66.2,0.94
CpG: 71,chr11,102447127,102447776,649,71,479,21.9,73.8,0.81
CpG: 19,chr11,102455819,102456072,253,19,171,15,67.6,0.66
CpG: 24,chr11,102467090,102467394,304,24,185,15.8,60.9,0.89
CpG: 76,chr11,102555764,102556459,695,76,479,21.9,68.9,0.93
CpG: 180,chr11,102604501,102606498,1997,180,1282,18,64.2,0.88
CpG: 119,chr11,102665168,102666458,1290,119,833,18.4,64.6,0.9
CpG: 40,chr11,102697575,102697952,377,40,248,21.2,65.8,0.98
CpG: 47,chr11,102761370,102761910,540,47,305,17.4,56.5,1.1
CpG: 63,chr11,102774033,102774852,819,63,518,15.4,63.2,0.77
CpG: 119,chr11,102818491,102819658,1167,119,686,20.4,58.8,1.19
CpG: 57,chr11,102880701,102881252,551,57,337,20.7,61.2,1.11
CpG: 34,chr11,102893198,102893569,371,34,232,18.3,62.5,0.94
CpG: 50,chr11,102924799,102925274,475,50,299,21.1,62.9,1.08
CpG: 100,chr11,102945902,102946867,965,100,657,20.7,68.1,0.89
CpG: 31,chr11,102948559,102948787,228,31,166,27.2,72.8,1.03
CpG: 32,chr11,102990044,102990356,312,32,204,20.5,65.4,0.97
CpG: 19,chr11,102994927,102995168,241,19,154,15.8,63.9,0.77
CpG: 53,chr11,103016861,103017242,381,53,286,27.8,75.1,0.99
CpG: 43,chr11,103080195,103080630,435,43,300,19.8,69,0.84
CpG: 51,chr11,103101303,103101796,493,51,338,20.7,68.6,0.89
CpG: 22,chr11,103116014,103116217,203,22,124,21.7,61.1,1.16
CpG: 18,chr11,103116397,103116657,260,18,161,13.8,61.9,0.73
CpG: 63,chr11,103117220,103117987,767,63,471,16.4,61.4,0.88
CpG: 66,chr11,103132301,103133111,810,66,514,16.3,63.5,0.82
CpG: 94,chr11,103170602,103171502,900,94,609,20.9,67.7,0.92
CpG: 38,chr11,103199382,103199794,412,38,294,18.4,71.4,0.73
CpG: 17,chr11,103218288,103218500,212,17,153,16,72.2,0.62
CpG: 73,chr11,103267034,103267850,816,73,484,17.9,59.3,1.02
CpG: 23,chr11,103312076,103312287,211,23,159,21.8,75.4,0.79
CpG: 38,chr11,103333799,103334313,514,38,326,14.8,63.4,0.74
CpG: 93,chr11,103360220,103360913,693,93,507,26.8,73.2,1.01
CpG: 25,chr11,103363137,103363411,274,25,187,18.2,68.2,0.8
CpG: 64,chr11,103412256,103413015,759,64,497,16.9,65.5,0.79
CpG: 85,chr11,103649513,103650338,825,85,560,20.6,67.9,0.9
CpG: 67,chr11,103697432,103698093,661,67,438,20.3,66.3,0.92
CpG: 62,chr11,103749374,103749942,568,62,396,21.8,69.7,0.91
CpG: 68,chr11,103773542,103774422,880,68,576,15.5,65.5,0.72
CpG: 24,chr11,103795475,103795789,314,24,213,15.3,67.8,0.68
CpG: 70,chr11,103809820,103810478,658,70,404,21.3,61.4,1.13
CpG: 25,chr11,103811332,103811622,290,25,184,17.2,63.4,0.86
CpG: 31,chr11,103812318,103812788,470,31,286,13.2,60.9,0.71
CpG: 67,chr11,103966474,103967112,638,67,414,21,64.9,1.01
CpG: 118,chr11,104132524,104133862,1338,118,832,17.6,62.2,0.92
CpG: 163,chr11,104231063,104232946,1883,163,1179,17.3,62.6,0.89
CpG: 21,chr11,104233714,104233988,274,21,151,15.3,55.1,1.01
CpG: 106,chr11,104441968,104443073,1105,106,692,19.2,62.6,0.98
CpG: 74,chr11,104468799,104469547,748,74,458,19.8,61.2,1.09
CpG: 71,chr11,104550009,104550838,829,71,539,17.1,65,0.81
CpG: 27,chr11,104571436,104571657,221,27,154,24.4,69.7,1.01
CpG: 53,chr11,104607827,104608349,522,53,368,20.3,70.5,0.83
CpG: 21,chr11,104685610,104685883,273,21,180,15.4,65.9,0.72
CpG: 58,chr11,105126420,105126995,575,58,381,20.2,66.3,0.92
CpG: 109,chr11,105164810,105166296,1486,109,933,14.7,62.8,0.74
CpG: 161,chr11,105180784,105182432,1648,161,1132,19.5,68.7,0.83
CpG: 65,chr11,105292203,105292937,734,65,496,17.7,67.6,0.8
CpG: 31,chr11,105362987,105363254,267,31,189,23.2,70.8,0.93
CpG: 34,chr11,105456517,105456866,349,34,249,19.5,71.3,0.77
CpG: 63,chr11,105589983,105590450,467,63,349,27,74.7,0.99
CpG: 94,chr11,105943715,105944452,737,94,528,25.5,71.6,1
CpG: 55,chr11,105967810,105968352,542,55,321,20.3,59.2,1.19
CpG: 15,chr11,105986061,105986263,202,15,115,14.9,56.9,0.92
CpG: 23,chr11,105988731,105988991,260,23,179,17.7,68.8,0.8
CpG: 22,chr11,106018765,106019015,250,22,155,17.6,62,0.92
CpG: 32,chr11,106020455,106020764,309,32,208,20.7,67.3,0.92
CpG: 47,chr11,106065892,106066412,520,47,326,18.1,62.7,0.92
CpG: 117,chr11,106083905,106085252,1347,117,831,17.4,61.7,0.92
CpG: 92,chr11,106159788,106160697,909,92,555,20.2,61.1,1.11
CpG: 26,chr11,106193391,106193684,293,26,199,17.7,67.9,0.77
CpG: 104,chr11,106216095,106217365,1270,104,763,16.4,60.1,0.91
CpG: 18,chr11,106255313,106255573,260,18,145,13.8,55.8,0.9
CpG: 106,chr11,106272450,106273413,963,106,651,22,67.6,0.97
CpG: 18,chr11,106320664,106320866,202,18,116,17.8,57.4,1.09
CpG: 98,chr11,106487118,106487912,794,98,575,24.7,72.4,0.94
CpG: 47,chr11,106500859,106501412,553,47,331,17,59.9,0.95
CpG: 92,chr11,106612182,106613208,1026,92,660,17.9,64.3,0.87
CpG: 42,chr11,106779227,106779632,405,42,286,20.7,70.6,0.84
CpG: 208,chr11,106787462,106789507,2045,208,1305,20.3,63.8,1
CpG: 80,chr11,106920093,106920955,862,80,479,18.6,55.6,1.21
CpG: 64,chr11,106999064,106999677,613,64,406,20.9,66.2,0.95
CpG: 26,chr11,107012600,107012831,231,26,143,22.5,61.9,1.18
CpG: 118,chr11,107027745,107028594,849,118,577,27.8,68,1.23
CpG: 54,chr11,107048725,107049588,863,54,455,12.5,52.7,0.91
CpG: 33,chr11,107049672,107050219,547,33,287,12.1,52.5,0.88
CpG: 18,chr11,107050303,107050587,284,18,151,12.7,53.2,0.9
CpG: 53,chr11,107131627,107132223,596,53,320,17.8,53.7,1.23
CpG: 49,chr11,107188910,107189486,576,49,356,17,61.8,0.91
CpG: 135,chr11,107469064,107470815,1751,135,1143,15.4,65.3,0.72
CpG: 39,chr11,107479399,107479863,464,39,317,16.8,68.3,0.74
CpG: 129,chr11,107546798,107548453,1655,129,1049,15.6,63.4,0.78
CpG: 71,chr11,107793847,107794702,855,71,460,16.6,53.8,1.15
CpG: 114,chr11,108342957,108344142,1185,114,760,19.2,64.1,0.94
CpG: 71,chr11,108424994,108425741,747,71,501,19,67.1,0.86
CpG: 31,chr11,108922545,108923014,469,31,278,13.2,59.3,0.75
CpG: 131,chr11,109362520,109363548,1028,131,730,25.5,71,1.01
CpG: 70,chr11,109425484,109426357,873,70,556,16,63.7,0.84
CpG: 30,chr11,109472253,109472605,352,30,228,17,64.8,0.82
CpG: 111,chr11,109473121,109474103,982,111,694,22.6,70.7,0.91
CpG: 77,chr11,109611083,109612118,1035,77,682,14.9,65.9,0.71
CpG: 96,chr11,109650240,109651287,1047,96,695,18.3,66.4,0.84
CpG: 38,chr11,109721320,109721733,413,38,293,18.4,70.9,0.75
CpG: 22,chr11,109722018,109722328,310,22,206,14.2,66.5,0.65
CpG: 86,chr11,110337365,110337948,583,86,430,29.5,73.8,1.1
CpG: 135,chr11,112781358,112783154,1796,135,1088,15,60.6,0.82
CpG: 22,chr11,112783817,112784076,259,22,161,17,62.2,0.88
CpG: 68,chr11,112784499,112785465,966,68,615,14.1,63.7,0.73
CpG: 46,chr11,113201433,113201928,495,46,310,18.6,62.6,0.95
CpG: 75,chr11,113618682,113619757,1075,75,685,14,63.7,0.69
CpG: 87,chr11,113649454,113650104,650,87,478,26.8,73.5,0.99
CpG: 135,chr11,113683423,113684750,1327,135,871,20.3,65.6,0.95
CpG: 99,chr11,113750857,113752076,1219,99,789,16.2,64.7,0.79
CpG: 31,chr11,114064913,114065327,414,31,285,15,68.8,0.64
CpG: 143,chr11,114065969,114067286,1317,143,930,21.7,70.6,0.87
CpG: 60,chr11,114668546,114669120,574,60,385,20.9,67.1,0.97
CpG: 54,chr11,114675372,114676005,633,54,423,17.1,66.8,0.77
CpG: 47,chr11,114764951,114765486,535,47,361,17.6,67.5,0.79
CpG: 42,chr11,114786357,114786681,324,42,231,25.9,71.3,1.02
CpG: 102,chr11,114791528,114792431,903,102,605,22.6,67,1.01
CpG: 113,chr11,114851258,114852601,1343,113,872,16.8,64.9,0.81
CpG: 31,chr11,115091450,115091824,374,31,240,16.6,64.2,0.81
CpG: 23,chr11,115154019,115154286,267,23,182,17.2,68.2,0.75
CpG: 104,chr11,115163023,115164203,1180,104,767,17.6,65,0.83
CpG: 37,chr11,115187227,115187538,311,37,214,23.8,68.8,1.01
CpG: 89,chr11,115249889,115250687,798,89,570,22.3,71.4,0.89
CpG: 57,chr11,115257800,115258414,614,57,423,18.6,68.9,0.78
CpG: 25,chr11,115265304,115265510,206,25,138,24.3,67,1.08
CpG: 67,chr11,115266607,115267269,662,67,448,20.2,67.7,0.91
CpG: 41,chr11,115297267,115297688,421,41,288,19.5,68.4,0.83
CpG: 58,chr11,115318303,115318946,643,58,428,18,66.6,0.82
CpG: 17,chr11,115321831,115322047,216,17,146,15.7,67.6,0.72
CpG: 30,chr11,115323362,115323699,337,30,219,17.8,65,0.85
CpG: 27,chr11,115334602,115334892,290,27,184,18.6,63.4,0.93
CpG: 59,chr11,115367036,115367842,806,59,550,14.6,68.2,0.63
CpG: 23,chr11,115374187,115374505,318,23,203,14.5,63.8,0.73
CpG: 66,chr11,115381814,115382337,523,66,396,25.2,75.7,0.88
CpG: 43,chr11,115393394,115394020,626,43,407,13.7,65,0.65
CpG: 51,chr11,115403659,115404213,554,51,358,18.4,64.6,0.89
CpG: 20,chr11,115412708,115412977,269,20,148,14.9,55,0.99
CpG: 29,chr11,115413396,115413721,325,29,196,17.8,60.3,0.98
CpG: 52,chr11,115419719,115420294,575,52,367,18.1,63.8,0.89
CpG: 28,chr11,115447896,115448233,337,28,212,16.6,62.9,0.86
CpG: 41,chr11,115475510,115476096,586,41,378,14,64.5,0.67
CpG: 34,chr11,115491594,115491879,285,34,196,23.9,68.8,1.01
CpG: 63,chr11,115513703,115514554,851,63,548,14.8,64.4,0.72
CpG: 119,chr11,115535454,115536606,1152,119,720,20.7,62.5,1.06
CpG: 114,chr11,115603564,115604631,1067,114,747,21.4,70,0.88
CpG: 55,chr11,115612386,115613023,637,55,362,17.3,56.8,1.08
CpG: 19,chr11,115627761,115628034,273,19,177,13.9,64.8,0.67
CpG: 22,chr11,115628181,115628442,261,22,151,16.9,57.9,1.01
CpG: 33,chr11,115707906,115708259,353,33,237,18.7,67.1,0.83
CpG: 26,chr11,115708577,115708804,227,26,146,22.9,64.3,1.12
CpG: 63,chr11,115765198,115766060,862,63,546,14.6,63.3,0.73
CpG: 16,chr11,115803544,115803758,214,16,148,15,69.2,0.65
CpG: 47,chr11,115813280,115813897,617,47,409,15.2,66.3,0.69
CpG: 80,chr11,115814568,115815262,694,80,481,23.1,69.3,0.98
CpG: 84,chr11,115823817,115824689,872,84,592,19.3,67.9,0.84
CpG: 133,chr11,115858427,115859990,1563,133,1058,17,67.7,0.75
CpG: 23,chr11,115933449,115933777,328,23,179,14,54.6,0.96
CpG: 59,chr11,115974662,115975209,547,59,379,21.6,69.3,0.9
CpG: 38,chr11,116004824,116005123,299,38,222,25.4,74.2,0.92
CpG: 49,chr11,116012347,116012848,501,49,352,19.6,70.3,0.82
CpG: 98,chr11,116023715,116024674,959,98,629,20.4,65.6,0.95
CpG: 54,chr11,116030276,116030729,453,54,319,23.8,70.4,0.96
CpG: 19,chr11,116086819,116087038,219,19,128,17.4,58.4,1.05
CpG: 110,chr11,116109510,116110468,958,110,704,23,73.5,0.85
CpG: 67,chr11,116130558,116131201,643,67,435,20.8,67.7,0.91
CpG: 57,chr11,116138362,116138892,530,57,366,21.5,69.1,0.91
CpG: 39,chr11,116167887,116168373,486,39,309,16,63.6,0.81
CpG: 53,chr11,116198479,116199140,661,53,389,16,58.9,0.93
CpG: 76,chr11,116221935,116223058,1123,76,720,13.5,64.1,0.7
CpG: 18,chr11,116232744,116232982,238,18,157,15.1,66,0.7
CpG: 25,chr11,116238045,116238278,233,25,174,21.5,74.7,0.77
CpG: 42,chr11,116273752,116274225,473,42,264,17.8,55.8,1.14
CpG: 42,chr11,116281204,116281662,458,42,308,18.3,67.2,0.81
CpG: 53,chr11,116282865,116283520,655,53,401,16.2,61.2,0.89
CpG: 38,chr11,116306427,116306856,429,38,283,17.7,66,0.84
CpG: 109,chr11,116334205,116335735,1530,109,994,14.2,65,0.68
CpG: 131,chr11,116412291,116413429,1138,131,725,23,63.7,1.14
CpG: 106,chr11,116433881,116434818,937,106,595,22.6,63.5,1.12
CpG: 78,chr11,116489763,116490485,722,78,500,21.6,69.3,0.9
CpG: 31,chr11,116498663,116498943,280,31,192,22.1,68.6,0.95
CpG: 190,chr11,116531530,116534153,2623,190,1618,14.5,61.7,0.76
CpG: 17,chr11,116541782,116541997,215,17,146,15.8,67.9,0.69
CpG: 107,chr11,116580701,116581652,951,107,585,22.5,61.5,1.19
CpG: 62,chr11,116623688,116624381,693,62,470,17.9,67.8,0.78
CpG: 29,chr11,116653652,116653951,299,29,208,19.4,69.6,0.86
CpG: 19,chr11,116654222,116654433,211,19,149,18,70.6,0.76
CpG: 69,chr11,116694238,116694929,691,69,486,20,70.3,0.81
CpG: 66,chr11,116827684,116828156,472,66,361,28,76.5,0.96
CpG: 140,chr11,116842473,116843848,1375,140,910,20.4,66.2,0.94
CpG: 204,chr11,116852079,116853903,1824,204,1186,22.4,65,1.06
CpG: 115,chr11,116918621,116919457,836,115,616,27.5,73.7,1.01
CpG: 22,chr11,116969039,116969281,242,22,168,18.2,69.4,0.76
CpG: 48,chr11,117076625,117077062,437,48,295,22,67.5,0.97
CpG: 113,chr11,117114759,117115949,1190,113,777,19,65.3,0.91
CpG: 55,chr11,117199340,117199881,541,55,388,20.3,71.7,0.79
CpG: 55,chr11,117266079,117266736,657,55,450,16.7,68.5,0.71
CpG: 22,chr11,117290409,117290715,306,22,204,14.4,66.7,0.65
CpG: 36,chr11,117332158,117332683,525,36,350,13.7,66.7,0.63
CpG: 25,chr11,117394496,117394786,290,25,199,17.2,68.6,0.73
CpG: 202,chr11,117654059,117656015,1956,202,1148,20.7,58.7,1.2
CpG: 21,chr11,117779900,117780140,240,21,168,17.5,70,0.72
CpG: 35,chr11,117783094,117783510,416,35,284,16.8,68.3,0.73
CpG: 58,chr11,117809662,117810160,498,58,364,23.3,73.1,0.87
CpG: 47,chr11,117849037,117849555,518,47,346,18.1,66.8,0.82
CpG: 19,chr11,117860710,117860915,205,19,140,18.5,68.3,0.8
CpG: 46,chr11,117873019,117873496,477,46,318,19.3,66.7,0.87
CpG: 46,chr11,117930807,117931220,413,46,309,22.3,74.8,0.81
CpG: 44,chr11,117949460,117949988,528,44,369,16.7,69.9,0.69
CpG: 38,chr11,117963365,117963770,405,38,270,18.8,66.7,0.86
CpG: 163,chr11,117967878,117969565,1687,163,1145,19.3,67.9,0.84
CpG: 65,chr11,117986791,117987358,567,65,408,22.9,72,0.89
CpG: 127,chr11,118247687,118248978,1291,127,877,19.7,67.9,0.89
CpG: 78,chr11,118289860,118290551,691,78,461,22.6,66.7,1.04
CpG: 77,chr11,118354933,118355608,675,77,489,22.8,72.4,0.87
CpG: 46,chr11,118418786,118419257,471,46,325,19.5,69,0.82
CpG: 47,chr11,118476739,118477243,504,47,344,18.7,68.3,0.8
CpG: 128,chr11,118569079,118570409,1330,128,867,19.2,65.2,0.91
CpG: 28,chr11,118891228,118891637,409,28,213,13.7,52.1,1.01
CpG: 124,chr11,118908509,118909787,1278,124,826,19.4,64.6,0.94
CpG: 27,chr11,118999518,118999905,387,27,226,14,58.4,0.82
CpG: 86,chr11,119022745,119023578,833,86,527,20.6,63.3,1.03
CpG: 30,chr11,119034303,119034721,418,30,246,14.4,58.9,0.83
CpG: 46,chr11,119037206,119037726,520,46,336,17.7,64.6,0.85
CpG: 165,chr11,119040750,119043113,2363,165,1477,14,62.5,0.73
CpG: 24,chr11,119044977,119045293,316,24,200,15.2,63.3,0.76
CpG: 27,chr11,119046523,119046859,336,27,221,16.1,65.8,0.74
CpG: 71,chr11,119053227,119054061,834,71,509,17,61,0.94
CpG: 29,chr11,119056596,119056835,239,29,174,24.3,72.8,0.92
CpG: 39,chr11,119058271,119058743,472,39,302,16.5,64,0.81
CpG: 55,chr11,119081041,119081767,726,55,451,15.2,62.1,0.79
CpG: 47,chr11,119085952,119086376,424,47,251,22.2,59.2,1.28
CpG: 106,chr11,119089984,119091203,1219,106,808,17.4,66.3,0.8
CpG: 24,chr11,119174678,119174898,220,24,167,21.8,75.9,0.76
CpG: 18,chr11,119210656,119210884,228,18,147,15.8,64.5,0.77
CpG: 36,chr11,119228093,119228487,394,36,255,18.3,64.7,0.89
CpG: 40,chr11,119267880,119268321,441,40,292,18.1,66.2,0.83
CpG: 99,chr11,119299620,119300419,799,99,554,24.8,69.3,1.03
CpG: 48,chr11,119355286,119355901,615,48,410,15.6,66.7,0.7
CpG: 71,chr11,119389954,119390810,856,71,572,16.6,66.8,0.74
CpG: 87,chr11,119490996,119491996,1000,87,652,17.4,65.2,0.83
CpG: 33,chr11,119524577,119524897,320,33,222,20.6,69.4,0.86
CpG: 230,chr11,119546892,119549732,2840,230,1769,16.2,62.3,0.84
CpG: 84,chr11,119602871,119603714,843,84,569,19.9,67.5,0.88
CpG: 49,chr11,119913703,119914107,404,49,273,24.3,67.6,1.09
CpG: 108,chr11,119942284,119943638,1354,108,785,16,58,0.97
CpG: 31,chr11,120011987,120012305,318,31,220,19.5,69.2,0.81
CpG: 46,chr11,120046796,120047187,391,46,266,23.5,68,1.02
CpG: 70,chr11,120086396,120087086,690,70,503,20.3,72.9,0.76
CpG: 79,chr11,120098464,120099310,846,79,540,18.7,63.8,0.92
CpG: 63,chr11,120150723,120151522,799,63,499,15.8,62.5,0.81
CpG: 49,chr11,120185431,120186075,644,49,434,15.2,67.4,0.67
CpG: 31,chr11,120187268,120187720,452,31,276,13.7,61.1,0.75
CpG: 29,chr11,120188049,120188407,358,29,205,16.2,57.3,0.99
CpG: 67,chr11,120189410,120190123,713,67,500,18.8,70.1,0.77
CpG: 76,chr11,120230922,120231594,672,76,470,22.6,69.9,0.93
CpG: 20,chr11,120232784,120232993,209,20,138,19.1,66,0.91
CpG: 338,chr11,120233787,120238101,4314,338,2550,15.7,59.1,0.9
CpG: 41,chr11,120305076,120305571,495,41,311,16.6,62.8,0.84
CpG: 48,chr11,120310793,120311320,527,48,360,18.2,68.3,0.78
CpG: 193,chr11,120347871,120350438,2567,193,1586,15,61.8,0.79
CpG: 65,chr11,120378268,120378892,624,65,406,20.8,65.1,0.98
CpG: 73,chr11,120437167,120437794,627,73,429,23.3,68.4,1.01
CpG: 41,chr11,120457857,120458275,418,41,291,19.6,69.6,0.82
CpG: 81,chr11,120467171,120468012,841,81,557,19.3,66.2,0.88
CpG: 54,chr11,120484496,120484984,488,54,336,22.1,68.9,0.94
CpG: 49,chr11,120491888,120492339,451,49,321,21.7,71.2,0.86
CpG: 45,chr11,120530551,120530999,448,45,276,20.1,61.6,1.08
CpG: 67,chr11,120549382,120549935,553,67,372,24.2,67.3,1.07
CpG: 128,chr11,120572476,120573685,1209,128,823,21.2,68.1,0.92
CpG: 88,chr11,120580994,120581808,814,88,432,21.6,53.1,1.55
CpG: 150,chr11,120597591,120598824,1233,150,757,24.3,61.4,1.29
CpG: 36,chr11,120608514,120608920,406,36,271,17.7,66.7,0.8
CpG: 53,chr11,120617581,120618028,447,53,314,23.7,70.2,1.01
CpG: 74,chr11,120624451,120625069,618,74,436,23.9,70.6,1.01
CpG: 104,chr11,120632650,120633766,1116,104,609,18.6,54.6,1.27
CpG: 149,chr11,120659854,120661388,1534,149,1012,19.4,66,0.89
CpG: 72,chr11,120672900,120673537,637,72,436,22.6,68.4,0.98
CpG: 57,chr11,120713222,120714026,804,57,499,14.2,62.1,0.76
CpG: 60,chr11,120721293,120721783,490,60,338,24.5,69,1.03
CpG: 27,chr11,120726952,120727208,256,27,175,21.1,68.4,0.99
CpG: 120,chr11,120783758,120784818,1060,120,639,22.6,60.3,1.25
CpG: 50,chr11,120796029,120796548,519,50,348,19.3,67.1,0.86
CpG: 160,chr11,120823573,120824995,1422,160,995,22.5,70,0.92
CpG: 36,chr11,120932612,120932994,382,36,237,18.8,62,0.98
CpG: 60,chr11,120948948,120949654,706,60,458,17,64.9,0.81
CpG: 26,chr11,120950831,120951111,280,26,179,18.6,63.9,0.92
CpG: 84,chr11,120990766,120991408,642,84,471,26.2,73.4,0.98
CpG: 59,chr11,121156395,121156973,578,59,388,20.4,67.1,0.91
CpG: 61,chr11,121204380,121204927,547,61,387,22.3,70.7,0.89
CpG: 63,chr11,121236702,121237537,835,63,524,15.1,62.8,0.77
CpG: 116,chr11,121259666,121260532,866,116,516,26.8,59.6,1.51
CpG: 96,chr11,121353779,121354600,821,96,573,23.4,69.8,0.98
CpG: 49,chr11,121387753,121388238,485,49,335,20.2,69.1,0.88
CpG: 19,chr11,121421613,121421846,233,19,153,16.3,65.7,0.76
CpG: 45,chr11,121451878,121452245,367,45,247,24.5,67.3,1.12
CpG: 58,chr11,121672748,121673446,698,58,445,16.6,63.8,0.84
CpG: 72,chr11,121702214,121702990,776,72,524,18.6,67.5,0.82
CpG: 20,chr11,121703380,121703627,247,20,157,16.2,63.6,0.82
CpG: 33,chr11,121830175,121830581,406,33,274,16.3,67.5,0.71
CpG: 184,chr12,5373700,5376059,2359,184,1448,15.6,61.4,0.83
CpG: 74,chr12,55836224,55836875,651,74,446,22.7,68.5,1.02
CpG: 45,chr12,84148115,84148569,454,45,309,19.8,68.1,0.86
CpG: 84,chr12,112721844,112722765,921,84,563,18.2,61.1,0.98
CpG: 55,chr12,3235440,3235920,480,55,304,22.9,63.3,1.16
CpG: 112,chr12,3309324,3310176,852,112,606,26.3,71.1,1.04
CpG: 33,chr12,3365111,3365428,317,33,210,20.8,66.2,0.95
CpG: 112,chr12,3426605,3427706,1101,112,726,20.3,65.9,0.94
CpG: 87,chr12,3572055,3572883,828,87,517,21,62.4,1.11
CpG: 29,chr12,3891226,3891634,408,29,269,14.2,65.9,0.68
CpG: 43,chr12,3930250,3930622,372,43,258,23.1,69.4,1.01
CpG: 48,chr12,3959901,3960450,549,48,351,17.5,63.9,0.86
CpG: 30,chr12,3981728,3982058,330,30,214,18.2,64.8,0.89
CpG: 70,chr12,4038394,4039169,775,70,506,18.1,65.3,0.85
CpG: 48,chr12,4082493,4082922,429,48,300,22.4,69.9,0.92
CpG: 72,chr12,4133130,4133736,606,72,439,23.8,72.4,0.91
CpG: 89,chr12,4592830,4593587,757,89,492,23.5,65,1.12
CpG: 61,chr12,4768898,4769443,545,61,366,22.4,67.2,1
CpG: 53,chr12,4817253,4817906,653,53,384,16.2,58.8,0.94
CpG: 48,chr12,4841210,4841687,477,48,345,20.1,72.3,0.77
CpG: 22,chr12,4843213,4843433,220,22,132,20,60,1.11
CpG: 17,chr12,4874228,4874458,230,17,156,14.8,67.8,0.64
CpG: 105,chr12,4906987,4907825,838,105,554,25.1,66.1,1.15
CpG: 116,chr12,4917016,4918101,1085,116,732,21.4,67.5,0.94
CpG: 19,chr12,5209990,5210228,238,19,162,16,68.1,0.7
CpG: 30,chr12,8208073,8208367,294,30,192,20.4,65.3,0.97
CpG: 104,chr12,8297986,8298957,971,104,627,21.4,64.6,1.03
CpG: 81,chr12,8301479,8302393,914,81,604,17.7,66.1,0.82
CpG: 31,chr12,8313313,8313592,279,31,199,22.2,71.3,0.88
CpG: 154,chr12,8498973,8500446,1473,154,974,20.9,66.1,0.96
CpG: 31,chr12,8640898,8641231,333,31,209,18.6,62.8,0.95
CpG: 101,chr12,8673955,8674910,955,101,616,21.2,64.5,1.04
CpG: 153,chr12,8770986,8772941,1955,153,1308,15.7,66.9,0.7
CpG: 91,chr12,8921580,8922636,1056,91,647,17.2,61.3,0.92
CpG: 46,chr12,8973788,8974262,474,46,289,19.4,61,1.04
CpG: 62,chr12,9029921,9030503,582,62,383,21.3,65.8,0.99
CpG: 29,chr12,9574445,9574788,343,29,223,16.9,65,0.8
CpG: 25,chr12,9581229,9581438,209,25,148,23.9,70.8,0.95
CpG: 47,chr12,10390726,10391201,475,47,340,19.8,71.6,0.78
CpG: 48,chr12,11150132,11150540,408,48,284,23.5,69.6,0.97
CpG: 101,chr12,11265767,11266616,849,101,586,23.8,69,1
CpG: 22,chr12,11436442,11436740,298,22,182,14.8,61.1,0.82
CpG: 41,chr12,11455760,11456245,485,41,325,16.9,67,0.78
CpG: 37,chr12,12262143,12262431,288,37,213,25.7,74,0.98
CpG: 22,chr12,12392418,12392711,293,22,207,15,70.6,0.65
CpG: 28,chr12,12911996,12912324,328,28,202,17.1,61.6,0.9
CpG: 32,chr12,12936991,12937387,396,32,235,16.2,59.3,0.92
CpG: 60,chr12,12939674,12940305,631,60,432,19,68.5,0.81
CpG: 90,chr12,12941552,12942789,1237,90,679,14.6,54.9,0.97
CpG: 44,chr12,13248795,13249277,482,44,301,18.3,62.4,0.95
CpG: 82,chr12,14149682,14150644,962,82,635,17,66,0.78
CpG: 43,chr12,14151807,14152353,546,43,345,15.8,63.2,0.79
CpG: 175,chr12,15814861,15817217,2356,175,1336,14.9,56.7,0.92
CpG: 27,chr12,16589553,16589846,293,27,197,18.4,67.2,0.82
CpG: 57,chr12,16653560,16654105,545,57,370,20.9,67.9,0.91
CpG: 51,chr12,16800362,16800961,599,51,387,17,64.6,0.83
CpG: 72,chr12,16810837,16811404,567,72,410,25.4,72.3,0.98
CpG: 124,chr12,16894408,16895514,1106,124,701,22.4,63.4,1.12
CpG: 33,chr12,16999720,17000078,358,33,234,18.4,65.4,0.88
CpG: 92,chr12,17175491,17176726,1235,92,768,14.9,62.2,0.77
CpG: 55,chr12,17266396,17266861,465,55,331,23.7,71.2,0.94
CpG: 42,chr12,17324455,17324844,389,42,259,21.6,66.6,0.97
CpG: 34,chr12,17348301,17348655,354,34,223,19.2,63,0.98
CpG: 102,chr12,17544573,17545428,855,102,591,23.9,69.1,1
CpG: 89,chr12,17690630,17691536,906,89,623,19.6,68.8,0.86
CpG: 99,chr12,17881694,17882503,809,99,583,24.5,72.1,0.95
CpG: 112,chr12,17992588,17993690,1102,112,734,20.3,66.6,0.92
CpG: 94,chr12,18135572,18136430,858,94,562,21.9,65.5,1.02
CpG: 79,chr12,18387201,18388046,845,79,547,18.7,64.7,0.89
CpG: 92,chr12,18514210,18515044,834,92,571,22.1,68.5,0.94
CpG: 93,chr12,18609904,18610691,787,93,551,23.6,70,0.97
CpG: 90,chr12,18853468,18854178,710,90,515,25.4,72.5,0.96
CpG: 92,chr12,19044166,19045001,835,92,579,22,69.3,0.92
CpG: 68,chr12,19175719,19176397,678,68,441,20.1,65,0.95
CpG: 107,chr12,19288194,19289105,911,107,655,23.5,71.9,0.91
CpG: 93,chr12,19387541,19388394,853,93,593,21.8,69.5,0.9
CpG: 92,chr12,19489982,19490838,856,92,602,21.5,70.3,0.87
CpG: 88,chr12,19606378,19607235,857,88,582,20.5,67.9,0.89
CpG: 53,chr12,19704083,19704478,395,53,290,26.8,73.4,1
CpG: 84,chr12,19882011,19882759,748,84,539,22.5,72.1,0.87
CpG: 98,chr12,19953989,19955007,1018,98,663,19.3,65.1,0.91
CpG: 93,chr12,20071332,20072188,856,93,604,21.7,70.6,0.88
CpG: 109,chr12,20196366,20197474,1108,109,743,19.7,67.1,0.87
CpG: 89,chr12,20311963,20312822,859,89,599,20.7,69.7,0.86
CpG: 109,chr12,20415387,20416495,1108,109,740,19.7,66.8,0.88
CpG: 98,chr12,20614757,20615610,853,98,617,23,72.3,0.88
CpG: 85,chr12,20815179,20816016,837,85,550,20.3,65.7,0.94
CpG: 115,chr12,20920409,20921531,1122,115,780,20.5,69.5,0.85
CpG: 106,chr12,20990202,20991305,1103,106,747,19.2,67.7,0.84
CpG: 130,chr12,21111482,21112601,1119,130,807,23.2,72.1,0.89
CpG: 64,chr12,21285891,21286626,735,64,478,17.4,65,0.82
CpG: 52,chr12,21316235,21316720,485,52,336,21.4,69.3,0.89
CpG: 63,chr12,21373232,21374059,827,63,509,15.2,61.5,0.8
CpG: 110,chr12,21416752,21417938,1186,110,738,18.5,62.2,0.96
CpG: 26,chr12,21543251,21543540,289,26,198,18,68.5,0.79
CpG: 94,chr12,21778296,21779153,857,94,584,21.9,68.1,0.95
CpG: 88,chr12,21783961,21784783,822,88,557,21.4,67.8,0.93
CpG: 97,chr12,21898661,21899567,906,97,622,21.4,68.7,0.91
CpG: 88,chr12,22030376,22031105,729,88,502,24.1,68.9,1.02
CpG: 81,chr12,22156050,22156787,737,81,496,22,67.3,0.97
CpG: 84,chr12,22274203,22274903,700,84,490,24,70,0.98
CpG: 96,chr12,22466409,22467220,811,96,581,23.7,71.6,0.93
CpG: 110,chr12,22622529,22623648,1119,110,760,19.7,67.9,0.85
CpG: 97,chr12,22745105,22745959,854,97,612,22.7,71.7,0.89
CpG: 87,chr12,22905918,22906713,795,87,543,21.9,68.3,0.94
CpG: 102,chr12,23009662,23010562,900,102,645,22.7,71.7,0.88
CpG: 94,chr12,23189091,23189915,824,94,562,22.8,68.2,0.98
CpG: 87,chr12,23314762,23315613,851,87,574,20.4,67.5,0.9
CpG: 82,chr12,23426574,23427274,700,82,489,23.4,69.9,0.96
CpG: 94,chr12,23634168,23634975,807,94,578,23.3,71.6,0.91
CpG: 94,chr12,23800339,23801191,852,94,596,22.1,70,0.9
CpG: 110,chr12,23968287,23969406,1119,110,759,19.7,67.8,0.86
CpG: 100,chr12,24096661,24097488,827,100,599,24.2,72.4,0.92
CpG: 85,chr12,24251936,24252731,795,85,548,21.4,68.9,0.9
CpG: 28,chr12,24493515,24493726,211,28,144,26.5,68.2,1.18
CpG: 26,chr12,24498555,24498845,290,26,197,17.9,67.9,0.8
CpG: 90,chr12,24571957,24572749,792,90,558,22.7,70.5,0.92
CpG: 102,chr12,24650980,24651906,926,102,617,22,66.6,0.99
CpG: 54,chr12,24680629,24681116,487,54,365,22.2,74.9,0.81
CpG: 75,chr12,24707882,24708702,820,75,528,18.3,64.4,0.88
CpG: 109,chr12,24830842,24832174,1332,109,818,16.4,61.4,0.87
CpG: 39,chr12,24974896,24975271,375,39,263,20.8,70.1,0.91
CpG: 43,chr12,25095914,25096527,613,43,386,14,63,0.71
CpG: 49,chr12,25098548,25099068,520,49,318,18.8,61.2,1.02
CpG: 57,chr12,25100522,25101183,661,57,407,17.2,61.6,0.91
CpG: 103,chr12,26414462,26415348,886,103,631,23.3,71.2,0.92
CpG: 59,chr12,26469171,26469850,679,59,468,17.4,68.9,0.73
CpG: 84,chr12,27338810,27339694,884,84,573,19,64.8,0.91
CpG: 228,chr12,27341186,27343461,2275,228,1445,20,63.5,1
CpG: 38,chr12,28552031,28552394,363,38,252,20.9,69.4,0.87
CpG: 73,chr12,28635375,28636150,775,73,497,18.8,64.1,0.92
CpG: 38,chr12,28649525,28649834,309,38,208,24.6,67.3,1.09
CpG: 42,chr12,28675146,28675589,443,42,267,19,60.3,1.06
CpG: 32,chr12,28750203,28750524,321,32,208,19.9,64.8,0.95
CpG: 19,chr12,28751791,28752033,242,19,144,15.7,59.5,1.02
CpG: 71,chr12,29937939,29938634,695,71,496,20.4,71.4,0.8
CpG: 30,chr12,30002417,30002806,389,30,246,15.4,63.2,0.78
CpG: 34,chr12,30373158,30373471,313,34,228,21.7,72.8,0.84
CpG: 36,chr12,30584391,30584747,356,36,231,20.2,64.9,0.96
CpG: 78,chr12,30884202,30884888,686,78,486,22.7,70.8,0.91
CpG: 62,chr12,30911475,30912293,818,62,515,15.2,63,0.77
CpG: 39,chr12,31073895,31074372,477,39,304,16.4,63.7,0.81
CpG: 95,chr12,31264945,31266363,1418,95,875,13.4,61.7,0.71
CpG: 64,chr12,31350903,31351526,623,64,428,20.5,68.7,0.87
CpG: 100,chr12,31498907,31500161,1254,100,767,15.9,61.2,0.85
CpG: 89,chr12,31559063,31559923,860,89,594,20.7,69.1,0.87
CpG: 54,chr12,31634422,31634833,411,54,267,26.3,65,1.25
CpG: 58,chr12,31654614,31655278,664,58,422,17.5,63.6,0.87
CpG: 116,chr12,31949239,31950364,1125,116,766,20.6,68.1,0.93
CpG: 82,chr12,32060616,32061258,642,82,473,25.5,73.7,0.94
CpG: 136,chr12,32378734,32379965,1231,136,780,22.1,63.4,1.1
CpG: 107,chr12,32819820,32821011,1191,107,717,18,60.2,0.99
CpG: 90,chr12,32953804,32954798,994,90,569,18.1,57.2,1.11
CpG: 59,chr12,33147313,33147894,581,59,388,20.3,66.8,0.91
CpG: 60,chr12,33429546,33430052,506,60,348,23.7,68.8,1
CpG: 142,chr12,33956951,33958701,1750,142,978,16.2,55.9,1.04
CpG: 19,chr12,33968482,33968740,258,19,165,14.7,64,0.78
CpG: 63,chr12,34906697,34907447,750,63,400,16.8,53.3,1.19
CpG: 123,chr12,35046762,35047870,1108,123,755,22.2,68.1,0.96
CpG: 69,chr12,35534505,35534998,493,69,369,28,74.8,1
CpG: 56,chr12,36042030,36042546,516,56,354,21.7,68.6,0.94
CpG: 51,chr12,36156333,36156914,581,51,389,17.6,67,0.79
CpG: 22,chr12,36317125,36317388,263,22,163,16.7,62,0.87
CpG: 58,chr12,36381628,36382221,593,58,417,19.6,70.3,0.79
CpG: 34,chr12,38778640,38779114,474,34,282,14.3,59.5,0.81
CpG: 107,chr12,40037326,40038224,898,107,624,23.8,69.5,1.01
CpG: 25,chr12,40134071,40134276,205,25,143,24.4,69.8,1
CpG: 120,chr12,40222212,40223523,1311,120,829,18.3,63.2,0.92
CpG: 104,chr12,40445683,40446660,977,104,667,21.3,68.3,0.91
CpG: 39,chr12,41024137,41024469,332,39,235,23.5,70.8,0.94
CpG: 102,chr12,44209465,44210430,965,102,647,21.1,67,0.95
CpG: 79,chr12,44221675,44222279,604,79,415,26.2,68.7,1.11
CpG: 58,chr12,44269134,44269572,438,58,330,26.5,75.3,0.95
CpG: 107,chr12,44328640,44329689,1049,107,711,20.4,67.8,0.92
CpG: 71,chr12,45074002,45074634,632,71,463,22.5,73.3,0.85
CpG: 24,chr12,46819439,46819673,234,24,164,20.5,70.1,0.89
CpG: 224,chr12,49383077,49385808,2731,224,1502,16.4,55,1.1
CpG: 31,chr12,49391301,49391696,395,31,258,15.7,65.3,0.74
CpG: 62,chr12,49401293,49401752,459,62,352,27,76.7,0.92
CpG: 65,chr12,50648966,50649446,480,65,316,27.1,65.8,1.25
CpG: 63,chr12,51347991,51348511,520,63,363,24.2,69.8,1
CpG: 23,chr12,51377346,51377622,276,23,179,16.7,64.9,0.8
CpG: 94,chr12,51593087,51594030,943,94,652,19.9,69.1,0.84
CpG: 127,chr12,51690919,51692308,1389,127,863,18.3,62.1,0.95
CpG: 190,chr12,51828655,51830115,1460,190,1063,26,72.8,0.98
CpG: 72,chr12,51970785,51971445,660,72,488,21.8,73.9,0.82
CpG: 31,chr12,52006341,52006583,242,31,179,25.6,74,0.94
CpG: 30,chr12,52097701,52097939,238,30,172,25.2,72.3,0.98
CpG: 19,chr12,52503422,52503636,214,19,132,17.8,61.7,0.98
CpG: 123,chr12,52503800,52504970,1170,123,729,21,62.3,1.12
CpG: 41,chr12,53248351,53248788,437,41,268,18.8,61.3,1.02
CpG: 75,chr12,53252691,53253666,975,75,491,15.4,50.4,1.24
CpG: 45,chr12,53707285,53707805,520,45,340,17.3,65.4,0.83
CpG: 126,chr12,54067759,54069166,1407,126,915,17.9,65,0.85
CpG: 71,chr12,54203111,54203938,827,71,554,17.2,67,0.77
CpG: 17,chr12,54313169,54313370,201,17,144,16.9,71.6,0.67
CpG: 61,chr12,54656156,54656806,650,61,444,18.8,68.3,0.83
CpG: 50,chr12,54695588,54696034,446,50,287,22.4,64.3,1.09
CpG: 28,chr12,54713923,54714181,258,28,148,21.7,57.4,1.6
CpG: 39,chr12,54719339,54719752,413,39,254,18.9,61.5,1.07
CpG: 39,chr12,54729175,54729588,413,39,254,18.9,61.5,1.07
CpG: 28,chr12,54734754,54735012,258,28,148,21.7,57.4,1.6
CpG: 42,chr12,54795252,54795700,448,42,280,18.8,62.5,0.97
CpG: 97,chr12,54862297,54863200,903,97,584,21.5,64.7,1.03
CpG: 151,chr12,54984960,54986326,1366,151,829,22.1,60.7,1.21
CpG: 75,chr12,55080008,55080835,827,75,526,18.1,63.6,0.9
CpG: 62,chr12,55124374,55124893,519,62,344,23.9,66.3,1.1
CpG: 70,chr12,55154849,55155679,830,70,520,16.9,62.7,0.86
CpG: 62,chr12,55199438,55199957,519,62,344,23.9,66.3,1.1
CpG: 71,chr12,55229913,55230743,830,71,519,17.1,62.5,0.88
CpG: 38,chr12,55302603,55303128,525,38,269,14.5,51.2,1.1
CpG: 48,chr12,55398657,55399188,531,48,350,18.1,65.9,0.83
CpG: 31,chr12,55420456,55420823,367,31,203,16.9,55.3,1.1
CpG: 52,chr12,55492136,55492666,530,52,358,19.6,67.5,0.86
CpG: 211,chr12,55598837,55600814,1977,211,1293,21.3,65.4,1.01
CpG: 79,chr12,55820512,55821237,725,79,426,21.8,58.8,1.26
CpG: 17,chr12,55861029,55861241,212,17,124,16,58.5,0.94
CpG: 32,chr12,56345477,56345897,420,32,280,15.2,66.7,0.7
CpG: 24,chr12,56519880,56520143,263,24,177,18.3,67.3,0.81
CpG: 25,chr12,56521093,56521319,226,25,163,22.1,72.1,0.89
CpG: 180,chr12,56532947,56535279,2332,180,1439,15.4,61.7,0.81
CpG: 59,chr12,56535831,56536691,860,59,554,13.7,64.4,0.67
CpG: 52,chr12,56611782,56612308,526,52,353,19.8,67.1,0.88
CpG: 18,chr12,56612959,56613189,230,18,151,15.7,65.7,0.74
CpG: 22,chr12,56681122,56681411,289,22,187,15.2,64.7,0.73
CpG: 28,chr12,56691494,56691803,309,28,202,18.1,65.4,0.86
CpG: 20,chr12,56692444,56692694,250,20,148,16,59.2,0.95
CpG: 63,chr12,56696494,56697281,787,63,494,16,62.8,0.81
CpG: 50,chr12,57196711,57197162,451,50,308,22.2,68.3,0.96
CpG: 67,chr12,57230278,57230924,646,67,406,20.7,62.8,1.05
CpG: 50,chr12,57538709,57539230,521,50,337,19.2,64.7,0.92
CpG: 74,chr12,57542297,57543269,972,74,601,15.2,61.8,0.8
CpG: 86,chr12,57545269,57546149,880,86,580,19.5,65.9,0.9
CpG: 81,chr12,57575938,57576606,668,81,461,24.3,69,1.02
CpG: 59,chr12,58212392,58213262,870,59,544,13.6,62.5,0.69
CpG: 22,chr12,58213473,58213783,310,22,185,14.2,59.7,0.8
CpG: 54,chr12,59011630,59012287,657,54,413,16.4,62.9,0.85
CpG: 27,chr12,59013375,59013679,304,27,198,17.8,65.1,0.85
CpG: 40,chr12,59061062,59061392,330,40,227,24.2,68.8,1.04
CpG: 68,chr12,59066731,59067474,743,68,477,18.3,64.2,0.89
CpG: 123,chr12,59130781,59131799,1018,123,722,24.2,70.9,0.98
CpG: 133,chr12,59219035,59220175,1140,133,727,23.3,63.8,1.15
CpG: 41,chr12,61522900,61523369,469,41,307,17.5,65.5,0.82
CpG: 54,chr12,64917786,64918353,567,54,295,19,52,1.43
CpG: 77,chr12,64965669,64966573,904,77,589,17,65.2,0.8
CpG: 49,chr12,65036217,65036687,470,49,296,20.9,63,1.06
CpG: 63,chr12,65073471,65074221,750,63,510,16.8,68,0.73
CpG: 61,chr12,65075474,65075975,501,61,346,24.4,69.1,1.02
CpG: 64,chr12,65172293,65172881,588,64,384,21.8,65.3,1.02
CpG: 24,chr12,65225693,65226020,327,24,195,14.7,59.6,0.83
CpG: 48,chr12,66283872,66284400,528,48,326,18.2,61.7,0.95
CpG: 177,chr12,67220630,67222891,2261,177,1320,15.7,58.4,0.92
CpG: 64,chr12,69158619,69159291,672,64,418,19,62.2,0.99
CpG: 45,chr12,69168494,69169167,673,45,417,13.4,62,0.7
CpG: 160,chr12,69183583,69184984,1401,160,929,22.8,66.3,1.04
CpG: 163,chr12,69196793,69198275,1482,163,1009,22,68.1,0.95
CpG: 33,chr12,69227871,69228196,325,33,209,20.3,64.3,1
CpG: 55,chr12,69241757,69242228,471,55,311,23.4,66,1.07
CpG: 93,chr12,69296617,69297435,818,93,539,22.7,65.9,1.05
CpG: 39,chr12,69356772,69357204,432,39,273,18.1,63.2,0.93
CpG: 21,chr12,69361484,69361731,247,21,148,17,59.9,0.95
CpG: 180,chr12,69371771,69373136,1365,180,980,26.4,71.8,1.03
CpG: 51,chr12,69582645,69583101,456,51,321,22.4,70.4,0.93
CpG: 120,chr12,69681325,69682397,1072,120,665,22.4,62,1.17
CpG: 69,chr12,69724479,69725206,727,69,497,19,68.4,0.81
CpG: 22,chr12,69790526,69790799,273,22,192,16.1,70.3,0.65
CpG: 130,chr12,69892483,69893467,984,130,717,26.4,72.9,1
CpG: 105,chr12,69986461,69987403,942,105,564,22.3,59.9,1.25
CpG: 125,chr12,70111228,70112213,985,125,732,25.4,74.3,0.92
CpG: 45,chr12,70227323,70227871,548,45,362,16.4,66.1,0.75
CpG: 100,chr12,70346497,70347720,1223,100,822,16.4,67.2,0.73
CpG: 45,chr12,70452890,70453367,477,45,320,18.9,67.1,0.85
CpG: 64,chr12,70825468,70826031,563,64,374,22.7,66.4,1.03
CpG: 41,chr12,70937736,70938157,421,41,260,19.5,61.8,1.02
CpG: 26,chr12,70968323,70968687,364,26,228,14.3,62.6,0.73
CpG: 71,chr12,70974528,70975224,696,71,461,20.4,66.2,0.93
CpG: 120,chr12,71015220,71016556,1336,120,868,18,65,0.85
CpG: 15,chr12,71069849,71070064,215,15,117,14,54.4,1
CpG: 32,chr12,71111371,71111657,286,32,205,22.4,71.7,0.87
CpG: 39,chr12,71136305,71136674,369,39,256,21.1,69.4,0.88
CpG: 104,chr12,71309568,71310456,888,104,597,23.4,67.2,1.06
CpG: 74,chr12,71317978,71318774,796,74,523,18.6,65.7,0.86
CpG: 69,chr12,71831095,71831860,765,69,493,18,64.4,0.87
CpG: 107,chr12,72070105,72071180,1075,107,703,19.9,65.4,0.94
CpG: 133,chr12,72084672,72086287,1615,133,1022,16.5,63.3,0.83
CpG: 56,chr12,72236467,72236967,500,56,317,22.4,63.4,1.14
CpG: 27,chr12,72303786,72304071,285,27,197,18.9,69.1,0.8
CpG: 49,chr12,72408265,72408741,476,49,340,20.6,71.4,0.81
CpG: 43,chr12,72536070,72536529,459,43,311,18.7,67.8,0.82
CpG: 28,chr12,72664671,72664937,266,28,182,21.1,68.4,0.92
CpG: 159,chr12,72760478,72761927,1449,159,942,21.9,65,1.05
CpG: 38,chr12,72917438,72918004,566,38,391,13.4,69.1,0.62
CpG: 65,chr12,72939661,72940486,825,65,508,15.8,61.6,0.83
CpG: 83,chr12,72945352,72946044,692,83,494,24,71.4,0.94
CpG: 24,chr12,73034963,73035250,287,24,199,16.7,69.3,0.7
CpG: 199,chr12,73044615,73046874,2259,199,1439,17.6,63.7,0.87
CpG: 42,chr12,73053667,73054187,520,42,347,16.2,66.7,0.75
CpG: 111,chr12,73111840,73113164,1324,111,891,16.8,67.3,0.75
CpG: 50,chr12,73286480,73287075,595,50,380,16.8,63.9,0.82
CpG: 140,chr12,73545288,73546556,1268,140,825,22.1,65.1,1.06
CpG: 102,chr12,73584451,73585703,1252,102,796,16.3,63.6,0.81
CpG: 145,chr12,73907475,73908803,1328,145,907,21.8,68.3,0.95
CpG: 38,chr12,73949649,73949992,343,38,234,22.2,68.2,0.95
CpG: 51,chr12,73964395,73964972,577,51,367,17.7,63.6,0.87
CpG: 41,chr12,73997631,73998000,369,41,238,22.2,64.5,1.07
CpG: 34,chr12,74283973,74284332,359,34,232,18.9,64.6,0.92
CpG: 33,chr12,75176643,75176970,327,33,237,20.2,72.5,0.77
CpG: 129,chr12,75595510,75596718,1208,129,806,21.4,66.7,0.96
CpG: 46,chr12,75669333,75669898,565,46,345,16.3,61.1,0.89
CpG: 70,chr12,75735241,75735934,693,70,407,20.2,58.7,1.18
CpG: 122,chr12,75818003,75819124,1121,122,747,21.8,66.6,0.99
CpG: 28,chr12,76152507,76152762,255,28,173,22,67.8,0.95
CpG: 34,chr12,76255069,76255449,380,34,249,17.9,65.5,0.85
CpG: 44,chr12,76324705,76325169,464,44,324,19,69.8,0.78
CpG: 253,chr12,76369031,76371309,2278,253,1574,22.2,69.1,0.93
CpG: 217,chr12,76403462,76406165,2703,217,1616,16.1,59.8,0.9
CpG: 37,chr12,76417491,76417899,408,37,278,18.1,68.1,0.79
CpG: 87,chr12,76533065,76533975,910,87,587,19.1,64.5,0.92
CpG: 19,chr12,76606283,76606504,221,19,149,17.2,67.4,0.78
CpG: 108,chr12,76709476,76710690,1214,108,855,17.8,70.4,0.72
CpG: 23,chr12,76765449,76765686,237,23,138,19.4,58.2,1.17
CpG: 66,chr12,76822085,76822765,680,66,448,19.4,65.9,0.9
CpG: 33,chr12,76837387,76837827,440,33,253,15,57.5,0.91
CpG: 94,chr12,76961702,76962853,1151,94,722,16.3,62.7,0.83
CpG: 168,chr12,77237966,77239594,1628,168,1125,20.6,69.1,0.87
CpG: 152,chr12,78225820,78227437,1617,152,1082,18.8,66.9,0.85
CpG: 111,chr12,78748531,78749539,1008,111,697,22,69.1,0.94
CpG: 84,chr12,78861352,78862379,1027,84,624,16.4,60.8,0.89
CpG: 36,chr12,78906809,78907160,351,36,247,20.5,70.4,0.89
CpG: 22,chr12,78911969,78912248,279,22,161,15.8,57.7,0.95
CpG: 80,chr12,79006770,79007452,682,80,476,23.5,69.8,0.99
CpG: 61,chr12,79029008,79029561,553,61,401,22.1,72.5,0.85
CpG: 47,chr12,79089334,79089734,400,47,278,23.5,69.5,0.98
CpG: 34,chr12,79130664,79131107,443,34,282,15.3,63.7,0.77
CpG: 69,chr12,79172100,79172815,715,69,503,19.3,70.3,0.78
CpG: 42,chr12,80109954,80110382,428,42,284,19.6,66.4,0.91
CpG: 23,chr12,80112800,80113026,226,23,148,20.4,65.5,0.95
CpG: 27,chr12,80114375,80114598,223,27,142,24.2,63.7,1.2
CpG: 68,chr12,80115531,80116070,539,68,381,25.2,70.7,1.02
CpG: 62,chr12,80132426,80132950,524,62,374,23.7,71.4,0.93
CpG: 27,chr12,80168329,80168631,302,27,173,17.9,57.3,1.1
CpG: 118,chr12,80259337,80260799,1462,118,947,16.1,64.8,0.77
CpG: 21,chr12,80339782,80340081,299,21,185,14,61.9,0.75
CpG: 61,chr12,80434954,80435737,783,61,524,15.6,66.9,0.7
CpG: 69,chr12,80436450,80436956,506,69,381,27.3,75.3,0.97
CpG: 51,chr12,80463093,80463711,618,51,418,16.5,67.6,0.72
CpG: 140,chr12,80518438,80519861,1423,140,969,19.7,68.1,0.85
CpG: 56,chr12,80643329,80643889,560,56,376,20,67.1,0.89
CpG: 45,chr12,80692630,80693046,416,45,285,21.6,68.5,0.94
CpG: 211,chr12,80757414,80759425,2011,211,1245,21,61.9,1.1
CpG: 24,chr12,80760303,80760588,285,24,192,16.8,67.4,0.74
CpG: 119,chr12,80790393,80791219,826,119,621,28.8,75.2,1.02
CpG: 102,chr12,80945334,80946329,995,102,662,20.5,66.5,0.93
CpG: 52,chr12,81026704,81027202,498,52,362,20.9,72.7,0.83
CpG: 59,chr12,81332664,81333165,501,59,377,23.6,75.2,0.84
CpG: 41,chr12,81484658,81485195,537,41,320,15.3,59.6,0.86
CpG: 42,chr12,81532339,81532927,588,42,340,14.3,57.8,0.86
CpG: 31,chr12,81594941,81595255,314,31,192,19.7,61.1,1.18
CpG: 82,chr12,81631257,81631951,694,82,488,23.6,70.3,0.96
CpG: 17,chr12,81731958,81732163,205,17,129,16.6,62.9,0.85
CpG: 105,chr12,81780397,81781580,1183,105,698,17.8,59,1.03
CpG: 144,chr12,81859893,81861110,1217,144,815,23.7,67,1.06
CpG: 129,chr12,82169228,82170410,1182,129,784,21.8,66.3,0.99
CpG: 95,chr12,82616747,82617728,981,95,649,19.4,66.2,0.89
CpG: 160,chr12,83485824,83487847,2023,160,1196,15.8,59.1,0.91
CpG: 30,chr12,83520350,83520776,426,30,265,14.1,62.2,0.73
CpG: 44,chr12,83596829,83597435,606,44,391,14.5,64.5,0.7
CpG: 27,chr12,83620901,83621162,261,27,164,20.7,62.8,1.05
CpG: 66,chr12,83632158,83632929,771,66,468,17.1,60.7,0.93
CpG: 68,chr12,83687919,83688565,646,68,436,21.1,67.5,0.93
CpG: 36,chr12,83771742,83772237,495,36,330,14.5,66.7,0.66
CpG: 83,chr12,83921199,83922055,856,83,611,19.4,71.4,0.84
CpG: 148,chr12,83950622,83951672,1050,148,758,28.2,72.2,1.08
CpG: 78,chr12,83987870,83988465,595,78,421,26.2,70.8,1.05
CpG: 64,chr12,84009505,84009950,445,64,323,28.8,72.6,1.1
CpG: 73,chr12,84038434,84038951,517,73,383,28.2,74.1,1.03
CpG: 63,chr12,84053476,84053925,449,63,329,28.1,73.3,1.05
CpG: 60,chr12,84069513,84069907,394,60,294,30.5,74.6,1.1
CpG: 73,chr12,84100865,84101412,547,73,402,26.7,73.5,0.99
CpG: 26,chr12,84114241,84114599,358,26,243,14.5,67.9,0.65
CpG: 154,chr12,84192668,84194159,1491,154,1018,20.7,68.3,0.89
CpG: 63,chr12,84218377,84218937,560,63,396,22.5,70.7,0.91
CpG: 29,chr12,84285162,84285521,359,29,217,16.2,60.4,0.89
CpG: 76,chr12,84316740,84317586,846,76,573,18,67.7,0.79
CpG: 86,chr12,84408397,84409190,793,86,543,21.7,68.5,0.93
CpG: 55,chr12,84417169,84417669,500,55,320,22,64,1.09
CpG: 27,chr12,84450694,84451029,335,27,216,16.1,64.5,0.78
CpG: 35,chr12,84569867,84570336,469,35,322,14.9,68.7,0.64
CpG: 36,chr12,84571213,84571736,523,36,302,13.8,57.7,0.83
CpG: 26,chr12,84589918,84590271,353,26,198,14.7,56.1,0.94
CpG: 25,chr12,84617242,84617489,247,25,173,20.2,70,0.83
CpG: 71,chr12,84698478,84699093,615,71,415,23.1,67.5,1.04
CpG: 48,chr12,84773035,84773754,719,48,434,13.4,60.4,0.73
CpG: 84,chr12,84875601,84876670,1069,84,699,15.7,65.4,0.74
CpG: 36,chr12,84970578,84970972,394,36,241,18.3,61.2,0.98
CpG: 69,chr12,84996186,84996819,633,69,406,21.8,64.1,1.08
CpG: 83,chr12,85110637,85111414,777,83,524,21.4,67.4,0.94
CpG: 29,chr12,85177183,85177532,349,29,225,16.6,64.5,0.8
CpG: 28,chr12,85216663,85217055,392,28,238,14.3,60.7,0.85
CpG: 62,chr12,85219146,85219906,760,62,472,16.3,62.1,0.85
CpG: 33,chr12,85270376,85270695,319,33,215,20.7,67.4,0.97
CpG: 23,chr12,85280202,85280474,272,23,175,16.9,64.3,0.86
CpG: 16,chr12,85288578,85288793,215,16,131,14.9,60.9,0.83
CpG: 66,chr12,85338943,85339535,592,66,400,22.3,67.6,0.98
CpG: 46,chr12,85374259,85374759,500,46,332,18.4,66.4,0.83
CpG: 20,chr12,85455298,85455557,259,20,164,15.4,63.3,0.78
CpG: 30,chr12,85472056,85472374,318,30,218,18.9,68.6,0.81
CpG: 91,chr12,85473438,85474752,1314,91,781,13.9,59.4,0.79
CpG: 32,chr12,85486030,85486377,347,32,214,18.4,61.7,0.97
CpG: 20,chr12,85486771,85487039,268,20,142,14.9,53,1.14
CpG: 87,chr12,85598798,85599797,999,87,591,17.4,59.2,1
CpG: 36,chr12,85698178,85698533,355,36,242,20.3,68.2,0.89
CpG: 43,chr12,85746214,85746750,536,43,344,16,64.2,0.8
CpG: 58,chr12,85824694,85825235,541,58,360,21.4,66.5,0.99
CpG: 28,chr12,86079369,86079688,319,28,216,17.6,67.7,0.77
CpG: 31,chr12,86082526,86082847,321,31,207,19.3,64.5,0.94
CpG: 20,chr12,86214337,86214574,237,20,130,16.9,54.9,1.13
CpG: 44,chr12,86241735,86242213,478,44,340,18.4,71.1,0.74
CpG: 23,chr12,86244152,86244456,304,23,182,15.1,59.9,0.85
CpG: 104,chr12,86421659,86422902,1243,104,782,16.7,62.9,0.85
CpG: 35,chr12,86470030,86470477,447,35,279,15.7,62.4,0.82
CpG: 71,chr12,86678450,86679180,730,71,479,19.5,65.6,0.9
CpG: 25,chr12,86689003,86689313,310,25,195,16.1,62.9,0.84
CpG: 56,chr12,86725946,86726559,613,56,429,18.3,70,0.77
CpG: 278,chr12,86881767,86884934,3167,278,2087,17.6,65.9,0.81
CpG: 23,chr12,86891988,86892282,294,23,171,15.6,58.2,0.94
CpG: 64,chr12,86946846,86947485,639,64,423,20,66.2,0.91
CpG: 16,chr12,86947870,86948080,210,16,127,15.2,60.5,0.86
CpG: 59,chr12,86989957,86990553,596,59,434,19.8,72.8,0.75
CpG: 36,chr12,87102113,87102587,474,36,323,15.2,68.1,0.67
CpG: 94,chr12,87147049,87148157,1108,94,725,17,65.4,0.79
CpG: 95,chr12,87199698,87200536,838,95,569,22.7,67.9,1
CpG: 22,chr12,87266607,87266905,298,22,192,14.8,64.4,0.79
CpG: 105,chr12,87299398,87300330,932,105,667,22.5,71.6,0.88
CpG: 76,chr12,87387720,87388413,693,76,479,21.9,69.1,0.92
CpG: 50,chr12,87443393,87444025,632,50,401,15.8,63.4,0.79
CpG: 48,chr12,87471872,87472369,497,48,304,19.3,61.2,1.03
CpG: 31,chr12,88354390,88354691,301,31,204,20.6,67.8,0.91
CpG: 29,chr12,88360491,88360828,337,29,220,17.2,65.3,0.81
CpG: 28,chr12,89260160,89260526,366,28,227,15.3,62,0.8
CpG: 31,chr12,91588236,91588626,390,31,233,15.9,59.7,0.89
CpG: 44,chr12,91647402,91648082,680,44,382,12.9,56.2,0.82
CpG: 72,chr12,91778468,91779212,744,72,502,19.4,67.5,0.85
CpG: 25,chr12,91848814,91849048,234,25,166,21.4,70.9,0.85
CpG: 67,chr12,95695187,95695876,689,67,460,19.4,66.8,0.88
CpG: 73,chr12,98258804,98259454,650,73,435,22.5,66.9,1.01
CpG: 88,chr12,98574531,98575379,848,88,558,20.8,65.8,0.96
CpG: 26,chr12,98628037,98628349,312,26,205,16.7,65.7,0.78
CpG: 18,chr12,98689216,98689420,204,18,127,17.6,62.3,0.95
CpG: 62,chr12,98737306,98737722,416,62,327,29.8,78.6,0.96
CpG: 74,chr12,98746804,98747423,619,74,409,23.9,66.1,1.1
CpG: 118,chr12,98900593,98901570,977,118,702,24.2,71.9,0.94
CpG: 128,chr12,99392016,99393399,1383,128,835,18.5,60.4,1.02
CpG: 43,chr12,99563399,99563791,392,43,268,21.9,68.4,0.94
CpG: 46,chr12,99627694,99628084,390,46,262,23.6,67.2,1.05
CpG: 30,chr12,99883259,99883599,340,30,217,17.6,63.8,0.91
CpG: 44,chr12,99884434,99884855,421,44,272,20.9,64.6,1.01
CpG: 21,chr12,99964804,99965084,280,21,171,15,61.1,0.82
CpG: 90,chr12,99965203,99966256,1053,90,676,17.1,64.2,0.83
CpG: 52,chr12,100110044,100110573,529,52,322,19.7,60.9,1.09
CpG: 18,chr12,100130872,100131077,205,18,128,17.6,62.4,0.9
CpG: 48,chr12,100187007,100187620,613,48,358,15.7,58.4,0.93
CpG: 127,chr12,100199246,100200860,1614,127,936,15.7,58,0.94
CpG: 44,chr12,100520311,100520687,376,44,250,23.4,66.5,1.07
CpG: 78,chr12,100724639,100725581,942,78,562,16.6,59.7,0.94
CpG: 46,chr12,100898889,100899508,619,46,407,14.9,65.8,0.69
CpG: 22,chr12,100908048,100908251,203,22,146,21.7,71.9,0.84
CpG: 101,chr12,101028441,101029415,974,101,658,20.7,67.6,0.91
CpG: 171,chr12,101082443,101084074,1631,171,1054,21,64.6,1.01
CpG: 72,chr12,101718013,101718608,595,72,433,24.2,72.8,0.93
CpG: 43,chr12,101818760,101819304,544,43,341,15.8,62.7,0.82
CpG: 69,chr12,101912587,101913308,721,69,465,19.1,64.5,0.92
CpG: 60,chr12,101957878,101958412,534,60,378,22.5,70.8,0.91
CpG: 90,chr12,101975356,101976335,979,90,641,18.4,65.5,0.86
CpG: 73,chr12,102128707,102129471,764,73,494,19.1,64.7,0.91
CpG: 60,chr12,102282946,102283476,530,60,356,22.6,67.2,1.02
CpG: 27,chr12,102439601,102439896,295,27,190,18.3,64.4,0.89
CpG: 71,chr12,102468963,102469586,623,71,429,22.8,68.9,0.96
CpG: 122,chr12,102704447,102705421,974,122,674,25.1,69.2,1.06
CpG: 75,chr12,102743358,102744050,692,75,472,21.7,68.2,0.93
CpG: 100,chr12,102757312,102758334,1022,100,650,19.6,63.6,0.97
CpG: 109,chr12,102877438,102878655,1217,109,714,17.9,58.7,1.05
CpG: 68,chr12,102948857,102949644,787,68,502,17.3,63.8,0.85
CpG: 103,chr12,103241818,103242793,975,103,690,21.1,70.8,0.85
CpG: 68,chr12,103325060,103325688,628,68,416,21.7,66.2,1.02
CpG: 51,chr12,103388600,103388989,389,51,277,26.2,71.2,1.03
CpG: 48,chr12,103425495,103426077,582,48,376,16.5,64.6,0.79
CpG: 67,chr12,103532173,103532834,661,67,385,20.3,58.2,1.2
CpG: 30,chr12,104447003,104447341,338,30,224,17.8,66.3,0.81
CpG: 147,chr12,104471917,104473411,1494,147,967,19.7,64.7,0.94
CpG: 29,chr12,104474425,104474666,241,29,169,24.1,70.1,0.98
CpG: 17,chr12,104609856,104610086,230,17,126,14.8,54.8,0.99
CpG: 110,chr12,104751475,104752369,894,110,597,24.6,66.8,1.12
CpG: 57,chr12,105009553,105010194,641,57,423,17.8,66,0.82
CpG: 65,chr12,105023197,105023957,760,65,451,17.1,59.3,1
CpG: 101,chr12,105032097,105033104,1007,101,675,20.1,67,0.9
CpG: 76,chr12,105336652,105337581,929,76,580,16.4,62.4,0.85
CpG: 111,chr12,105684842,105685824,982,111,677,22.6,68.9,0.96
CpG: 15,chr12,105766563,105766768,205,15,109,14.6,53.2,1.04
CpG: 106,chr12,105784340,105785306,966,106,590,21.9,61.1,1.18
CpG: 20,chr12,105862675,105862932,257,20,159,15.6,61.9,0.81
CpG: 19,chr12,105935499,105935762,263,19,155,14.4,58.9,0.84
CpG: 30,chr12,105962822,105963249,427,30,254,14.1,59.5,0.8
CpG: 67,chr12,106010171,106010924,753,67,462,17.8,61.4,0.95
CpG: 19,chr12,106174174,106174389,215,19,129,17.7,60,0.98
CpG: 169,chr12,107915284,107917294,2010,169,1313,16.8,65.3,0.79
CpG: 49,chr12,107980220,107980746,526,49,361,18.6,68.6,0.79
CpG: 74,chr12,108002606,108003243,637,74,406,23.2,63.7,1.16
CpG: 48,chr12,108003777,108004350,573,48,329,16.8,57.4,1.02
CpG: 39,chr12,108006023,108006417,394,39,281,19.8,71.3,0.78
CpG: 165,chr12,108178345,108180230,1885,165,1137,17.5,60.3,0.96
CpG: 201,chr12,108274316,108276582,2266,201,1387,17.7,61.2,0.95
CpG: 55,chr12,108306261,108306741,480,55,351,22.9,73.1,0.87
CpG: 54,chr12,108318311,108318894,583,54,378,18.5,64.8,0.88
CpG: 93,chr12,108327675,108328409,734,93,487,25.3,66.3,1.15
CpG: 30,chr12,108333754,108334091,337,30,213,17.8,63.2,0.95
CpG: 47,chr12,108334378,108334793,415,47,297,22.7,71.6,0.88
CpG: 23,chr12,108352800,108353060,260,23,174,17.7,66.9,0.79
CpG: 72,chr12,108422930,108423569,639,72,436,22.5,68.2,0.97
CpG: 25,chr12,108463314,108463666,352,25,198,14.2,56.2,0.9
CpG: 104,chr12,108554660,108555423,763,104,513,27.3,67.2,1.22
CpG: 60,chr12,108701848,108702598,750,60,494,16,65.9,0.74
CpG: 34,chr12,108757847,108758133,286,34,195,23.8,68.2,1.03
CpG: 301,chr12,108792175,108794771,2596,301,1612,23.2,62.1,1.21
CpG: 30,chr12,108826870,108827224,354,30,226,16.9,63.8,0.83
CpG: 97,chr12,108835408,108836377,969,97,656,20,67.7,0.88
CpG: 54,chr12,108893867,108894413,546,54,377,19.8,69,0.83
CpG: 117,chr12,109033231,109034363,1132,117,762,20.7,67.3,0.92
CpG: 162,chr12,109052327,109053871,1544,162,959,21,62.1,1.09
CpG: 20,chr12,109399647,109399930,283,20,165,14.1,58.3,0.84
CpG: 77,chr12,109452985,109453847,862,77,505,17.9,58.6,1.06
CpG: 26,chr12,109459744,109460028,284,26,194,18.3,68.3,0.79
CpG: 29,chr12,109528252,109528472,220,29,136,26.4,61.8,1.38
CpG: 98,chr12,110187462,110188905,1443,98,951,13.6,65.9,0.63
CpG: 28,chr12,110189306,110189683,377,28,238,14.9,63.1,0.75
CpG: 171,chr12,110277822,110279918,2096,171,1176,16.3,56.1,1.04
CpG: 34,chr12,110319822,110320173,351,34,229,19.4,65.2,0.91
CpG: 22,chr12,110373455,110373727,272,22,181,16.2,66.5,0.73
CpG: 89,chr12,110446519,110447628,1109,89,607,16.1,54.7,1.09
CpG: 62,chr12,110591276,110591938,662,62,421,18.7,63.6,0.93
CpG: 87,chr12,110601250,110602006,756,87,492,23,65.1,1.09
CpG: 123,chr12,110695726,110696810,1084,123,706,22.7,65.1,1.09
CpG: 124,chr12,110737530,110738875,1345,124,880,18.4,65.4,0.87
CpG: 57,chr12,110840474,110841076,602,57,360,18.9,59.8,1.07
CpG: 20,chr12,110843832,110844079,247,20,154,16.2,62.3,0.85
CpG: 15,chr12,110844899,110845103,204,15,108,14.7,52.9,1.06
CpG: 66,chr12,110850074,110850726,652,66,405,20.2,62.1,1.05
CpG: 84,chr12,110888690,110889614,924,84,622,18.2,67.3,0.84
CpG: 56,chr12,110976985,110977510,525,56,358,21.3,68.2,0.92
CpG: 73,chr12,110978635,110979282,647,73,430,22.6,66.5,1.03
CpG: 157,chr12,111038403,111040347,1944,157,1149,16.2,59.1,0.92
CpG: 58,chr12,111166356,111166931,575,58,335,20.2,58.3,1.2
CpG: 64,chr12,111271061,111271997,936,64,594,13.7,63.5,0.68
CpG: 177,chr12,111274093,111275908,1815,177,1258,19.5,69.3,0.81
CpG: 17,chr12,111299424,111299678,254,17,149,13.4,58.7,0.78
CpG: 21,chr12,111318562,111318858,296,21,170,14.2,57.4,0.88
CpG: 146,chr12,111376967,111378223,1256,146,843,23.2,67.1,1.03
CpG: 49,chr12,111423454,111423995,541,49,341,18.1,63,0.91
CpG: 25,chr12,111425927,111426266,339,25,202,14.7,59.6,0.84
CpG: 21,chr12,111429589,111429796,207,21,134,20.3,64.7,0.98
CpG: 44,chr12,111442352,111442913,561,44,359,15.7,64,0.77
CpG: 49,chr12,111445534,111446079,545,49,326,18,59.8,1.04
CpG: 106,chr12,111485150,111486001,851,106,609,24.9,71.6,0.98
CpG: 164,chr12,111537507,111539183,1676,164,1063,19.6,63.4,0.99
CpG: 109,chr12,111574329,111575376,1047,109,703,20.8,67.1,0.93
CpG: 155,chr12,111670537,111672509,1972,155,1288,15.7,65.3,0.74
CpG: 45,chr12,111677860,111678297,437,45,287,20.6,65.7,0.96
CpG: 115,chr12,111712542,111713550,1008,115,643,22.8,63.8,1.12
CpG: 75,chr12,111758626,111759348,722,75,480,20.8,66.5,0.94
CpG: 19,chr12,111774393,111774623,230,19,142,16.5,61.7,0.87
CpG: 102,chr12,111813650,111814661,1011,102,682,20.2,67.5,0.89
CpG: 57,chr12,111908096,111908669,573,57,393,19.9,68.6,0.85
CpG: 42,chr12,111966615,111967113,498,42,332,16.9,66.7,0.76
CpG: 102,chr12,112130305,112131109,804,102,583,25.4,72.5,0.97
CpG: 228,chr12,112143933,112146955,3022,228,1856,15.1,61.4,0.81
CpG: 19,chr12,112161611,112161839,228,19,150,16.7,65.8,0.79
CpG: 30,chr12,112173828,112174216,388,30,262,15.5,67.5,0.68
CpG: 29,chr12,112175530,112175832,302,29,206,19.2,68.2,0.84
CpG: 20,chr12,112178042,112178291,249,20,164,16.1,65.9,0.74
CpG: 59,chr12,112510772,112511271,499,59,341,23.6,68.3,1.02
CpG: 27,chr12,112588782,112589044,262,27,178,20.6,67.9,0.89
CpG: 22,chr12,112600019,112600281,262,22,180,16.8,68.7,0.72
CpG: 48,chr12,112619903,112620380,477,48,323,20.1,67.7,0.88
CpG: 114,chr12,112644426,112645448,1022,114,684,22.3,66.9,1
CpG: 92,chr12,112673671,112674433,762,92,468,24.1,61.4,1.29
CpG: 111,chr12,112678599,112679696,1097,111,663,20.2,60.4,1.11
CpG: 42,chr12,112693471,112693788,317,42,222,26.5,70,1.09
CpG: 20,chr12,112736321,112736591,270,20,174,14.8,64.4,0.72
CpG: 22,chr12,112738786,112739074,288,22,193,15.3,67,0.68
CpG: 56,chr12,112802310,112802821,511,56,376,21.9,73.6,0.82
CpG: 42,chr12,112808849,112809293,444,42,282,18.9,63.5,0.94
CpG: 107,chr12,112828852,112829747,895,107,622,23.9,69.5,0.99
CpG: 38,chr12,112877557,112877897,340,38,248,22.4,72.9,0.86
CpG: 28,chr12,112890460,112890856,396,28,264,14.1,66.7,0.84
CpG: 20,chr12,112909106,112909372,266,20,168,15,63.2,0.75
CpG: 27,chr12,112913417,112913783,366,27,242,14.8,66.1,0.68
CpG: 19,chr12,112920278,112920547,269,19,167,14.1,62.1,0.73
CpG: 171,chr12,112928400,112929942,1542,171,939,22.2,60.9,1.2
CpG: 29,chr12,112941836,112942123,287,29,167,20.2,58.2,1.23
CpG: 54,chr12,112950185,112950690,505,54,347,21.4,68.7,0.91
CpG: 68,chr12,112976414,112976978,564,68,413,24.1,73.2,0.9
CpG: 135,chr12,112999866,113000936,1070,135,732,25.2,68.4,1.08
CpG: 77,chr12,113014095,113015060,965,77,504,16,52.2,1.17
CpG: 21,chr12,113098723,113099001,278,21,186,15.1,66.9,0.7
CpG: 87,chr12,113140050,113141002,952,87,576,18.3,60.5,1
CpG: 23,chr12,113151930,113152237,307,23,204,15,66.4,0.68
CpG: 57,chr12,113155977,113156611,634,57,426,18,67.2,0.8
CpG: 119,chr12,113187654,113189171,1517,119,954,15.7,62.9,0.79
CpG: 32,chr12,114378886,114379215,329,32,216,19.5,65.7,0.9
CpG: 27,chr12,116047741,116048005,264,27,175,20.5,66.3,0.98
CpG: 31,chr12,116077685,116077984,299,31,213,20.7,71.2,0.85
CpG: 36,chr12,116262812,116263097,285,36,212,25.3,74.4,0.93
CpG: 117,chr12,116280639,116281851,1212,117,848,19.3,70,0.79
CpG: 63,chr12,116405180,116405776,596,63,410,21.1,68.8,0.95
CpG: 74,chr12,116485731,116486504,773,74,500,19.1,64.7,0.92
CpG: 41,chr12,117153900,117154247,347,41,250,23.6,72,0.91
CpG: 91,chr12,117533752,117534427,675,91,491,27,72.7,1.02
CpG: 86,chr12,117843434,117844257,823,86,586,20.9,71.2,0.82
CpG: 43,chr12,118198504,118199025,521,43,348,16.5,66.8,0.74
CpG: 128,chr12,118301131,118302632,1501,128,971,17.1,64.7,0.82
CpG: 64,chr12,118836524,118837186,662,64,450,19.3,68,0.84
CpG: 22,chr12,118843094,118843351,257,22,170,17.1,66.1,0.78
CpG: 45,chr12,118846728,118847223,495,45,288,18.2,58.2,1.15
CpG: 146,chr12,118848513,118849904,1391,146,904,21,65,1
CpG: 23,chr12,119237786,119238102,316,23,200,14.6,63.3,0.73
CpG: 87,chr13,17694572,17695766,1194,87,650,14.6,54.4,1
CpG: 58,chr13,81657636,81658147,511,58,328,22.7,64.2,1.11
CpG: 226,chr13,3358212,3361343,3131,226,1947,14.4,62.2,0.75
CpG: 33,chr13,3478175,3478490,315,33,212,21,67.3,0.95
CpG: 82,chr13,3537576,3538596,1020,82,588,16.1,57.6,0.97
CpG: 90,chr13,3610510,3611307,797,90,547,22.6,68.6,0.97
CpG: 38,chr13,3633944,3634416,472,38,304,16.1,64.4,0.79
CpG: 24,chr13,3893449,3893682,233,24,164,20.6,70.4,0.83
CpG: 48,chr13,3917723,3918274,551,48,375,17.4,68.1,0.76
CpG: 73,chr13,5861051,5861902,851,73,523,17.2,61.5,0.91
CpG: 30,chr13,6547941,6548275,334,30,215,18,64.4,0.89
CpG: 28,chr13,6648513,6648846,333,28,225,16.8,67.6,0.74
CpG: 56,chr13,8870777,8871471,694,56,419,16.1,60.4,0.91
CpG: 27,chr13,8885656,8885937,281,27,186,19.2,66.2,0.89
CpG: 58,chr13,8995785,8996419,634,58,410,18.3,64.7,0.88
CpG: 86,chr13,9093439,9094271,832,86,499,20.7,60,1.15
CpG: 21,chr13,9094460,9094725,265,21,152,15.8,57.4,0.97
CpG: 52,chr13,9276405,9276691,286,52,233,36.4,81.5,1.1
CpG: 123,chr13,9763792,9765350,1558,123,809,15.8,51.9,1.18
CpG: 59,chr13,10360202,10360659,457,59,331,25.8,72.4,0.99
CpG: 99,chr13,12105934,12107026,1092,99,697,18.1,63.8,0.9
CpG: 60,chr13,12257660,12258283,623,60,397,19.3,63.7,0.95
CpG: 25,chr13,12395483,12395805,322,25,193,15.5,59.9,0.89
CpG: 42,chr13,12461219,12461571,352,42,241,23.9,68.5,1.02
CpG: 28,chr13,12520170,12520523,353,28,224,15.9,63.5,0.79
CpG: 64,chr13,12565826,12566382,556,64,383,23,68.9,0.99
CpG: 89,chr13,12649830,12650773,943,89,622,18.9,66,0.87
CpG: 57,chr13,12702081,12702878,797,57,506,14.3,63.5,0.72
CpG: 28,chr13,13232706,13232961,255,28,170,22,66.7,0.99
CpG: 89,chr13,13393039,13393980,941,89,620,18.9,65.9,0.87
CpG: 58,chr13,13437421,13438218,797,58,508,14.6,63.7,0.73
CpG: 80,chr13,13590248,13591004,756,80,531,21.2,70.2,0.87
CpG: 101,chr13,13783981,13784944,963,101,671,21,69.7,0.87
CpG: 114,chr13,13953979,13955217,1238,114,808,18.4,65.3,0.87
CpG: 28,chr13,14039386,14039784,398,28,235,14.1,59,0.82
CpG: 152,chr13,14062996,14064859,1863,152,1133,16.3,60.8,0.88
CpG: 41,chr13,14612964,14613509,545,41,324,15,59.4,0.85
CpG: 161,chr13,15462833,15464498,1665,161,1052,19.3,63.2,0.98
CpG: 287,chr13,17803342,17805807,2465,287,1632,23.3,66.2,1.06
CpG: 73,chr13,17943717,17944457,740,73,427,19.7,57.7,1.19
CpG: 43,chr13,17993052,17993423,371,43,253,23.2,68.2,1
CpG: 59,chr13,18948372,18949027,655,59,442,18,67.5,0.79
CpG: 48,chr13,19395455,19395957,502,48,345,19.1,68.7,0.81
CpG: 42,chr13,19619241,19619765,524,42,360,16,68.7,0.68
CpG: 24,chr13,19623025,19623283,258,24,175,18.6,67.8,0.83
CpG: 24,chr13,19995711,19995920,209,24,136,23,65.1,1.09
CpG: 134,chr13,20090379,20091658,1279,134,843,21,65.9,1
CpG: 135,chr13,21179978,21181148,1170,135,848,23.1,72.5,0.88
CpG: 23,chr13,21200463,21200674,211,23,135,21.8,64,1.07
CpG: 21,chr13,21362790,21363031,241,21,166,17.4,68.9,0.74
CpG: 29,chr13,21402452,21402738,286,29,191,20.3,66.8,0.93
CpG: 22,chr13,21440747,21441039,292,22,160,15.1,54.8,1
CpG: 45,chr13,21468195,21468632,437,45,285,20.6,65.2,0.97
CpG: 38,chr13,21530756,21531091,335,38,231,22.7,69,0.95
CpG: 86,chr13,21715804,21716743,939,86,560,18.3,59.6,1.03
CpG: 45,chr13,21717647,21718055,408,45,276,22.1,67.6,0.97
CpG: 81,chr13,21721497,21722451,954,81,553,17,58,1.01
CpG: 49,chr13,21734968,21735415,447,49,291,21.9,65.1,1.04
CpG: 44,chr13,21750201,21750626,425,44,274,20.7,64.5,1
CpG: 38,chr13,21753505,21753794,289,38,206,26.3,71.3,1.04
CpG: 34,chr13,21754133,21754461,328,34,209,20.7,63.7,1.02
CpG: 27,chr13,21780385,21780713,328,27,190,16.5,57.9,0.98
CpG: 44,chr13,21782962,21783364,402,44,272,21.9,67.7,0.96
CpG: 93,chr13,21786854,21787853,999,93,601,18.6,60.2,1.03
CpG: 92,chr13,21809816,21810788,972,92,602,18.9,61.9,0.99
CpG: 35,chr13,21811824,21812090,266,35,178,26.3,66.9,1.18
CpG: 35,chr13,21831851,21832117,266,35,178,26.3,66.9,1.18
CpG: 92,chr13,21833153,21834125,972,92,602,18.9,61.9,0.99
CpG: 27,chr13,21945044,21945334,290,27,188,18.6,64.8,0.9
CpG: 56,chr13,21981189,21981771,582,56,391,19.2,67.2,0.86
CpG: 44,chr13,22005885,22006300,415,44,280,21.2,67.5,0.93
CpG: 37,chr13,22006797,22007257,460,37,298,16.1,64.8,0.77
CpG: 85,chr13,22035230,22036225,995,85,591,17.1,59.4,0.97
CpG: 44,chr13,22041016,22041460,444,44,279,19.8,62.8,1.01
CpG: 88,chr13,22042605,22043584,979,88,587,18,60,1
CpG: 35,chr13,22050952,22051408,456,35,268,15.4,58.8,0.9
CpG: 49,chr13,23368894,23369417,523,49,342,18.7,65.4,0.88
CpG: 58,chr13,23395742,23396575,833,58,448,13.9,53.8,0.96
CpG: 38,chr13,23423504,23423926,422,38,260,18,61.6,0.97
CpG: 36,chr13,23445655,23445985,330,36,217,21.8,65.8,1.01
CpG: 34,chr13,23464124,23464494,370,34,216,18.4,58.4,1.09
CpG: 60,chr13,23531123,23531812,689,60,382,17.4,55.4,1.14
CpG: 41,chr13,23533919,23534232,313,41,225,26.2,71.9,1.01
CpG: 58,chr13,23535285,23535842,557,58,355,20.8,63.7,1.03
CpG: 30,chr13,23543013,23543275,262,30,168,22.9,64.1,1.12
CpG: 49,chr13,23544490,23544932,442,49,290,22.2,65.6,1.04
CpG: 35,chr13,23551336,23551602,266,35,174,26.3,65.4,1.24
CpG: 50,chr13,23554952,23555591,639,50,398,15.6,62.3,0.81
CpG: 61,chr13,23561917,23562523,606,61,382,20.1,63,1.03
CpG: 81,chr13,23570786,23571771,985,81,570,16.4,57.9,0.98
CpG: 84,chr13,23573851,23574792,941,84,567,17.9,60.3,0.98
CpG: 45,chr13,23575807,23576209,402,45,272,22.4,67.7,0.98
CpG: 36,chr13,23581610,23581916,306,36,198,23.5,64.7,1.12
CpG: 23,chr13,23585008,23585335,327,23,170,14.1,52,1.04
CpG: 29,chr13,23585617,23585879,262,29,168,22.1,64.1,1.08
CpG: 59,chr13,23622097,23622643,546,59,371,21.6,67.9,0.94
CpG: 84,chr13,23683595,23684586,991,84,590,17,59.5,0.96
CpG: 36,chr13,23698123,23698408,285,36,182,25.3,63.9,1.24
CpG: 57,chr13,23738708,23739340,632,57,416,18,65.8,0.83
CpG: 45,chr13,23745100,23745491,391,45,264,23,67.5,1.02
CpG: 31,chr13,23746235,23746476,241,31,168,25.7,69.7,1.06
CpG: 30,chr13,23746881,23747149,268,30,172,22.4,64.2,1.09
CpG: 42,chr13,23751125,23751454,329,42,232,25.5,70.5,1.03
CpG: 45,chr13,23752385,23752774,389,45,263,23.1,67.6,1.02
CpG: 35,chr13,23757029,23757324,295,35,196,23.7,66.4,1.08
CpG: 137,chr13,23760850,23762347,1497,137,888,18.3,59.3,1.04
CpG: 21,chr13,23763720,23763936,216,21,135,19.4,62.5,1
CpG: 98,chr13,24280420,24281398,978,98,634,20,64.8,0.95
CpG: 27,chr13,24638734,24638949,215,27,152,25.1,70.7,1.03
CpG: 64,chr13,24761559,24762170,611,64,408,20.9,66.8,0.97
CpG: 85,chr13,24801093,24801950,857,85,508,19.8,59.3,1.13
CpG: 19,chr13,24802079,24802349,270,19,165,14.1,61.1,0.76
CpG: 97,chr13,24831402,24832195,793,97,535,24.5,67.5,1.08
CpG: 26,chr13,24845054,24845340,286,26,193,18.2,67.5,0.82
CpG: 53,chr13,24937222,24937642,420,53,310,25.2,73.8,0.94
CpG: 75,chr13,25019947,25020439,492,75,374,30.5,76,1.06
CpG: 33,chr13,25055183,25055522,339,33,237,19.5,69.9,0.8
CpG: 58,chr13,25055874,25056494,620,58,399,18.7,64.4,0.91
CpG: 177,chr13,28951746,28953465,1719,177,1109,20.6,64.5,0.99
CpG: 35,chr13,28958240,28958627,387,35,242,18.1,62.5,0.93
CpG: 20,chr13,28959592,28959809,217,20,146,18.4,67.3,0.81
CpG: 23,chr13,29855262,29855514,252,23,154,18.3,61.1,0.98
CpG: 172,chr13,29983913,29986187,2274,172,1380,15.1,60.7,0.82
CpG: 48,chr13,30136321,30136780,459,48,341,20.9,74.3,0.76
CpG: 81,chr13,30544890,30545577,687,81,470,23.6,68.4,1.01
CpG: 54,chr13,30659832,30660225,393,54,275,27.5,70,1.13
CpG: 21,chr13,30750569,30750781,212,21,131,19.8,61.8,1.08
CpG: 49,chr13,30973747,30974136,389,49,285,25.2,73.3,0.96
CpG: 240,chr13,31557823,31560098,2275,240,1513,21.1,66.5,0.96
CpG: 21,chr13,31615282,31615489,207,21,137,20.3,66.2,0.93
CpG: 25,chr13,31620182,31620444,262,25,153,19.1,58.4,1.13
CpG: 156,chr13,31625498,31627171,1673,156,1066,18.6,63.7,0.92
CpG: 64,chr13,31629171,31629886,715,64,446,17.9,62.4,0.92
CpG: 54,chr13,31806191,31806991,800,54,416,13.5,52,1.01
CpG: 151,chr13,31807182,31808773,1591,151,1017,19,63.9,0.93
CpG: 87,chr13,31811015,31812000,985,87,615,17.7,62.4,0.91
CpG: 70,chr13,32338259,32338807,548,70,412,25.5,75.2,0.91
CpG: 143,chr13,32801795,32803183,1388,143,894,20.6,64.4,1
CpG: 28,chr13,33935548,33935844,296,28,201,18.9,67.9,0.83
CpG: 90,chr13,34002115,34002961,846,90,570,21.3,67.4,0.94
CpG: 32,chr13,34037570,34037885,315,32,213,20.3,67.6,0.89
CpG: 39,chr13,34077688,34078152,464,39,318,16.8,68.5,0.72
CpG: 20,chr13,34130329,34130556,227,20,150,17.6,66.1,0.82
CpG: 36,chr13,34162935,34163304,369,36,245,19.5,66.4,0.89
CpG: 151,chr13,34344129,34345588,1459,151,983,20.7,67.4,0.91
CpG: 135,chr13,34651951,34653210,1259,135,828,21.4,65.8,1
CpG: 62,chr13,34746830,34747515,685,62,435,18.1,63.5,0.91
CpG: 32,chr13,34874196,34874564,368,32,236,17.4,64.1,0.85
CpG: 83,chr13,34875440,34876142,702,83,485,23.6,69.1,0.99
CpG: 33,chr13,34993732,34994156,424,33,270,15.6,63.7,0.77
CpG: 165,chr13,35740685,35742379,1694,165,1049,19.5,61.9,1.02
CpG: 18,chr13,35906090,35906319,229,18,136,15.7,59.4,0.89
CpG: 102,chr13,35968256,35969565,1309,102,853,15.6,65.2,0.73
CpG: 20,chr13,35991308,35991546,238,20,158,16.8,66.4,0.77
CpG: 71,chr13,36117325,36118001,676,71,465,21,68.8,0.89
CpG: 29,chr13,36578632,36578863,231,29,171,25.1,74,0.92
CpG: 21,chr13,36724627,36724887,260,21,152,16.2,58.5,0.96
CpG: 18,chr13,36726528,36726733,205,18,133,17.6,64.9,0.86
CpG: 27,chr13,36735064,36735286,222,27,151,24.3,68,1.1
CpG: 15,chr13,36736018,36736221,203,15,137,14.8,67.5,0.68
CpG: 75,chr13,37777982,37778987,1005,75,657,14.9,65.4,0.7
CpG: 184,chr13,37825913,37827866,1953,184,1273,18.8,65.2,0.89
CpG: 56,chr13,37857342,37857950,608,56,415,18.4,68.3,0.79
CpG: 26,chr13,37930867,37931184,317,26,205,16.4,64.7,0.79
CpG: 99,chr13,37993603,37994322,719,99,532,27.5,74,1.02
CpG: 59,chr13,38036860,38037571,711,59,447,16.6,62.9,0.84
CpG: 88,chr13,38151113,38151949,836,88,564,21.1,67.5,0.93
CpG: 52,chr13,38204828,38205403,575,52,376,18.1,65.4,0.85
CpG: 157,chr13,38345062,38346755,1693,157,1100,18.5,65,0.88
CpG: 84,chr13,38527875,38528545,670,84,505,25.1,75.4,0.88
CpG: 51,chr13,38634762,38635300,538,51,351,19,65.2,0.89
CpG: 57,chr13,38658549,38659185,636,57,425,17.9,66.8,0.81
CpG: 45,chr13,38960249,38960746,497,45,274,18.1,55.1,1.21
CpG: 29,chr13,40703949,40704191,242,29,168,24,69.4,1
CpG: 22,chr13,40708986,40709271,285,22,160,15.4,56.1,1.01
CpG: 55,chr13,40722806,40723395,589,55,356,18.7,60.4,1.02
CpG: 39,chr13,40728309,40728773,464,39,312,16.8,67.2,0.78
CpG: 143,chr13,40730163,40731844,1681,143,931,17,55.4,1.11
CpG: 26,chr13,40733526,40733807,281,26,170,18.5,60.5,1.04
CpG: 30,chr13,40737839,40738229,390,30,274,15.4,70.3,0.65
CpG: 19,chr13,41000470,41000686,216,19,144,17.6,66.7,0.79
CpG: 54,chr13,41000940,41001477,537,54,361,20.1,67.2,0.89
CpG: 37,chr13,41016245,41016635,390,37,243,19,62.3,0.99
CpG: 48,chr13,41079329,41079760,431,48,306,22.3,71,0.9
CpG: 40,chr13,41220155,41220393,238,40,189,33.6,79.4,1.08
CpG: 88,chr13,41249657,41250485,828,88,584,21.3,70.5,0.86
CpG: 29,chr13,41358794,41359175,381,29,225,15.2,59.1,0.88
CpG: 114,chr13,41605447,41606526,1079,114,680,21.1,63,1.06
CpG: 36,chr13,42049428,42049761,333,36,249,21.6,74.8,0.87
CpG: 109,chr13,42051762,42052794,1032,109,649,21.1,62.9,1.07
CpG: 26,chr13,42094886,42095313,427,26,277,12.2,64.9,0.62
CpG: 67,chr13,42916313,42916984,671,67,443,20,66,0.92
CpG: 49,chr13,43171283,43171787,504,49,321,19.4,63.7,0.96
CpG: 22,chr13,43200461,43200754,293,22,188,15,64.2,0.73
CpG: 20,chr13,43200971,43201218,247,20,155,16.2,62.8,0.83
CpG: 132,chr13,43303259,43304447,1188,132,838,22.2,70.5,0.91
CpG: 24,chr13,43365435,43365643,208,24,154,23.1,74,0.84
CpG: 76,chr13,43398213,43398833,620,76,426,24.5,68.7,1.04
CpG: 103,chr13,43559641,43560309,668,103,513,30.8,76.8,1.05
CpG: 58,chr13,43615827,43616295,468,58,348,24.8,74.4,0.9
CpG: 53,chr13,43784970,43785437,467,53,318,22.7,68.1,0.98
CpG: 39,chr13,43864470,43864931,461,39,317,16.9,68.8,0.72
CpG: 160,chr13,44729660,44731359,1699,160,1077,18.8,63.4,0.95
CpG: 62,chr13,44733418,44734107,689,62,456,18,66.2,0.83
CpG: 30,chr13,44902779,44903193,414,30,252,14.5,60.9,0.78
CpG: 70,chr13,45001613,45002231,618,70,384,22.7,62.1,1.17
CpG: 55,chr13,45078550,45079118,568,55,372,19.4,65.5,0.91
CpG: 92,chr13,45389464,45390447,983,92,686,18.7,69.8,0.8
CpG: 46,chr13,45507386,45507769,383,46,272,24,71,0.95
CpG: 15,chr13,45568236,45568439,203,15,136,14.8,67,0.66
CpG: 164,chr13,45963397,45965460,2063,164,1211,15.9,58.7,0.92
CpG: 19,chr13,45965936,45966195,259,19,161,14.7,62.2,0.77
CpG: 82,chr13,46418124,46419208,1084,82,627,15.1,57.8,0.91
CpG: 108,chr13,46669263,46670275,1012,108,618,21.3,61.1,1.15
CpG: 137,chr13,46726811,46728212,1401,137,885,19.6,63.2,0.98
CpG: 19,chr13,46771211,46771472,261,19,155,14.6,59.4,0.85
CpG: 116,chr13,46929348,46930615,1267,116,767,18.3,60.5,1
CpG: 25,chr13,47010853,47011096,243,25,163,20.6,67.1,0.93
CpG: 72,chr13,47014190,47014946,756,72,482,19,63.8,0.94
CpG: 84,chr13,47043183,47044004,821,84,597,20.5,72.7,0.77
CpG: 130,chr13,47105647,47106704,1057,130,688,24.6,65.1,1.16
CpG: 55,chr13,47122519,47123195,676,55,436,16.3,64.5,0.78
CpG: 37,chr13,48227748,48228087,339,37,240,21.8,70.8,0.87
CpG: 129,chr13,48261040,48262467,1427,129,898,18.1,62.9,0.91
CpG: 21,chr13,48513265,48513487,222,21,142,18.9,64,0.93
CpG: 140,chr13,48545475,48546919,1444,140,965,19.4,66.8,0.87
CpG: 99,chr13,48625241,48626007,766,99,558,25.8,72.8,0.97
CpG: 18,chr13,48659889,48660124,235,18,153,15.3,65.1,0.73
CpG: 53,chr13,48663074,48663631,557,53,346,19,62.1,0.99
CpG: 42,chr13,48665897,48666361,464,42,296,18.1,63.8,0.89
CpG: 34,chr13,48668911,48669325,414,34,276,16.4,66.7,0.79
CpG: 36,chr13,48731445,48731835,390,36,262,18.5,67.2,0.82
CpG: 24,chr13,48732624,48732892,268,24,179,17.9,66.8,0.8
CpG: 51,chr13,48870067,48870547,480,51,324,21.2,67.5,0.95
CpG: 35,chr13,48878572,48878907,335,35,224,20.9,66.9,0.93
CpG: 129,chr13,48967331,48968609,1278,129,785,20.2,61.4,1.07
CpG: 174,chr13,49146510,49148166,1656,174,1139,21,68.8,0.89
CpG: 54,chr13,49187523,49188120,597,54,417,18.1,69.8,0.74
CpG: 89,chr13,49215547,49216388,841,89,574,21.2,68.3,0.95
CpG: 57,chr13,49247724,49248279,555,57,372,20.5,67,0.91
CpG: 69,chr13,49341095,49341943,848,69,504,16.3,59.4,0.93
CpG: 23,chr13,49379582,49379901,319,23,204,14.4,63.9,0.71
CpG: 21,chr13,49383202,49383461,259,21,170,16.2,65.6,0.75
CpG: 75,chr13,49420930,49421765,835,75,560,18,67.1,0.8
CpG: 64,chr13,49652570,49653118,548,64,355,23.4,64.8,1.12
CpG: 20,chr13,49682046,49682296,250,20,155,16,62,0.83
CpG: 28,chr13,50417796,50418121,325,28,221,17.2,68,0.75
CpG: 102,chr13,51100417,51101588,1171,102,626,17.4,53.5,1.22
CpG: 35,chr13,51171306,51171584,278,35,192,25.2,69.1,1.1
CpG: 48,chr13,51202641,51203047,406,48,275,23.6,67.7,1.03
CpG: 38,chr13,51408568,51409090,522,38,334,14.6,64,0.74
CpG: 76,chr13,51566991,51567736,745,76,491,20.4,65.9,0.94
CpG: 25,chr13,51594868,51595203,335,25,220,14.9,65.7,0.78
CpG: 83,chr13,51644876,51645761,885,83,564,18.8,63.7,0.92
CpG: 66,chr13,51651539,51652038,499,66,352,26.5,70.5,1.06
CpG: 89,chr13,51792760,51793703,943,89,655,18.9,69.5,0.8
CpG: 139,chr13,51845657,51847742,2085,139,1226,13.3,58.8,0.78
CpG: 20,chr13,51848024,51848252,228,20,159,17.5,69.7,0.74
CpG: 39,chr13,52530361,52530803,442,39,313,17.6,70.8,0.74
CpG: 60,chr13,52582830,52583565,735,60,431,16.3,58.6,0.95
CpG: 56,chr13,52929307,52929781,474,56,340,23.6,71.7,0.95
CpG: 38,chr13,52978361,52978809,448,38,257,17,57.4,1.03
CpG: 153,chr13,52980186,52981840,1654,153,974,18.5,58.9,1.07
CpG: 23,chr13,53111251,53111503,252,23,162,18.3,64.3,0.89
CpG: 24,chr13,53118692,53118926,234,24,158,20.5,67.5,0.9
CpG: 94,chr13,53285354,53286306,952,94,648,19.7,68.1,0.85
CpG: 38,chr13,53377194,53377494,300,38,214,25.3,71.3,1
CpG: 40,chr13,53462292,53462721,429,40,282,18.6,65.7,0.88
CpG: 69,chr13,53472289,53472899,610,69,421,22.6,69,0.95
CpG: 43,chr13,53475878,53476393,515,43,317,16.7,61.6,0.9
CpG: 51,chr13,54055106,54055780,674,51,452,15.1,67.1,0.69
CpG: 65,chr13,54071718,54072312,594,65,398,21.9,67,1.01
CpG: 29,chr13,54192027,54192345,318,29,215,18.2,67.6,0.81
CpG: 87,chr13,54302674,54303444,770,87,576,22.6,74.8,0.81
CpG: 47,chr13,54371381,54371932,551,47,392,17.1,71.1,0.69
CpG: 54,chr13,54468513,54468952,439,54,303,24.6,69,1.05
CpG: 104,chr13,54503655,54504476,821,104,608,25.3,74.1,0.93
CpG: 47,chr13,54564983,54565451,468,47,323,20.1,69,0.86
CpG: 52,chr13,54574961,54575474,513,52,363,20.3,70.8,0.82
CpG: 18,chr13,54589869,54590073,204,18,116,17.6,56.9,1.15
CpG: 52,chr13,54610998,54611478,480,52,335,21.7,69.8,0.89
CpG: 50,chr13,54621652,54622206,554,50,366,18.1,66.1,0.83
CpG: 107,chr13,54687074,54688361,1287,107,746,16.6,58,0.99
CpG: 98,chr13,54693579,54694399,820,98,599,23.9,73,0.9
CpG: 91,chr13,54737666,54738409,743,91,500,24.5,67.3,1.08
CpG: 89,chr13,54749313,54750035,722,89,480,24.7,66.5,1.13
CpG: 42,chr13,54765863,54766389,526,42,335,16,63.7,0.79
CpG: 73,chr13,54789073,54790023,950,73,648,15.4,68.2,0.68
CpG: 122,chr13,54948690,54950061,1371,122,888,17.8,64.8,0.85
CpG: 43,chr13,54955892,54956276,384,43,271,22.4,70.6,0.9
CpG: 19,chr13,54996366,54996572,206,19,137,18.4,66.5,0.84
CpG: 19,chr13,54997185,54997425,240,19,159,15.8,66.2,0.72
CpG: 62,chr13,55099818,55100253,435,62,319,28.5,73.3,1.07
CpG: 55,chr13,55105183,55105715,532,55,365,20.7,68.6,0.88
CpG: 61,chr13,55152630,55153267,637,61,454,19.2,71.3,0.76
CpG: 24,chr13,55190227,55190550,323,24,204,14.9,63.2,0.75
CpG: 247,chr13,55210005,55212751,2746,247,1856,18,67.6,0.79
CpG: 86,chr13,55321562,55322338,776,86,530,22.2,68.3,0.96
CpG: 19,chr13,55329483,55329691,208,19,140,18.3,67.3,0.82
CpG: 56,chr13,55329913,55330332,419,56,292,26.7,69.7,1.1
CpG: 16,chr13,55351379,55351581,202,16,118,15.8,58.4,0.93
CpG: 61,chr13,55362135,55362965,830,61,523,14.7,63,0.74
CpG: 29,chr13,55414820,55415130,310,29,209,18.7,67.4,0.84
CpG: 19,chr13,55420601,55420832,231,19,150,16.5,64.9,0.78
CpG: 86,chr13,55444654,55445775,1121,86,626,15.3,55.8,0.99
CpG: 81,chr13,55464132,55464876,744,81,538,21.8,72.3,0.84
CpG: 177,chr13,55471445,55473022,1577,177,1128,22.4,71.5,0.89
CpG: 73,chr13,55487321,55488154,833,73,518,17.5,62.2,0.91
CpG: 67,chr13,55512781,55513535,754,67,517,17.8,68.6,0.76
CpG: 67,chr13,55536244,55536886,642,67,405,20.9,63.1,1.06
CpG: 49,chr13,55570702,55571286,584,49,343,16.8,58.7,0.99
CpG: 42,chr13,55593041,55593514,473,42,299,17.8,63.2,0.91
CpG: 20,chr13,55600014,55600221,207,20,135,19.3,65.2,0.92
CpG: 35,chr13,55622935,55623283,348,35,224,20.1,64.4,0.97
CpG: 66,chr13,55634859,55635531,672,66,451,19.6,67.1,0.87
CpG: 98,chr13,55692916,55693717,801,98,517,24.5,64.5,1.19
CpG: 54,chr13,55714590,55715028,438,54,320,24.7,73.1,0.93
CpG: 15,chr13,55717892,55718104,212,15,147,14.2,69.3,0.6
CpG: 44,chr13,55727172,55727548,376,44,233,23.4,62,1.23
CpG: 97,chr13,55825478,55826646,1168,97,738,16.6,63.2,0.84
CpG: 36,chr13,55828355,55828762,407,36,261,17.7,64.1,0.87
CpG: 90,chr13,55830597,55831485,888,90,581,20.3,65.4,0.95
CpG: 17,chr13,55835492,55835739,247,17,141,13.8,57.1,0.85
CpG: 44,chr13,55836019,55836358,339,44,254,26,74.9,0.93
CpG: 115,chr13,56134753,56135783,1030,115,683,22.3,66.3,1.02
CpG: 64,chr13,56221627,56222549,922,64,548,13.9,59.4,0.79
CpG: 118,chr13,56251343,56252536,1193,118,830,19.8,69.6,0.82
CpG: 59,chr13,56258701,56259336,635,59,383,18.6,60.3,1.02
CpG: 81,chr13,56295880,56296643,763,81,530,21.2,69.5,0.89
CpG: 53,chr13,56522227,56522816,589,53,401,18,68.1,0.79
CpG: 36,chr13,56609464,56609917,453,36,311,15.9,68.7,0.67
CpG: 103,chr13,56702856,56703942,1086,103,629,19,57.9,1.14
CpG: 93,chr13,56752957,56753806,849,93,587,21.9,69.1,0.92
CpG: 22,chr13,56887628,56887879,251,22,162,17.5,64.5,0.85
CpG: 87,chr13,57907481,57908451,970,87,659,17.9,67.9,0.78
CpG: 232,chr13,58127275,58129475,2200,232,1269,21.1,57.7,1.28
CpG: 104,chr13,58215251,58216067,816,104,555,25.5,68,1.1
CpG: 161,chr13,58273349,58274853,1504,161,935,21.4,62.2,1.11
CpG: 64,chr13,58358698,58359201,503,64,338,25.4,67.2,1.18
CpG: 78,chr13,58384781,58385404,623,78,440,25,70.6,1.01
CpG: 248,chr13,58401244,58403342,2098,248,1469,23.6,70,0.97
CpG: 60,chr13,58806417,58807080,663,60,420,18.1,63.3,0.9
CpG: 58,chr13,58807912,58808769,857,58,565,13.5,65.9,0.62
CpG: 118,chr13,59556637,59557704,1067,118,652,22.1,61.1,1.19
CpG: 91,chr13,59585157,59585869,712,91,476,25.6,66.9,1.17
CpG: 114,chr13,59769313,59770409,1096,114,719,20.8,65.6,0.97
CpG: 89,chr13,59822525,59823367,842,89,559,21.1,66.4,0.97
CpG: 221,chr13,60175837,60177591,1754,221,1224,25.2,69.8,1.03
CpG: 96,chr13,60601761,60602653,892,96,614,21.5,68.8,0.95
CpG: 44,chr13,61665839,61666101,262,44,203,33.6,77.5,1.12
CpG: 21,chr13,62812921,62813140,219,21,114,19.2,52.1,1.49
CpG: 18,chr13,62887831,62888039,208,18,128,17.3,61.5,0.91
CpG: 38,chr13,62964732,62965237,505,38,314,15,62.2,0.79
CpG: 27,chr13,63240027,63240320,293,27,184,18.4,62.8,0.95
CpG: 41,chr13,63431481,63431843,362,41,233,22.7,64.4,1.09
CpG: 227,chr13,63563240,63566182,2942,227,1839,15.4,62.5,0.79
CpG: 66,chr13,63567807,63568358,551,66,385,24,69.9,1
CpG: 68,chr13,63572424,63573149,725,68,494,18.8,68.1,0.82
CpG: 27,chr13,63573396,63573732,336,27,220,16.1,65.5,0.75
CpG: 71,chr13,63815109,63815669,560,71,380,25.4,67.9,1.1
CpG: 136,chr13,64152403,64153554,1151,136,759,23.6,65.9,1.09
CpG: 77,chr13,64161748,64162409,661,77,435,23.3,65.8,1.08
CpG: 153,chr13,64273916,64275619,1703,153,1075,18,63.1,0.9
CpG: 59,chr13,64312395,64312852,457,59,340,25.8,74.4,0.93
CpG: 53,chr13,64369856,64370443,587,53,392,18.1,66.8,0.81
CpG: 47,chr13,64432348,64432883,535,47,329,17.6,61.5,0.93
CpG: 55,chr13,65112511,65113001,490,55,335,22.4,68.4,0.96
CpG: 34,chr13,65175897,65176247,350,34,233,19.4,66.6,0.88
CpG: 143,chr13,65240832,65242629,1797,143,1120,15.9,62.3,0.82
CpG: 19,chr13,65257355,65257582,227,19,161,16.7,70.9,0.68
CpG: 37,chr13,65259084,65259501,417,37,264,17.7,63.3,0.89
CpG: 22,chr13,65259751,65260060,309,22,208,14.2,67.3,0.64
CpG: 31,chr13,65278714,65279062,348,31,206,17.8,59.2,1.02
CpG: 48,chr13,65351764,65352304,540,48,373,17.8,69.1,0.77
CpG: 54,chr13,65420135,65420795,660,54,445,16.4,67.4,0.73
CpG: 53,chr13,65562705,65563351,646,53,442,16.4,68.4,0.71
CpG: 50,chr13,65726282,65726919,637,50,430,15.7,67.5,0.71
CpG: 43,chr13,65890420,65890884,464,43,314,18.5,67.7,0.81
CpG: 31,chr13,66007607,66007843,236,31,167,26.3,70.8,1.06
CpG: 48,chr13,66199438,66200066,628,48,424,15.3,67.5,0.69
CpG: 49,chr13,66247774,66248411,637,49,429,15.4,67.3,0.7
CpG: 51,chr13,66807515,66808148,633,51,428,16.1,67.6,0.73
CpG: 43,chr13,66868393,66868857,464,43,314,18.5,67.7,0.81
CpG: 87,chr13,66932700,66933520,820,87,553,21.2,67.4,0.93
CpG: 21,chr13,67060993,67061258,265,21,164,15.8,61.9,0.86
CpG: 25,chr13,67552939,67553199,260,25,165,19.2,63.5,0.98
CpG: 18,chr13,67813843,67814098,255,18,159,14.1,62.4,0.78
CpG: 85,chr13,68581859,68582608,749,85,500,22.7,66.8,1.03
CpG: 75,chr13,68998747,68999463,716,75,494,20.9,69,0.88
CpG: 192,chr13,69533424,69535192,1768,192,987,21.7,55.8,1.4
CpG: 111,chr13,69610925,69612270,1345,111,833,16.5,61.9,0.86
CpG: 150,chr13,69738588,69740070,1482,150,920,20.2,62.1,1.05
CpG: 37,chr13,69809840,69810221,381,37,260,19.4,68.2,0.85
CpG: 64,chr13,70637317,70637905,588,64,418,21.8,71.1,0.87
CpG: 77,chr13,71959354,71960256,902,77,572,17.1,63.4,0.86
CpG: 122,chr13,71962779,71964032,1253,122,788,19.5,62.9,0.99
CpG: 25,chr13,72624105,72624421,316,25,199,15.8,63,0.81
CpG: 288,chr13,72628317,72631991,3674,288,2234,15.7,60.8,0.85
CpG: 91,chr13,73260358,73261147,789,91,524,23.1,66.4,1.05
CpG: 32,chr13,73263049,73263497,448,32,256,14.3,57.1,0.88
CpG: 16,chr13,73264390,73264601,211,16,124,15.2,58.8,0.88
CpG: 18,chr13,73268476,73268710,234,18,151,15.4,64.5,0.75
CpG: 36,chr13,73271873,73272236,363,36,216,19.8,59.5,1.12
CpG: 35,chr13,73328251,73328608,357,35,233,19.6,65.3,0.92
CpG: 45,chr13,73330957,73331558,601,45,393,15,65.4,0.7
CpG: 50,chr13,73467150,73467678,528,50,317,18.9,60,1.07
CpG: 66,chr13,73603788,73604438,650,66,399,20.3,61.4,1.08
CpG: 29,chr13,73626854,73627172,318,29,211,18.2,66.4,0.84
CpG: 46,chr13,73763572,73763966,394,46,280,23.4,71.1,0.93
CpG: 95,chr13,73846882,73847698,816,95,584,23.3,71.6,0.92
CpG: 79,chr13,73937344,73938037,693,79,470,22.8,67.8,0.99
CpG: 100,chr13,74009107,74010403,1296,100,829,15.4,64,0.76
CpG: 37,chr13,74061992,74062372,380,37,263,19.5,69.2,0.82
CpG: 35,chr13,74121112,74121525,413,35,277,16.9,67.1,0.77
CpG: 21,chr13,74166889,74167109,220,21,148,19.1,67.3,0.9
CpG: 30,chr13,74208465,74208779,314,30,209,19.1,66.6,0.87
CpG: 27,chr13,74259940,74260238,298,27,198,18.1,66.4,0.84
CpG: 21,chr13,74292231,74292439,208,21,147,20.2,70.7,0.81
CpG: 27,chr13,74317304,74317657,353,27,210,15.3,59.5,0.87
CpG: 50,chr13,74349907,74350364,457,50,299,21.9,65.4,1.04
CpG: 33,chr13,74406450,74406830,380,33,231,17.4,60.8,0.95
CpG: 34,chr13,74639824,74640171,347,34,248,19.6,71.5,0.78
CpG: 27,chr13,74808354,74808612,258,27,179,20.9,69.4,0.89
CpG: 140,chr13,75707246,75708619,1373,140,930,20.4,67.7,0.91
CpG: 109,chr13,75943185,75943983,798,109,590,27.3,73.9,1
CpG: 40,chr13,76018288,76018759,471,40,300,17,63.7,0.84
CpG: 90,chr13,76055567,76056709,1142,90,761,15.8,66.6,0.71
CpG: 105,chr13,76384089,76385275,1186,105,818,17.7,69,0.75
CpG: 64,chr13,77135036,77135623,587,64,392,21.8,66.8,0.99
CpG: 31,chr13,77708636,77708971,335,31,220,18.5,65.7,0.86
CpG: 83,chr13,78163268,78163974,706,83,488,23.5,69.1,0.99
CpG: 28,chr13,78179318,78179663,345,28,234,16.2,67.8,0.72
CpG: 20,chr13,78181213,78181415,202,20,116,19.8,57.4,1.2
CpG: 64,chr13,78194876,78195573,697,64,467,18.4,67,0.82
CpG: 131,chr13,78198238,78199754,1516,131,835,17.3,55.1,1.14
CpG: 51,chr13,78203138,78203691,553,51,358,18.4,64.7,0.9
CpG: 33,chr13,80883029,80883352,323,33,177,20.4,54.8,1.36
CpG: 84,chr13,80885428,80886411,983,84,604,17.1,61.4,0.91
CpG: 34,chr13,80962886,80963146,260,34,193,26.2,74.2,0.96
CpG: 26,chr13,81064633,81064852,219,26,142,23.7,64.8,1.13
CpG: 27,chr13,81632823,81633145,322,27,217,16.8,67.4,0.85
CpG: 82,chr13,81710936,81711912,976,82,634,16.8,65,0.8
CpG: 81,chr13,81782996,81783976,980,81,589,16.5,60.1,0.92
CpG: 27,chr13,83523648,83523957,309,27,199,17.5,64.4,0.88
CpG: 29,chr13,83720866,83721244,378,29,249,15.3,65.9,0.72
CpG: 67,chr13,83730779,83731521,742,67,464,18.1,62.5,0.93
CpG: 33,chr13,83745071,83745334,263,33,188,25.1,71.5,0.99
CpG: 27,chr13,84222045,84222352,307,27,183,17.6,59.6,1.01
CpG: 42,chr13,85189330,85189666,336,42,228,25,67.9,1.09
CpG: 107,chr13,85288517,85289675,1158,107,695,18.5,60,1.03
CpG: 49,chr13,86046277,86046895,618,49,380,15.9,61.5,0.85
CpG: 41,chr13,88821490,88821969,479,41,315,17.1,65.8,0.81
CpG: 32,chr13,89739366,89739817,451,32,277,14.2,61.4,0.76
CpG: 20,chr13,89742137,89742400,263,20,163,15.2,62,0.8
CpG: 51,chr13,90089535,90090032,497,51,332,20.5,66.8,0.93
CpG: 49,chr13,90923074,90923635,561,49,359,17.5,64,0.87
CpG: 44,chr13,91223793,91224289,496,44,319,17.7,64.3,0.86
CpG: 150,chr13,91460384,91462219,1835,150,963,16.3,52.5,1.21
CpG: 26,chr13,91741439,91741695,256,26,185,20.3,72.3,0.79
CpG: 46,chr13,91807249,91807719,470,46,318,19.6,67.7,0.87
CpG: 80,chr13,92131220,92131980,760,80,516,21.1,67.9,0.91
CpG: 78,chr13,92354704,92355478,774,78,506,20.2,65.4,0.95
CpG: 142,chr13,92425853,92427042,1189,142,864,23.9,72.7,0.91
CpG: 93,chr13,92530435,92531395,960,93,607,19.4,63.2,0.97
CpG: 87,chr13,92610599,92611514,915,87,607,19,66.3,0.89
CpG: 28,chr13,92794706,92794986,280,28,186,20,66.4,0.95
CpG: 38,chr13,92844706,92845098,392,38,286,19.4,73,0.73
CpG: 36,chr13,93192225,93192629,404,36,261,17.8,64.6,0.87
CpG: 136,chr13,93303526,93304637,1111,136,788,24.5,70.9,0.98
CpG: 163,chr13,93498263,93499789,1526,163,1015,21.4,66.5,0.97
CpG: 27,chr13,93674272,93674553,281,27,174,19.2,61.9,1
CpG: 46,chr13,93771714,93772156,442,46,282,20.8,63.8,1.02
CpG: 68,chr13,94057450,94058115,665,68,438,20.5,65.9,0.95
CpG: 38,chr13,94174104,94174682,578,38,345,13.1,59.7,0.74
CpG: 108,chr13,94284886,94285843,957,108,645,22.6,67.4,1
CpG: 99,chr13,94358367,94359414,1047,99,684,18.9,65.3,0.89
CpG: 26,chr13,94595964,94596226,262,26,190,19.8,72.5,0.76
CpG: 47,chr13,94702605,94703017,412,47,278,22.8,67.5,1
CpG: 23,chr13,94710455,94710656,201,23,141,22.9,70.1,0.94
CpG: 73,chr13,94788817,94789373,556,73,414,26.3,74.5,0.95
CpG: 34,chr13,94868576,94868895,319,34,238,21.3,74.6,0.77
CpG: 29,chr13,94873666,94873924,258,29,188,22.5,72.9,0.86
CpG: 19,chr13,94875360,94875562,202,19,151,18.8,74.8,0.68
CpG: 39,chr13,94876988,94877530,542,39,355,14.4,65.5,0.67
CpG: 219,chr13,94882780,94886009,3229,219,1808,13.6,56,0.87
CpG: 50,chr13,94976247,94976587,340,50,253,29.4,74.4,1.07
CpG: 72,chr13,95222399,95223076,677,72,461,21.3,68.1,0.92
CpG: 65,chr13,95324974,95325632,658,65,429,19.8,65.2,0.94
CpG: 34,chr13,95336130,95336545,415,34,290,16.4,69.9,0.67
CpG: 81,chr13,95374831,95375441,610,81,438,26.6,71.8,1.03
CpG: 78,chr13,95524298,95525435,1137,78,711,13.7,62.5,0.7
CpG: 51,chr13,95604059,95604766,707,51,414,14.4,58.6,0.85
CpG: 61,chr13,95617986,95618798,812,61,519,15,63.9,0.74
CpG: 66,chr13,95891566,95892117,551,66,376,24,68.2,1.06
CpG: 16,chr13,95961237,95961458,221,16,134,14.5,60.6,0.8
CpG: 28,chr13,96131116,96131402,286,28,201,19.6,70.3,0.84
CpG: 46,chr13,96132369,96132813,444,46,309,20.7,69.6,0.86
CpG: 26,chr13,96542283,96542625,342,26,215,15.2,62.9,0.79
CpG: 57,chr13,96542873,96543417,544,57,371,21,68.2,0.91
CpG: 95,chr13,96670359,96671269,910,95,621,20.9,68.2,0.91
CpG: 20,chr13,96748199,96748403,204,20,141,19.6,69.1,0.89
CpG: 91,chr13,96924497,96925446,949,91,646,19.2,68.1,0.83
CpG: 119,chr13,97071234,97072327,1093,119,638,21.8,58.4,1.28
CpG: 49,chr13,97137669,97138266,597,49,371,16.4,62.1,0.85
CpG: 42,chr13,97198025,97198480,455,42,306,18.5,67.3,0.82
CpG: 111,chr13,97240816,97241892,1076,111,750,20.6,69.7,0.86
CpG: 69,chr13,98205787,98206478,691,69,510,20,73.8,0.75
CpG: 68,chr13,98262848,98263491,643,68,408,21.2,63.5,1.05
CpG: 70,chr13,98316616,98317173,557,70,391,25.1,70.2,1.02
CpG: 201,chr13,98354262,98356159,1897,201,1108,21.2,58.4,1.26
CpG: 72,chr13,98365821,98366560,739,72,490,19.5,66.3,0.89
CpG: 46,chr13,98391125,98391548,423,46,261,21.7,61.7,1.15
CpG: 20,chr13,98502955,98503214,259,20,148,15.4,57.1,0.95
CpG: 24,chr13,98504157,98504424,267,24,172,18,64.4,0.87
CpG: 62,chr13,98572661,98573442,781,62,485,15.9,62.1,0.82
CpG: 18,chr13,98573974,98574214,240,18,146,15,60.8,0.81
CpG: 36,chr13,98588933,98589306,373,36,257,19.3,68.9,0.81
CpG: 26,chr13,98613240,98613489,249,26,170,20.9,68.3,0.9
CpG: 35,chr13,98694849,98695186,337,35,247,20.8,73.3,0.79
CpG: 129,chr13,98814432,98815475,1043,129,705,24.7,67.6,1.09
CpG: 40,chr13,98890838,98891237,399,40,240,20.1,60.2,1.13
CpG: 125,chr13,98925741,98926826,1085,125,761,23,70.1,0.94
CpG: 42,chr13,99344426,99344872,446,42,306,18.8,68.6,0.8
CpG: 123,chr13,99514930,99516695,1765,123,1105,13.9,62.6,0.71
CpG: 39,chr13,99900454,99900895,441,39,295,17.7,66.9,0.8
CpG: 36,chr13,100015330,100015811,481,36,316,15,65.7,0.69
CpG: 47,chr13,100103694,100104168,474,47,322,19.8,67.9,0.88
CpG: 70,chr13,100107957,100108478,521,70,386,26.9,74.1,1.02
CpG: 34,chr13,100124808,100125087,279,34,198,24.4,71,0.98
CpG: 54,chr13,100492017,100492654,637,54,409,17,64.2,0.85
CpG: 105,chr13,100551632,100552839,1207,105,809,17.4,67,0.78
CpG: 59,chr13,100616515,100617016,501,59,339,23.6,67.7,1.04
CpG: 108,chr13,100650928,100651791,863,108,611,25,70.8,1.01
CpG: 27,chr13,100669718,100669952,234,27,165,23.1,70.5,0.95
CpG: 29,chr13,100730712,100731055,343,29,222,16.9,64.7,0.83
CpG: 44,chr13,100744138,100744607,469,44,311,18.8,66.3,0.87
CpG: 39,chr13,100775445,100775972,527,39,337,14.8,63.9,0.74
CpG: 46,chr13,100786288,100786735,447,46,302,20.6,67.6,0.92
CpG: 17,chr13,100832665,100832908,243,17,132,14,54.3,0.95
CpG: 71,chr13,100832975,100833553,578,71,401,24.6,69.4,1.04
CpG: 30,chr13,101694497,101694738,241,30,176,24.9,73,0.94
CpG: 114,chr13,101767253,101768516,1263,114,842,18.1,66.7,0.81
CpG: 121,chr13,103333880,103334916,1036,121,713,23.4,68.8,0.99
CpG: 37,chr13,103592627,103593009,382,37,271,19.4,70.9,0.77
CpG: 101,chr13,103773833,103774725,892,101,596,22.6,66.8,1.02
CpG: 130,chr13,103920317,103921809,1492,130,765,17.4,51.3,1.33
CpG: 56,chr13,104109350,104110032,682,56,400,16.4,58.7,0.96
CpG: 37,chr13,104178699,104179120,421,37,278,17.6,66,0.81
CpG: 63,chr13,104228524,104229200,676,63,415,18.6,61.4,0.99
CpG: 25,chr13,104817028,104817334,306,25,182,16.3,59.5,0.92
CpG: 26,chr13,104863566,104863806,240,26,165,21.7,68.8,0.92
CpG: 80,chr13,105054060,105054878,818,80,533,19.6,65.2,0.93
CpG: 69,chr13,105293968,105294519,551,69,371,25,67.3,1.11
CpG: 43,chr13,105444636,105445143,507,43,314,17,61.9,0.88
CpG: 74,chr13,106936553,106937164,611,74,416,24.2,68.1,1.05
CpG: 53,chr13,106946998,106947538,540,53,368,19.6,68.1,0.85
CpG: 119,chr13,107021683,107022715,1032,119,594,23.1,57.6,1.39
CpG: 25,chr13,107645283,107645600,317,25,210,15.8,66.2,0.72
CpG: 309,chr13,107888547,107891460,2913,309,1821,21.2,62.5,1.09
CpG: 57,chr13,108044085,108044666,581,57,372,19.6,64,0.96
CpG: 72,chr13,108158157,108159000,843,72,542,17.1,64.3,0.83
CpG: 86,chr13,108214190,108215029,839,86,614,20.5,73.2,0.77
CpG: 67,chr13,108316088,108316732,644,67,428,20.8,66.5,0.94
CpG: 50,chr13,109116426,109117027,601,50,365,16.6,60.7,0.9
CpG: 96,chr13,109902499,109903358,859,96,542,22.4,63.1,1.12
CpG: 98,chr13,110394608,110395616,1008,98,694,19.4,68.8,0.82
CpG: 176,chr13,111488769,111490745,1976,176,1045,17.8,52.9,1.27
CpG: 159,chr13,111685810,111687761,1951,159,1112,16.3,57,1.01
CpG: 79,chr13,111724877,111725939,1062,79,667,14.9,62.8,0.76
CpG: 23,chr13,111748762,111749041,279,23,167,16.5,59.9,0.92
CpG: 20,chr13,111755265,111755501,236,20,132,16.9,55.9,1.09
CpG: 154,chr13,111807772,111809469,1697,154,877,18.1,51.7,1.36
CpG: 20,chr13,111977845,111978120,275,20,163,14.5,59.3,0.83
CpG: 94,chr13,112463722,112464553,831,94,594,22.6,71.5,0.89
CpG: 68,chr13,112651959,112652503,544,68,404,25,74.3,0.91
CpG: 86,chr13,112800681,112801409,728,86,515,23.6,70.7,0.96
CpG: 15,chr13,112831980,112832199,219,15,114,13.7,52.1,1.02
CpG: 57,chr13,112927306,112927962,656,57,418,17.4,63.7,0.86
CpG: 92,chr13,112987476,112988322,846,92,586,21.7,69.3,0.91
CpG: 25,chr13,112988703,112989010,307,25,185,16.3,60.3,0.96
CpG: 21,chr13,112989615,112989915,300,21,189,14,63,0.71
CpG: 92,chr13,112993517,112994445,928,92,644,19.8,69.4,0.83
CpG: 39,chr13,112998484,112999028,544,39,346,14.3,63.6,0.71
CpG: 47,chr13,113034954,113035423,469,47,319,20,68,0.89
CpG: 65,chr13,113293112,113293574,462,65,358,28.1,77.5,0.94
CpG: 164,chr13,113617302,113618748,1446,164,989,22.7,68.4,0.97
CpG: 67,chr13,113794155,113794960,805,67,485,16.6,60.2,0.92
CpG: 33,chr13,114387746,114388137,391,33,249,16.9,63.7,0.85
CpG: 29,chr13,114457269,114457546,277,29,187,20.9,67.5,0.93
CpG: 112,chr13,114458558,114459714,1156,112,722,19.4,62.5,0.99
CpG: 28,chr13,114818154,114818471,317,28,203,17.7,64,0.87
CpG: 61,chr13,115089696,115090334,638,61,423,19.1,66.3,0.87
CpG: 82,chr13,116309560,116310265,705,82,490,23.3,69.5,0.96
CpG: 24,chr13,116705579,116705884,305,24,180,15.7,59,0.91
CpG: 129,chr13,117024388,117025928,1540,129,979,16.8,63.6,0.83
CpG: 63,chr13,117220564,117221184,620,63,432,20.3,69.7,0.85
CpG: 85,chr13,117602283,117602936,653,85,454,26,69.5,1.09
CpG: 72,chr13,118386603,118387323,720,72,429,20,59.6,1.13
CpG: 24,chr13,118714300,118714513,213,24,152,22.5,71.4,0.89
CpG: 35,chr13,119408786,119409138,352,35,253,19.9,71.9,0.79
CpG: 153,chr13,119428376,119429714,1338,153,896,22.9,67,1.02
CpG: 38,chr13,119462635,119463119,484,38,251,15.7,51.9,1.17
CpG: 103,chr13,119487972,119489121,1149,103,611,17.9,53.2,1.27
CpG: 33,chr13,119631620,119632022,402,33,209,16.4,52,1.23
CpG: 70,chr13,119690070,119690840,770,70,515,18.2,66.9,0.81
CpG: 26,chr13,119755651,119755894,243,26,173,21.4,71.2,0.84
CpG: 98,chr13,119790494,119791460,966,98,607,20.3,62.8,1.03
CpG: 27,chr13,119836757,119837075,318,27,164,17,51.6,1.32
CpG: 45,chr13,119965528,119966218,690,45,393,13,57,0.81
CpG: 40,chr13,120096417,120097038,621,40,367,12.9,59.1,0.74
CpG: 28,chr13,120100322,120100563,241,28,141,23.2,58.5,1.36
CpG: 97,chr14,45219318,45220490,1172,97,714,16.6,60.9,0.89
CpG: 59,chr14,69336994,69337565,571,59,368,20.7,64.4,1
CpG: 216,chr14,76414039,76416551,2512,216,1447,17.2,57.6,1.04
CpG: 56,chr14,3049153,3049889,736,56,503,15.2,68.3,0.65
CpG: 57,chr14,3208456,3209210,754,57,515,15.1,68.3,0.65
CpG: 42,chr14,3332478,3332931,453,42,301,18.5,66.4,0.84
CpG: 16,chr14,3333096,3333308,212,16,134,15.1,63.2,0.76
CpG: 67,chr14,3412498,3413157,659,67,467,20.3,70.9,0.81
CpG: 40,chr14,3571885,3572327,442,40,290,18.1,65.6,0.85
CpG: 67,chr14,3651915,3652573,658,67,466,20.4,70.8,0.81
CpG: 40,chr14,3809934,3810378,444,40,290,18,65.3,0.85
CpG: 33,chr14,4018800,4019122,322,33,231,20.5,71.7,0.82
CpG: 63,chr14,4110194,4111053,859,63,567,14.7,66,0.68
CpG: 65,chr14,4182302,4183100,798,65,535,16.3,67,0.73
CpG: 52,chr14,4334676,4335342,666,52,449,15.6,67.4,0.69
CpG: 67,chr14,4415302,4416132,830,67,538,16.1,64.8,0.77
CpG: 83,chr14,4498848,4499884,1036,83,701,16,67.7,0.71
CpG: 70,chr14,4726409,4727293,884,70,594,15.8,67.2,0.71
CpG: 67,chr14,4855423,4856251,828,67,530,16.2,64,0.79
CpG: 32,chr14,5071004,5071344,340,32,240,18.8,70.6,0.77
CpG: 47,chr14,5148998,5149563,565,47,367,16.6,65,0.79
CpG: 49,chr14,5388881,5389396,515,49,366,19,71.1,0.77
CpG: 64,chr14,5459678,5460506,828,64,526,15.5,63.5,0.77
CpG: 47,chr14,5501639,5502204,565,47,367,16.6,65,0.79
CpG: 49,chr14,5741409,5741924,515,49,366,19,71.1,0.77
CpG: 55,chr14,5812171,5812888,717,55,470,15.3,65.6,0.71
CpG: 54,chr14,5879687,5880413,726,54,491,14.9,67.6,0.65
CpG: 57,chr14,5961054,5961803,749,57,509,15.2,68,0.66
CpG: 64,chr14,6037716,6038572,856,64,545,15,63.7,0.74
CpG: 35,chr14,6108354,6108737,383,35,226,18.3,59,1.05
CpG: 39,chr14,6287027,6287444,417,39,277,18.7,66.4,0.86
CpG: 63,chr14,6426577,6427250,673,63,442,18.7,65.7,0.87
CpG: 17,chr14,6756401,6756650,249,17,164,13.7,65.9,0.63
CpG: 41,chr14,6756726,6757174,448,41,273,18.3,60.9,1
CpG: 54,chr14,6889373,6890048,675,54,447,16,66.2,0.73
CpG: 46,chr14,7027162,7027715,553,46,370,16.6,66.9,0.75
CpG: 64,chr14,7104775,7105598,823,64,528,15.6,64.2,0.76
CpG: 64,chr14,7173902,7174729,827,64,529,15.5,64,0.76
CpG: 66,chr14,7244189,7245029,840,66,560,15.7,66.7,0.71
CpG: 51,chr14,7314524,7315093,569,51,393,17.9,69.1,0.75
CpG: 18,chr14,7487993,7488242,249,18,167,14.5,67.1,0.64
CpG: 44,chr14,7488318,7488767,449,44,302,19.6,67.3,0.87
CpG: 60,chr14,7567870,7568624,754,60,514,15.9,68.2,0.68
CpG: 79,chr14,7657923,7658992,1069,79,667,14.8,62.4,0.76
CpG: 30,chr14,7791426,7791817,391,30,257,15.3,65.7,0.73
CpG: 79,chr14,7817861,7818881,1020,79,620,15.5,60.8,0.84
CpG: 30,chr14,8002678,8003008,330,30,209,18.2,63.3,0.98
CpG: 47,chr14,8080222,8080665,443,47,282,21.2,63.7,1.06
CpG: 19,chr14,8097973,8098184,211,19,136,18,64.5,0.88
CpG: 57,chr14,8172557,8173238,681,57,440,16.7,64.6,0.81
CpG: 98,chr14,8213945,8214584,639,98,472,30.7,73.9,1.14
CpG: 32,chr14,8666062,8666337,275,32,188,23.3,68.4,1.01
CpG: 18,chr14,11161667,11161890,223,18,146,16.1,65.5,0.75
CpG: 97,chr14,11553365,11554460,1095,97,675,17.7,61.6,0.93
CpG: 41,chr14,12284113,12284660,547,41,355,15,64.9,0.74
CpG: 38,chr14,12341100,12341600,500,38,291,15.2,58.2,0.91
CpG: 116,chr14,12344738,12346366,1628,116,982,14.3,60.3,0.78
CpG: 109,chr14,12821819,12823224,1405,109,828,15.5,58.9,0.9
CpG: 93,chr14,13960825,13961720,895,93,562,20.8,62.8,1.08
CpG: 91,chr14,14012433,14013127,694,91,483,26.2,69.6,1.1
CpG: 21,chr14,14013255,14013528,273,21,170,15.4,62.3,0.79
CpG: 59,chr14,14120450,14121052,602,59,405,19.6,67.3,0.88
CpG: 92,chr14,14345541,14346567,1026,92,675,17.9,65.8,0.83
CpG: 126,chr14,14702707,14703781,1074,126,724,23.5,67.4,1.03
CpG: 42,chr14,15438703,15439065,362,42,255,23.2,70.4,0.97
CpG: 26,chr14,16243145,16243428,283,26,185,18.4,65.4,0.88
CpG: 47,chr14,16249278,16249697,419,47,300,22.4,71.6,0.88
CpG: 141,chr14,16364625,16366177,1552,141,1006,18.2,64.8,0.87
CpG: 47,chr14,16575224,16575781,557,47,359,16.9,64.5,0.83
CpG: 22,chr14,17172723,17172967,244,22,181,18,74.2,0.67
CpG: 88,chr14,17660327,17661154,827,88,582,21.3,70.4,0.87
CpG: 128,chr14,18238224,18239412,1188,128,841,21.5,70.8,0.89
CpG: 84,chr14,18270482,18271462,980,84,632,17.1,64.5,0.83
CpG: 38,chr14,18326947,18327379,432,38,301,17.6,69.7,0.75
CpG: 74,chr14,18331053,18331975,922,74,468,16.1,50.8,1.25
CpG: 79,chr14,18893261,18894055,794,79,432,19.9,54.4,1.37
CpG: 47,chr14,19041962,19042658,696,47,428,13.5,61.5,0.76
CpG: 44,chr14,19584837,19585289,452,44,300,19.5,66.4,0.89
CpG: 36,chr14,19751168,19751591,423,36,268,17,63.4,0.86
CpG: 74,chr14,19823347,19823956,609,74,437,24.3,71.8,0.94
CpG: 57,chr14,20082826,20083456,630,57,404,18.1,64.1,0.88
CpG: 42,chr14,20181555,20182044,489,42,310,17.2,63.4,0.86
CpG: 50,chr14,20388556,20389021,465,50,316,21.5,68,0.93
CpG: 59,chr14,20393382,20393885,503,59,355,23.5,70.6,0.94
CpG: 31,chr14,20479738,20480021,283,31,189,21.9,66.8,0.99
CpG: 87,chr14,20545846,20546601,755,87,524,23,69.4,0.96
CpG: 60,chr14,20640711,20641325,614,60,381,19.5,62.1,1.04
CpG: 21,chr14,20661199,20661426,227,21,149,18.5,65.6,0.86
CpG: 33,chr14,20674177,20674605,428,33,272,15.4,63.6,0.77
CpG: 105,chr14,20694906,20695866,960,105,610,21.9,63.5,1.08
CpG: 45,chr14,20702837,20703233,396,45,253,22.7,63.9,1.11
CpG: 58,chr14,20707476,20708081,605,58,376,19.2,62.1,0.99
CpG: 18,chr14,20712447,20712714,267,18,167,13.5,62.5,0.71
CpG: 75,chr14,20734106,20734688,582,75,439,25.8,75.4,0.91
CpG: 112,chr14,20793132,20794288,1156,112,828,19.4,71.6,0.79
CpG: 91,chr14,20928966,20929785,819,91,566,22.2,69.1,0.93
CpG: 86,chr14,21051936,21053052,1116,86,727,15.4,65.1,0.73
CpG: 48,chr14,21075820,21076363,543,48,360,17.7,66.3,0.81
CpG: 152,chr14,21499430,21501345,1915,152,1185,15.9,61.9,0.86
CpG: 36,chr14,21686625,21686919,294,36,193,24.5,65.6,1.15
CpG: 52,chr14,21750506,21750966,460,52,333,22.6,72.4,0.87
CpG: 70,chr14,21831202,21831936,734,70,492,19.1,67,0.85
CpG: 42,chr14,21847624,21848111,487,42,328,17.2,67.4,0.76
CpG: 43,chr14,21848497,21849077,580,43,390,14.8,67.2,0.66
CpG: 245,chr14,21984958,21988506,3548,245,2090,13.8,58.9,0.8
CpG: 48,chr14,21989043,21989725,682,48,398,14.1,58.4,0.83
CpG: 20,chr14,21995465,21995720,255,20,174,15.7,68.2,0.7
CpG: 27,chr14,22019595,22019858,263,27,187,20.5,71.1,0.82
CpG: 18,chr14,24003687,24003940,253,18,143,14.2,56.5,0.89
CpG: 90,chr14,24004138,24005040,902,90,563,20,62.4,1.03
CpG: 94,chr14,24245025,24245948,923,94,626,20.4,67.8,0.89
CpG: 28,chr14,24486857,24487168,311,28,190,18,61.1,0.98
CpG: 56,chr14,24490658,24491223,565,56,376,19.8,66.5,0.9
CpG: 27,chr14,24779205,24779551,346,27,231,15.6,66.8,0.72
CpG: 39,chr14,25378196,25378585,389,39,280,20.1,72,0.78
CpG: 43,chr14,25457369,25457822,453,43,315,19,69.5,0.84
CpG: 190,chr14,25459062,25461092,2030,190,1326,18.7,65.3,0.88
CpG: 147,chr14,25606732,25608195,1463,147,980,20.1,67,0.9
CpG: 64,chr14,25694003,25694412,409,64,295,31.3,72.1,1.2
CpG: 65,chr14,25768412,25769374,962,65,553,13.5,57.5,0.82
CpG: 51,chr14,25841984,25842552,568,51,374,18,65.8,0.83
CpG: 31,chr14,25902787,25903070,283,31,199,21.9,70.3,0.89
CpG: 32,chr14,25927123,25927518,395,32,254,16.2,64.3,0.78
CpG: 31,chr14,26042553,26042836,283,31,199,21.9,70.3,0.89
CpG: 32,chr14,26066876,26067271,395,32,254,16.2,64.3,0.78
CpG: 31,chr14,26182167,26182450,283,31,199,21.9,70.3,0.89
CpG: 32,chr14,26206492,26206887,395,32,254,16.2,64.3,0.78
CpG: 16,chr14,26397973,26398176,203,16,138,15.8,68,0.69
CpG: 97,chr14,26533914,26534984,1070,97,703,18.1,65.7,0.84
CpG: 71,chr14,26579433,26580003,570,71,424,24.9,74.4,0.92
CpG: 80,chr14,26637890,26638619,729,80,493,21.9,67.6,0.96
CpG: 148,chr14,26668417,26670139,1722,148,1083,17.2,62.9,0.87
CpG: 112,chr14,26969890,26970847,957,112,671,23.4,70.1,0.97
CpG: 73,chr14,27038876,27039621,745,73,491,19.6,65.9,0.91
CpG: 41,chr14,27114753,27115256,503,41,331,16.3,65.8,0.77
CpG: 47,chr14,27335909,27336613,704,47,442,13.4,62.8,0.69
CpG: 114,chr14,27428557,27429673,1116,114,737,20.4,66,0.94
CpG: 39,chr14,27508268,27508654,386,39,266,20.2,68.9,0.87
CpG: 58,chr14,27622255,27622859,604,58,358,19.2,59.3,1.09
CpG: 33,chr14,28504710,28504984,274,33,202,24.1,73.7,0.89
CpG: 79,chr14,28505744,28506737,993,79,580,15.9,58.4,0.95
CpG: 27,chr14,28518280,28518538,258,27,168,20.9,65.1,1
CpG: 168,chr14,29721523,29723164,1641,168,1067,20.5,65,0.97
CpG: 35,chr14,29968429,29968835,406,35,262,17.2,64.5,0.85
CpG: 35,chr14,29978335,29978793,458,35,281,15.3,61.4,0.82
CpG: 48,chr14,30008731,30009232,501,48,355,19.2,70.9,0.76
CpG: 49,chr14,30479314,30479994,680,49,440,14.4,64.7,0.69
CpG: 62,chr14,30549034,30549614,580,62,391,21.4,67.4,0.95
CpG: 91,chr14,30625376,30626332,956,91,670,19,70.1,0.79
CpG: 27,chr14,30654331,30654596,265,27,193,20.4,72.8,0.77
CpG: 182,chr14,30714969,30716784,1815,182,1056,20.1,58.2,1.2
CpG: 66,chr14,30825527,30826045,518,66,379,25.5,73.2,0.95
CpG: 55,chr14,30951187,30951763,576,55,368,19.1,63.9,0.94
CpG: 88,chr14,31001177,31001979,802,88,550,21.9,68.6,0.94
CpG: 37,chr14,31128722,31129151,429,37,276,17.2,64.3,0.84
CpG: 84,chr14,31130796,31131640,844,84,552,19.9,65.4,0.93
CpG: 17,chr14,31138756,31138962,206,17,125,16.5,60.7,1.09
CpG: 32,chr14,31176414,31176785,371,32,235,17.3,63.3,0.91
CpG: 41,chr14,31206313,31206726,413,41,285,19.9,69,0.9
CpG: 84,chr14,31250806,31251709,903,84,519,18.6,57.5,1.15
CpG: 71,chr14,31336547,31337121,574,71,413,24.7,72,0.96
CpG: 85,chr14,31435255,31436173,918,85,579,18.5,63.1,0.93
CpG: 84,chr14,31494495,31495463,968,84,611,17.4,63.1,0.87
CpG: 22,chr14,31641076,31641345,269,22,176,16.4,65.4,0.77
CpG: 37,chr14,31661724,31662252,528,37,295,14,55.9,0.9
CpG: 138,chr14,31829870,31831161,1291,138,822,21.4,63.7,1.06
CpG: 49,chr14,32085239,32085808,569,49,348,17.2,61.2,0.92
CpG: 38,chr14,32159840,32160256,416,38,276,18.3,66.3,0.85
CpG: 30,chr14,32165537,32165807,270,30,184,22.2,68.1,0.99
CpG: 110,chr14,32201399,32202470,1071,110,706,20.5,65.9,0.95
CpG: 35,chr14,32321923,32322148,225,35,163,31.1,72.4,1.19
CpG: 184,chr14,32462885,32464963,2078,184,1299,17.7,62.5,0.91
CpG: 19,chr14,32465179,32465402,223,19,158,17,70.9,0.7
CpG: 52,chr14,32513401,32513831,430,52,294,24.2,68.4,1.04
CpG: 66,chr14,32597539,32598251,712,66,484,18.5,68,0.8
CpG: 34,chr14,32599353,32599667,314,34,219,21.7,69.7,0.9
CpG: 58,chr14,32856635,32857335,700,58,413,16.6,59,0.95
CpG: 108,chr14,33319523,33320508,985,108,691,21.9,70.2,0.89
CpG: 44,chr14,33351094,33351520,426,44,290,20.7,68.1,0.89
CpG: 104,chr14,33446594,33447436,842,104,506,24.7,60.1,1.37
CpG: 75,chr14,33923270,33923822,552,75,418,27.2,75.7,0.96
CpG: 19,chr14,33978657,33978876,219,19,147,17.4,67.1,0.77
CpG: 41,chr14,34201177,34201649,472,41,327,17.4,69.3,0.73
CpG: 129,chr14,34310267,34311460,1193,129,786,21.6,65.9,1.01
CpG: 157,chr14,34501972,34503439,1467,157,888,21.4,60.5,1.17
CpG: 69,chr14,34548777,34549629,852,69,573,16.2,67.3,0.72
CpG: 111,chr14,34673369,34674780,1411,111,824,15.7,58.4,0.92
CpG: 44,chr14,34769259,34769847,588,44,374,15,63.6,0.74
CpG: 156,chr14,34819065,34820630,1565,156,958,19.9,61.2,1.07
CpG: 19,chr14,34822879,34823080,201,19,127,18.9,63.2,0.97
CpG: 23,chr14,34896263,34896534,271,23,170,17,62.7,0.86
CpG: 74,chr14,36968287,36968894,607,74,462,24.4,76.1,0.86
CpG: 64,chr14,37134859,37135524,665,64,424,19.2,63.8,0.96
CpG: 27,chr14,39472116,39472397,281,27,198,19.2,70.5,0.86
CpG: 101,chr14,39473035,39474133,1098,101,656,18.4,59.7,1.03
CpG: 106,chr14,40966306,40967430,1124,106,711,18.9,63.3,0.95
CpG: 32,chr14,41013530,41013945,415,32,272,15.4,65.5,0.72
CpG: 16,chr14,41072829,41073031,202,16,119,15.8,58.9,0.91
CpG: 22,chr14,41265045,41265281,236,22,151,18.6,64,0.91
CpG: 24,chr14,42543311,42543565,254,24,163,18.9,64.2,0.92
CpG: 34,chr14,43122170,43122402,232,34,177,29.3,76.3,1.06
CpG: 20,chr14,44858992,44859201,209,20,139,19.1,66.5,0.87
CpG: 43,chr14,44989052,44989670,618,43,366,13.9,59.2,0.8
CpG: 107,chr14,45318139,45318958,819,107,603,26.1,73.6,0.99
CpG: 36,chr14,45329642,45330100,458,36,263,15.7,57.4,0.96
CpG: 71,chr14,45351017,45351731,714,71,454,19.9,63.6,0.98
CpG: 54,chr14,45388489,45388958,469,54,339,23,72.3,0.92
CpG: 100,chr14,45529495,45530466,971,100,570,20.6,58.7,1.2
CpG: 149,chr14,45657105,45658428,1323,149,830,22.5,62.7,1.15
CpG: 21,chr14,46380507,46380713,206,21,153,20.4,74.3,0.78
CpG: 25,chr14,46385746,46386028,282,25,177,17.7,62.8,0.91
CpG: 123,chr14,46387354,46389165,1811,123,1038,13.6,57.3,0.83
CpG: 53,chr14,46760328,46760830,502,53,337,21.1,67.1,0.94
CpG: 85,chr14,46787831,46788439,608,85,457,28,75.2,0.99
CpG: 57,chr14,46821887,46822368,481,57,324,23.7,67.4,1.05
CpG: 68,chr14,46831779,46832643,864,68,546,15.7,63.2,0.79
CpG: 220,chr14,46881984,46885050,3066,220,1840,14.4,60,0.8
CpG: 65,chr14,47188874,47189528,654,65,455,19.9,69.6,0.82
CpG: 89,chr14,47276431,47277333,902,89,594,19.7,65.9,0.91
CpG: 65,chr14,47298132,47298693,561,65,408,23.2,72.7,0.88
CpG: 38,chr14,47373718,47374202,484,38,330,15.7,68.2,0.69
CpG: 21,chr14,47418158,47418422,264,21,159,15.9,60.2,0.89
CpG: 90,chr14,47472465,47473177,712,90,513,25.3,72.1,0.98
CpG: 28,chr14,47568168,47568375,207,28,140,27.1,67.6,1.19
CpG: 98,chr14,47649162,47650163,1001,98,660,19.6,65.9,0.9
CpG: 109,chr14,48120836,48121724,888,109,629,24.5,70.8,0.98
CpG: 62,chr14,48446239,48446704,465,62,350,26.7,75.3,0.95
CpG: 21,chr14,48662336,48662607,271,21,166,15.5,61.3,0.84
CpG: 42,chr14,48664942,48665572,630,42,349,13.3,55.4,0.88
CpG: 55,chr14,48665980,48666724,744,55,456,14.8,61.3,0.79
CpG: 48,chr14,48673671,48674264,593,48,358,16.2,60.4,0.9
CpG: 86,chr14,49065833,49066540,707,86,486,24.3,68.7,1.04
CpG: 18,chr14,49171997,49172219,222,18,157,16.2,70.7,0.65
CpG: 73,chr14,49172552,49173272,720,73,486,20.3,67.5,0.89
CpG: 23,chr14,50062410,50062654,244,23,178,18.9,73,0.71
CpG: 33,chr14,50807567,50807961,394,33,246,16.8,62.4,0.86
CpG: 74,chr14,50924637,50925331,694,74,445,21.3,64.1,1.04
CpG: 93,chr14,50930361,50931313,952,93,606,19.5,63.7,0.97
CpG: 46,chr14,51358179,51358651,472,46,284,19.5,60.2,1.1
CpG: 40,chr14,51434918,51435452,534,40,332,15,62.2,0.78
CpG: 41,chr14,51884683,51885286,603,41,355,13.6,58.9,0.79
CpG: 34,chr14,51913071,51913507,436,34,298,15.6,68.3,0.73
CpG: 18,chr14,51913746,51913964,218,18,141,16.5,64.7,0.8
CpG: 56,chr14,51984572,51985096,524,56,376,21.4,71.8,0.84
CpG: 22,chr14,52006642,52006926,284,22,195,15.5,68.7,0.66
CpG: 45,chr14,52009117,52009656,539,45,356,16.7,66,0.77
CpG: 73,chr14,52019651,52020333,682,73,481,21.4,70.5,0.86
CpG: 67,chr14,52103655,52104409,754,67,451,17.8,59.8,1.01
CpG: 26,chr14,52119196,52119414,218,26,151,23.9,69.3,1
CpG: 107,chr14,52196634,52197659,1025,107,690,20.9,67.3,0.92
CpG: 62,chr14,52257388,52258072,684,62,468,18.1,68.4,0.78
CpG: 65,chr14,52279159,52280006,847,65,527,15.3,62.2,0.8
CpG: 43,chr14,52304680,52305184,504,43,309,17.1,61.3,0.92
CpG: 42,chr14,54253700,54254197,497,42,290,16.9,58.4,0.99
CpG: 54,chr14,54360796,54361428,632,54,405,17.1,64.1,0.83
CpG: 37,chr14,54426669,54427141,472,37,282,15.7,59.7,0.88
CpG: 74,chr14,54431736,54432641,905,74,568,16.4,62.8,0.84
CpG: 83,chr14,54464045,54464787,742,83,534,22.4,72,0.87
CpG: 36,chr14,54479454,54479798,344,36,228,20.9,66.3,0.96
CpG: 24,chr14,54517283,54517542,259,24,164,18.5,63.3,0.94
CpG: 64,chr14,54553905,54554442,537,64,368,23.8,68.5,1.02
CpG: 173,chr14,54575687,54577650,1963,173,1270,17.6,64.7,0.84
CpG: 15,chr14,54584483,54584701,218,15,131,13.8,60.1,0.76
CpG: 39,chr14,54603235,54603593,358,39,249,21.8,69.6,0.9
CpG: 51,chr14,54617531,54618122,591,51,379,17.3,64.1,0.86
CpG: 51,chr14,54632065,54632542,477,51,343,21.4,71.9,0.83
CpG: 69,chr14,54641128,54641737,609,69,449,22.7,73.7,0.83
CpG: 76,chr14,54686229,54686999,770,76,491,19.7,63.8,0.99
CpG: 93,chr14,54691270,54692555,1285,93,783,14.5,60.9,0.79
CpG: 59,chr14,54781103,54781990,887,59,485,13.3,54.7,0.89
CpG: 26,chr14,54814094,54814387,293,26,192,17.7,65.5,0.83
CpG: 53,chr14,54863827,54864469,642,53,412,16.5,64.2,0.8
CpG: 152,chr14,54876403,54877606,1203,152,881,25.3,73.2,0.94
CpG: 47,chr14,54894056,54894626,570,47,349,16.5,61.2,0.96
CpG: 95,chr14,54912159,54913115,956,95,694,19.9,72.6,0.76
CpG: 94,chr14,54925853,54926972,1119,94,773,16.8,69.1,0.71
CpG: 29,chr14,55014822,55015191,369,29,223,15.7,60.4,0.86
CpG: 17,chr14,55091472,55091680,208,17,142,16.3,68.3,0.78
CpG: 22,chr14,55106007,55106321,314,22,183,14,58.3,0.85
CpG: 148,chr14,55113414,55115427,2013,148,1304,14.7,64.8,0.71
CpG: 61,chr14,55490843,55491392,549,61,353,22.2,64.3,1.08
CpG: 47,chr14,55520577,55520945,368,47,259,25.5,70.4,1.03
CpG: 22,chr14,55540273,55540569,296,22,199,14.9,67.2,0.69
CpG: 60,chr14,55559952,55560730,778,60,480,15.4,61.7,0.82
CpG: 24,chr14,55578335,55578631,296,24,203,16.2,68.6,0.7
CpG: 43,chr14,55591541,55592094,553,43,363,15.6,65.6,0.72
CpG: 31,chr14,55635503,55635849,346,31,231,17.9,66.8,0.8
CpG: 84,chr14,55643160,55643858,698,84,493,24.1,70.6,0.97
CpG: 28,chr14,55660284,55660576,292,28,182,19.2,62.3,0.99
CpG: 20,chr14,55671858,55672103,245,20,155,16.3,63.3,0.82
CpG: 61,chr14,55681414,55682118,704,61,441,17.3,62.6,0.89
CpG: 41,chr14,55721851,55722305,454,41,308,18.1,67.8,0.79
CpG: 53,chr14,55745623,55746066,443,53,284,23.9,64.1,1.16
CpG: 85,chr14,55761978,55762879,901,85,629,18.9,69.8,0.77
CpG: 37,chr14,55767855,55768193,338,37,239,21.9,70.7,0.88
CpG: 31,chr14,55823371,55823739,368,31,261,16.8,70.9,0.67
CpG: 22,chr14,55825499,55825707,208,22,159,21.2,76.4,0.75
CpG: 30,chr14,55826542,55826917,375,30,247,16,65.9,0.75
CpG: 30,chr14,55853961,55854326,365,30,249,16.4,68.2,0.73
CpG: 50,chr14,55884760,55885300,540,50,392,18.5,72.6,0.74
CpG: 25,chr14,55900147,55900461,314,25,186,15.9,59.2,0.91
CpG: 57,chr14,56364695,56365341,646,57,422,17.6,65.3,0.83
CpG: 21,chr14,56402618,56402909,291,21,193,14.4,66.3,0.7
CpG: 52,chr14,56571498,56572019,521,52,340,20,65.3,0.97
CpG: 65,chr14,56668015,56668686,671,65,442,19.4,65.9,0.93
CpG: 90,chr14,56777592,56778439,847,90,535,21.3,63.2,1.07
CpG: 182,chr14,56811083,56812806,1723,182,1158,21.1,67.2,0.94
CpG: 47,chr14,56864978,56865307,329,47,247,28.6,75.1,1.02
CpG: 181,chr14,56885457,56887319,1862,181,1192,19.4,64,0.95
CpG: 42,chr14,57036347,57036833,486,42,291,17.3,59.9,0.96
CpG: 91,chr14,57057457,57058246,789,91,573,23.1,72.6,0.9
CpG: 113,chr14,57103888,57104871,983,113,676,23,68.8,0.97
CpG: 50,chr14,57132909,57133456,547,50,372,18.3,68,0.79
CpG: 30,chr14,57398263,57398546,283,30,200,21.2,70.7,0.85
CpG: 49,chr14,57423968,57424412,444,49,320,22.1,72.1,0.85
CpG: 85,chr14,57524724,57525612,888,85,511,19.1,57.5,1.16
CpG: 33,chr14,57542342,57542656,314,33,219,21,69.7,0.87
CpG: 77,chr14,57664861,57665494,633,77,443,24.3,70,0.99
CpG: 30,chr14,57691292,57691751,459,30,290,13.1,63.2,0.66
CpG: 30,chr14,57699608,57699956,348,30,242,17.2,69.5,0.73
CpG: 146,chr14,57745384,57746445,1061,146,755,27.5,71.2,1.09
CpG: 86,chr14,57797948,57798779,831,86,492,20.7,59.2,1.18
CpG: 91,chr14,57825893,57826716,823,91,553,22.1,67.2,0.98
CpG: 70,chr14,57889810,57890537,727,70,443,19.3,60.9,1.05
CpG: 66,chr14,57998870,57999409,539,66,396,24.5,73.5,0.93
CpG: 34,chr14,58070941,58071337,396,34,250,17.2,63.1,0.86
CpG: 71,chr14,58071916,58072432,516,71,365,27.5,70.7,1.11
CpG: 148,chr14,58074858,58076844,1986,148,1289,14.9,64.9,0.71
CpG: 102,chr14,59200934,59201773,839,102,587,24.3,70,1
CpG: 34,chr14,59440675,59441049,374,34,226,18.2,60.4,1
CpG: 28,chr14,59597693,59598021,328,28,211,17.1,64.3,0.84
CpG: 112,chr14,59625213,59626407,1194,112,805,18.8,67.4,0.83
CpG: 21,chr14,60086635,60086903,268,21,172,15.7,64.2,0.76
CpG: 71,chr14,60176934,60177572,638,71,409,22.3,64.1,1.08
CpG: 98,chr14,60250944,60251913,969,98,639,20.2,65.9,0.93
CpG: 40,chr14,60265165,60265612,447,40,302,17.9,67.6,0.81
CpG: 120,chr14,60378106,60379275,1169,120,784,20.5,67.1,0.93
CpG: 58,chr14,60634605,60635216,611,58,432,19,70.7,0.78
CpG: 54,chr14,60784515,60784965,450,54,321,24,71.3,0.96
CpG: 27,chr14,61037742,61038042,300,27,216,18,72,0.72
CpG: 40,chr14,61046070,61046642,572,40,333,14,58.2,0.83
CpG: 92,chr14,61172675,61173531,856,92,607,21.5,70.9,0.87
CpG: 20,chr14,61274961,61275189,228,20,149,17.5,65.4,0.84
CpG: 30,chr14,61360201,61360502,301,30,214,19.9,71.1,0.79
CpG: 108,chr14,61439308,61440356,1048,108,629,20.6,60,1.15
CpG: 95,chr14,61556299,61557395,1096,95,746,17.3,68.1,0.76
CpG: 36,chr14,61599428,61599716,288,36,213,25,74,0.95
CpG: 153,chr14,61647885,61649387,1502,153,967,20.4,64.4,1.01
CpG: 155,chr14,61681429,61683136,1707,155,1144,18.2,67,0.82
CpG: 44,chr14,61686477,61687075,598,44,356,14.7,59.5,0.84
CpG: 47,chr14,61689450,61690062,612,47,365,15.4,59.6,0.87
CpG: 46,chr14,62292586,62293023,437,46,321,21.1,73.5,0.78
CpG: 58,chr14,62331902,62332436,534,58,354,21.7,66.3,0.99
CpG: 51,chr14,62555511,62555970,459,51,292,22.2,63.6,1.1
CpG: 124,chr14,62760232,62761802,1570,124,989,15.8,63,0.8
CpG: 74,chr14,62837245,62838147,902,74,563,16.4,62.4,0.84
CpG: 42,chr14,63122413,63122868,455,42,315,18.5,69.2,0.79
CpG: 48,chr14,63177707,63178176,469,48,306,20.5,65.2,0.96
CpG: 58,chr14,63240595,63241125,530,58,399,21.9,75.3,0.77
CpG: 63,chr14,63245177,63245911,734,63,481,17.2,65.5,0.8
CpG: 24,chr14,63246365,63246730,365,24,225,13.2,61.6,0.7
CpG: 18,chr14,63251554,63251766,212,18,137,17,64.6,0.83
CpG: 66,chr14,63255682,63256125,443,66,343,29.8,77.4,1
CpG: 46,chr14,63436314,63436646,332,46,236,27.7,71.1,1.14
CpG: 17,chr14,63493642,63493875,233,17,148,14.6,63.5,0.74
CpG: 27,chr14,63508522,63508838,316,27,206,17.1,65.2,0.81
CpG: 58,chr14,63543406,63544048,642,58,433,18.1,67.4,0.8
CpG: 23,chr14,63606145,63606376,231,23,166,19.9,71.9,0.79
CpG: 30,chr14,63606863,63607154,291,30,202,20.6,69.4,0.87
CpG: 43,chr14,63860244,63860637,393,43,251,21.9,63.9,1.08
CpG: 80,chr14,63943359,63944306,947,80,611,16.9,64.5,0.83
CpG: 45,chr14,64440539,64441017,478,45,321,18.8,67.2,0.84
CpG: 59,chr14,64587032,64587858,826,59,507,14.3,61.4,0.76
CpG: 59,chr14,64652352,64652894,542,59,367,21.8,67.7,0.95
CpG: 27,chr14,65076263,65076651,388,27,246,13.9,63.4,0.69
CpG: 25,chr14,65077415,65077777,362,25,209,13.8,57.7,0.83
CpG: 74,chr14,65097696,65098287,591,74,431,25,72.9,0.95
CpG: 47,chr14,65149568,65150233,665,47,417,14.1,62.7,0.76
CpG: 153,chr14,65261733,65262879,1146,153,829,26.7,72.3,1.03
CpG: 68,chr14,65343460,65344149,689,68,475,19.7,68.9,0.87
CpG: 109,chr14,65358046,65359202,1156,109,732,18.9,63.3,0.95
CpG: 23,chr14,65730733,65731067,334,23,222,13.8,66.5,0.63
CpG: 39,chr14,65805803,65806238,435,39,268,17.9,61.6,0.97
CpG: 40,chr14,65833654,65834070,416,40,266,19.2,63.9,0.96
CpG: 55,chr14,65837236,65837829,593,55,380,18.5,64.1,0.92
CpG: 47,chr14,65953513,65953964,451,47,326,20.8,72.3,0.8
CpG: 26,chr14,66044940,66045184,244,26,161,21.3,66,1
CpG: 72,chr14,66296844,66297584,740,72,497,19.5,67.2,0.86
CpG: 29,chr14,66867432,66867760,328,29,208,17.7,63.4,0.89
CpG: 75,chr14,66868655,66869260,605,75,436,24.8,72.1,0.96
CpG: 100,chr14,66910077,66911329,1252,100,765,16,61.1,0.86
CpG: 96,chr14,67008243,67009161,918,96,594,20.9,64.7,1
CpG: 62,chr14,67071836,67072553,717,62,447,17.3,62.3,0.89
CpG: 22,chr14,67231826,67232086,260,22,159,16.9,61.2,0.91
CpG: 38,chr14,67233318,67233850,532,38,293,14.3,55.1,0.95
CpG: 27,chr14,67234409,67234680,271,27,185,19.9,68.3,0.86
CpG: 70,chr14,67235403,67236476,1073,70,616,13,57.4,0.79
CpG: 124,chr14,67715116,67716535,1419,124,907,17.5,63.9,0.86
CpG: 80,chr14,67933026,67933976,950,80,499,16.8,52.5,1.22
CpG: 127,chr14,68083681,68084944,1263,127,808,20.1,64,0.99
CpG: 139,chr14,68123594,68125071,1477,139,929,18.8,62.9,0.95
CpG: 52,chr14,69174640,69175155,515,52,341,20.2,66.2,0.93
CpG: 48,chr14,69190582,69191014,432,48,301,22.2,69.7,0.92
CpG: 98,chr14,69284199,69285213,1014,98,686,19.3,67.7,0.84
CpG: 25,chr14,69390794,69391069,275,25,186,18.2,67.6,0.8
CpG: 98,chr14,69502449,69503463,1014,98,686,19.3,67.7,0.84
CpG: 59,chr14,69555244,69555815,571,59,368,20.7,64.4,1
CpG: 25,chr14,69609069,69609344,275,25,186,18.2,67.6,0.8
CpG: 32,chr14,69707297,69707630,333,32,217,19.2,65.2,0.91
CpG: 60,chr14,69732154,69732804,650,60,444,18.5,68.3,0.81
CpG: 34,chr14,69767480,69767936,456,34,283,14.9,62.1,0.79
CpG: 16,chr14,69796944,69797162,218,16,147,14.7,67.4,0.69
CpG: 48,chr14,69805129,69805513,384,48,254,25,66.1,1.14
CpG: 94,chr14,70074548,70075804,1256,94,850,15,67.7,0.66
CpG: 204,chr14,70077736,70080412,2676,204,1710,15.2,63.9,0.75
CpG: 31,chr14,70099980,70100343,363,31,233,17.1,64.2,0.83
CpG: 65,chr14,70153176,70153877,701,65,478,18.5,68.2,0.81
CpG: 43,chr14,70176603,70177143,540,43,318,15.9,58.9,0.92
CpG: 50,chr14,70191782,70192426,644,50,450,15.5,69.9,0.64
CpG: 41,chr14,70205675,70206234,559,41,385,14.7,68.9,0.62
CpG: 91,chr14,70288971,70289603,632,91,432,28.8,68.4,1.24
CpG: 46,chr14,70351027,70351579,552,46,354,16.7,64.1,0.86
CpG: 16,chr14,70429010,70429236,226,16,154,14.2,68.1,0.63
CpG: 89,chr14,70442895,70443894,999,89,668,17.8,66.9,0.8
CpG: 65,chr14,70519795,70520605,810,65,427,16,52.7,1.17
CpG: 22,chr14,70530831,70531099,268,22,189,16.4,70.5,0.68
CpG: 49,chr14,70545128,70545607,479,49,327,20.5,68.3,0.88
CpG: 101,chr14,70554072,70555129,1057,101,769,19.1,72.8,0.73
CpG: 65,chr14,70577466,70578210,744,65,489,17.5,65.7,0.82
CpG: 33,chr14,70599338,70599644,306,33,200,21.6,65.4,1.08
CpG: 33,chr14,70618136,70618520,384,33,268,17.2,69.8,0.71
CpG: 23,chr14,70636751,70637028,277,23,174,16.6,62.8,0.85
CpG: 18,chr14,70641956,70642175,219,18,141,16.4,64.4,0.79
CpG: 22,chr14,70659207,70659420,213,22,138,20.7,64.8,0.99
CpG: 122,chr14,70765911,70767002,1091,122,759,22.4,69.6,0.94
CpG: 35,chr14,70889700,70890049,349,35,249,20.1,71.3,0.81
CpG: 19,chr14,70890502,70890733,231,19,156,16.5,67.5,0.72
CpG: 28,chr14,70890937,70891230,293,28,201,19.1,68.6,0.82
CpG: 65,chr14,72531906,72532783,877,65,555,14.8,63.3,0.74
CpG: 162,chr14,72709212,72710670,1458,162,939,22.2,64.4,1.08
CpG: 26,chr14,72980207,72980461,254,26,185,20.5,72.8,0.78
CpG: 68,chr14,73143062,73143624,562,68,403,24.2,71.7,0.94
CpG: 138,chr14,73325169,73326460,1291,138,775,21.4,60,1.19
CpG: 56,chr14,73384790,73385296,506,56,360,22.1,71.1,0.88
CpG: 35,chr14,73509941,73510312,371,35,243,18.9,65.5,0.89
CpG: 40,chr14,73524875,73525315,440,40,276,18.2,62.7,0.93
CpG: 62,chr14,73552672,73553184,512,62,386,24.2,75.4,0.85
CpG: 52,chr14,74732201,74732799,598,52,397,17.4,66.4,0.8
CpG: 107,chr14,74946850,74947938,1088,107,702,19.7,64.5,0.95
CpG: 45,chr14,75015955,75016491,536,45,320,16.8,59.7,0.97
CpG: 19,chr14,75130970,75131209,239,19,164,15.9,68.6,0.68
CpG: 66,chr14,75284049,75284748,699,66,446,18.9,63.8,0.94
CpG: 67,chr14,75754037,75754640,603,67,423,22.2,70.1,0.91
CpG: 55,chr14,75786602,75787121,519,55,364,21.2,70.1,0.87
CpG: 140,chr14,75844829,75845982,1153,140,784,24.3,68,1.05
CpG: 51,chr14,76010581,76011033,452,51,286,22.6,63.3,1.13
CpG: 65,chr14,76110499,76111209,710,65,461,18.3,64.9,0.88
CpG: 49,chr14,76504147,76504595,448,49,317,21.9,70.8,0.88
CpG: 53,chr14,76556480,76556942,462,53,331,22.9,71.6,0.89
CpG: 66,chr14,77036339,77036901,562,66,362,23.5,64.4,1.14
CpG: 151,chr14,77156292,77157837,1545,151,1024,19.5,66.3,0.9
CpG: 23,chr14,77874781,77874982,201,23,131,22.9,65.2,1.09
CpG: 39,chr14,78307749,78308030,281,39,215,27.8,76.5,0.95
CpG: 79,chr14,78536482,78537145,663,79,468,23.8,70.6,0.97
CpG: 44,chr14,78724770,78725265,495,44,350,17.8,70.7,0.74
CpG: 111,chr14,78731811,78733108,1297,111,696,17.1,53.7,1.19
CpG: 51,chr14,78849032,78849511,479,51,357,21.3,74.5,0.77
CpG: 93,chr14,79300718,79301843,1125,93,712,16.5,63.3,0.83
CpG: 75,chr14,79390227,79390931,704,75,490,21.3,69.6,0.88
CpG: 99,chr14,79426347,79427229,882,99,586,22.4,66.4,1.02
CpG: 84,chr14,79451833,79452555,722,84,486,23.3,67.3,1.03
CpG: 152,chr14,79480680,79482211,1531,152,923,19.9,60.3,1.09
CpG: 56,chr14,79587228,79587774,546,56,349,20.5,63.9,1.01
CpG: 24,chr14,79661295,79661614,319,24,207,15,64.9,0.72
CpG: 257,chr14,79768453,79771419,2966,257,1892,17.3,63.8,0.85
CpG: 33,chr14,79773910,79774336,426,33,251,15.5,58.9,0.89
CpG: 31,chr14,84443319,84443642,323,31,215,19.2,66.6,0.87
CpG: 16,chr14,84444288,84444501,213,16,124,15,58.2,0.9
CpG: 159,chr14,84445819,84448029,2210,159,1308,14.4,59.2,0.82
CpG: 44,chr14,87140956,87141361,405,44,275,21.7,67.9,0.96
CpG: 142,chr14,87415915,87417408,1493,142,870,19,58.3,1.12
CpG: 68,chr14,89898190,89899068,878,68,535,15.5,60.9,0.84
CpG: 31,chr14,93890724,93891054,330,31,230,18.8,69.7,0.77
CpG: 109,chr14,99045504,99046496,992,109,604,22,60.9,1.19
CpG: 78,chr14,99099323,99100013,690,78,469,22.6,68,0.98
CpG: 121,chr14,99298434,99299444,1010,121,721,24,71.4,0.94
CpG: 58,chr14,100285450,100286092,642,58,439,18.1,68.4,0.81
CpG: 116,chr14,101607831,101609266,1435,116,960,16.2,66.9,0.72
CpG: 26,chr14,101640202,101640508,306,26,206,17,67.3,0.76
CpG: 60,chr14,101653891,101654556,665,60,434,18,65.3,0.85
CpG: 55,chr14,101729429,101730117,688,55,457,16,66.4,0.74
CpG: 181,chr14,102981427,102983032,1605,181,1080,22.6,67.3,1
CpG: 58,chr14,103070166,103070558,392,58,300,29.6,76.5,1.03
CpG: 130,chr14,103098752,103099853,1101,130,704,23.6,63.9,1.17
CpG: 85,chr14,103346112,103347012,900,85,565,18.9,62.8,0.96
CpG: 86,chr14,103650020,103650973,953,86,592,18,62.1,0.94
CpG: 34,chr14,104473079,104473450,371,34,241,18.3,65,0.88
CpG: 72,chr14,104522150,104522767,617,72,445,23.3,72.1,0.9
CpG: 15,chr14,104940044,104940266,222,15,118,13.5,53.2,1.04
CpG: 77,chr14,105176670,105177521,851,77,518,18.1,60.9,0.98
CpG: 63,chr14,105258656,105259154,498,63,335,25.3,67.3,1.12
CpG: 19,chr14,105895076,105895323,247,19,159,15.4,64.4,0.76
CpG: 108,chr14,105895952,105897500,1548,108,828,14,53.5,0.98
CpG: 33,chr14,105898830,105899080,250,33,180,26.4,72,1.02
CpG: 42,chr14,106106099,106106731,632,42,416,13.3,65.8,0.61
CpG: 16,chr14,108911299,108911530,231,16,135,13.9,58.4,0.81
CpG: 94,chr14,111675225,111676142,917,94,647,20.5,70.6,0.83
CpG: 226,chr14,115040329,115042403,2074,226,1209,21.8,58.3,1.29
CpG: 72,chr14,115092127,115092922,795,72,534,18.1,67.2,0.81
CpG: 131,chr14,116925377,116926927,1550,131,1018,16.9,65.7,0.78
CpG: 28,chr14,118132659,118132908,249,28,165,22.5,66.3,1.03
CpG: 93,chr14,118136697,118137559,862,93,568,21.6,65.9,1
CpG: 18,chr14,118157967,118158183,216,18,133,16.7,61.6,0.89
CpG: 21,chr14,118226011,118226253,242,21,144,17.4,59.5,0.98
CpG: 242,chr14,118234464,118237221,2757,242,1723,17.6,62.5,0.9
CpG: 37,chr14,118436905,118437298,393,37,274,18.8,69.7,0.77
CpG: 39,chr14,118473814,118474116,302,39,223,25.8,73.8,0.95
CpG: 18,chr14,118533924,118534141,217,18,120,16.6,55.3,1.09
CpG: 21,chr14,118611620,118611930,310,21,186,13.5,60,0.76
CpG: 96,chr14,118705781,118706547,766,96,527,25.1,68.8,1.06
CpG: 40,chr14,118854588,118855037,449,40,309,17.8,68.8,0.78
CpG: 51,chr14,118922583,118923158,575,51,378,17.7,65.7,0.82
CpG: 43,chr14,118925059,118925560,501,43,335,17.2,66.9,0.77
CpG: 118,chr14,118937549,118938542,993,118,702,23.8,70.7,0.95
CpG: 72,chr14,119098953,119099592,639,72,457,22.5,71.5,0.89
CpG: 161,chr14,119137598,119139195,1597,161,1091,20.2,68.3,0.87
CpG: 19,chr14,120058475,120058708,233,19,138,16.3,59.2,0.93
CpG: 136,chr14,120477710,120479102,1392,136,844,19.5,60.6,1.07
CpG: 16,chr14,120830574,120830788,214,16,133,15,62.1,0.83
CpG: 112,chr14,120910725,120911825,1100,112,645,20.4,58.6,1.23
CpG: 140,chr14,121035063,121036380,1317,140,905,21.3,68.7,0.9
CpG: 104,chr14,121378358,121379532,1174,104,699,17.7,59.5,1
CpG: 117,chr14,121797402,121798622,1220,117,773,19.2,63.4,0.97
CpG: 77,chr14,121878311,121879163,852,77,566,18.1,66.4,0.82
CpG: 105,chr14,122106900,122107704,804,105,588,26.1,73.1,0.98
CpG: 18,chr14,122203045,122203267,222,18,125,16.2,56.3,1.05
CpG: 56,chr14,122406527,122407139,612,56,394,18.3,64.4,0.88
CpG: 169,chr14,122463429,122465286,1857,169,1140,18.2,61.4,0.99
CpG: 203,chr14,122474008,122476299,2291,203,1347,17.7,58.8,1.03
CpG: 45,chr14,122490532,122490977,445,45,297,20.2,66.7,0.91
CpG: 46,chr14,122534139,122534686,547,46,369,16.8,67.5,0.74
CpG: 53,chr14,122912883,122913319,436,53,315,24.3,72.2,0.94
CpG: 86,chr14,122982699,122983595,896,86,546,19.2,60.9,1.03
CpG: 39,chr14,123626726,123627093,367,39,250,21.3,68.1,0.92
CpG: 68,chr15,10485668,10486508,840,68,502,16.2,59.8,0.91
CpG: 91,chr15,53345591,53346538,947,91,569,19.2,60.1,1.07
CpG: 39,chr15,3583001,3583525,524,39,294,14.9,56.1,0.97
CpG: 54,chr15,3979154,3979562,408,54,314,26.5,77,0.9
CpG: 52,chr15,3995516,3996031,515,52,352,20.2,68.3,0.9
CpG: 115,chr15,4026394,4027616,1222,115,818,18.8,66.9,0.84
CpG: 68,chr15,5116153,5117062,909,68,581,15,63.9,0.73
CpG: 93,chr15,5143492,5144220,728,93,474,25.5,65.1,1.22
CpG: 23,chr15,5185695,5185951,256,23,176,18,68.8,0.81
CpG: 49,chr15,5242329,5242792,463,49,308,21.2,66.5,0.98
CpG: 47,chr15,5243924,5244466,542,47,370,17.3,68.3,0.75
CpG: 44,chr15,6386350,6386893,543,44,321,16.2,59.1,0.93
CpG: 200,chr15,6707477,6709529,2052,200,1250,19.5,60.9,1.05
CpG: 44,chr15,6874085,6874520,435,44,298,20.2,68.5,0.87
CpG: 92,chr15,7129140,7129988,848,92,509,21.7,60,1.21
CpG: 59,chr15,7397833,7398528,695,59,463,17,66.6,0.78
CpG: 107,chr15,7810071,7811208,1137,107,771,18.8,67.8,0.82
CpG: 84,chr15,7812910,7814065,1155,84,691,14.5,59.8,0.81
CpG: 34,chr15,7815557,7815869,312,34,214,21.8,68.6,0.94
CpG: 49,chr15,8098842,8099315,473,49,323,20.7,68.3,0.89
CpG: 35,chr15,8109224,8109568,344,35,205,20.3,59.6,1.15
CpG: 54,chr15,8168930,8169448,518,54,380,20.8,73.4,0.78
CpG: 151,chr15,8443622,8445583,1961,151,1069,15.4,54.5,1.04
CpG: 57,chr15,8568749,8569494,745,57,458,15.3,61.5,0.81
CpG: 14,chr15,8636128,8636335,207,14,111,13.5,53.6,0.95
CpG: 21,chr15,8710129,8710432,303,21,175,13.9,57.8,0.83
CpG: 99,chr15,9071022,9071985,963,99,665,20.6,69.1,0.86
CpG: 71,chr15,9140266,9141139,873,71,547,16.3,62.7,0.83
CpG: 84,chr15,10469784,10470688,904,84,534,18.6,59.1,1.07
CpG: 87,chr15,10714048,10715037,989,87,637,17.6,64.4,0.87
CpG: 36,chr15,10981770,10982073,303,36,214,23.8,70.6,0.97
CpG: 37,chr15,11035894,11036411,517,37,316,14.3,61.1,0.78
CpG: 33,chr15,11037026,11037461,435,33,278,15.2,63.9,0.74
CpG: 18,chr15,11383928,11384129,201,18,129,17.9,64.2,0.9
CpG: 27,chr15,11399424,11399731,307,27,202,17.6,65.8,0.83
CpG: 153,chr15,11903851,11905677,1826,153,1150,16.8,63,0.85
CpG: 31,chr15,11906067,11906438,371,31,206,16.7,55.5,1.12
CpG: 96,chr15,11995251,11996107,856,96,615,22.4,71.8,0.87
CpG: 113,chr15,12117481,12118830,1349,113,826,16.8,61.2,0.9
CpG: 77,chr15,12204780,12205688,908,77,479,17,52.8,1.24
CpG: 90,chr15,12321519,12322423,904,90,575,19.9,63.6,0.98
CpG: 14,chr15,12372949,12373159,210,14,128,13.3,61,0.72
CpG: 60,chr15,12739312,12740114,802,60,463,15,57.7,0.9
CpG: 89,chr15,12824443,12825348,905,89,573,19.7,63.3,0.99
CpG: 16,chr15,13051272,13051487,215,16,122,14.9,56.7,0.93
CpG: 30,chr15,13173108,13173414,306,30,213,19.6,69.6,0.85
CpG: 76,chr15,25364175,25364865,690,76,399,22,57.8,1.32
CpG: 96,chr15,25412388,25413695,1307,96,816,14.7,62.4,0.76
CpG: 23,chr15,25414436,25414751,315,23,195,14.6,61.9,0.76
CpG: 114,chr15,25622212,25623450,1238,114,839,18.4,67.8,0.83
CpG: 31,chr15,25713785,25714189,404,31,244,15.3,60.4,0.85
CpG: 68,chr15,25781090,25781865,775,68,484,17.5,62.5,0.9
CpG: 60,chr15,25843038,25843573,535,60,381,22.4,71.2,0.89
CpG: 129,chr15,25984005,25985277,1272,129,818,20.3,64.3,0.98
CpG: 114,chr15,26308646,26309682,1036,114,746,22,72,0.88
CpG: 24,chr15,26543389,26543737,348,24,199,13.8,57.2,0.85
CpG: 94,chr15,26894904,26895771,867,94,623,21.7,71.9,0.84
CpG: 86,chr15,27466247,27467326,1079,86,575,15.9,53.3,1.13
CpG: 52,chr15,27630461,27630870,409,52,278,25.4,68,1.1
CpG: 17,chr15,27665505,27665735,230,17,132,14.8,57.4,0.91
CpG: 73,chr15,27681189,27681779,590,73,421,24.7,71.4,1
CpG: 25,chr15,27747663,27748022,359,25,230,13.9,64.1,0.71
CpG: 22,chr15,27773850,27774075,225,22,145,19.6,64.4,0.95
CpG: 213,chr15,28024209,28026277,2068,213,1334,20.6,64.5,0.99
CpG: 134,chr15,30172358,30173548,1190,134,779,22.5,65.5,1.05
CpG: 68,chr15,30646537,30647251,714,68,450,19,63,1.02
CpG: 70,chr15,31224121,31224744,623,70,441,22.5,70.8,0.9
CpG: 101,chr15,31367028,31368006,978,101,674,20.7,68.9,0.87
CpG: 52,chr15,31453362,31453883,521,52,345,20,66.2,0.92
CpG: 135,chr15,31530286,31531449,1163,135,730,23.2,62.8,1.18
CpG: 92,chr15,31601265,31602255,990,92,599,18.6,60.5,1.02
CpG: 101,chr15,32244785,32246205,1420,101,900,14.2,63.4,0.71
CpG: 22,chr15,32778969,32779211,242,22,140,18.2,57.9,1.09
CpG: 27,chr15,32920846,32921136,290,27,174,18.6,60,1.04
CpG: 69,chr15,33687286,33687929,643,69,451,21.5,70.1,0.88
CpG: 112,chr15,34082235,34083336,1101,112,746,20.3,67.8,0.89
CpG: 80,chr15,34238040,34238769,729,80,497,21.9,68.2,0.95
CpG: 53,chr15,34306631,34307128,497,53,351,21.3,70.6,0.86
CpG: 65,chr15,34442921,34443694,773,65,487,16.8,63,0.85
CpG: 29,chr15,34495235,34495543,308,29,198,18.8,64.3,0.92
CpG: 60,chr15,34678370,34678857,487,60,358,24.6,73.5,0.91
CpG: 71,chr15,34837348,34837934,586,71,419,24.2,71.5,0.95
CpG: 77,chr15,35155284,35155995,711,77,490,21.7,68.9,0.93
CpG: 47,chr15,35293626,35294206,580,47,372,16.2,64.1,0.79
CpG: 70,chr15,35295983,35296887,904,70,563,15.5,62.3,0.8
CpG: 41,chr15,35326487,35326847,360,41,260,22.8,72.2,0.91
CpG: 81,chr15,35371186,35371845,659,81,461,24.6,70,1
CpG: 54,chr15,35937639,35938257,618,54,408,17.5,66,0.81
CpG: 31,chr15,36140274,36140581,307,31,228,20.2,74.3,0.74
CpG: 52,chr15,36164662,36165153,491,52,360,21.2,73.3,0.8
CpG: 44,chr15,36210420,36210805,385,44,273,22.9,70.9,0.92
CpG: 116,chr15,36282440,36283476,1036,116,638,22.4,61.6,1.19
CpG: 66,chr15,36496265,36496901,636,66,430,20.8,67.6,0.91
CpG: 164,chr15,36608050,36609696,1646,164,978,19.9,59.4,1.13
CpG: 191,chr15,36792385,36794379,1994,191,1318,19.2,66.1,0.88
CpG: 46,chr15,36938615,36939058,443,46,283,20.8,63.9,1.03
CpG: 102,chr15,37006933,37007797,864,102,575,23.6,66.6,1.08
CpG: 41,chr15,37135477,37136021,544,41,336,15.1,61.8,0.8
CpG: 26,chr15,37175906,37176318,412,26,265,12.6,64.3,0.63
CpG: 120,chr15,37232987,37234441,1454,120,891,16.5,61.3,0.88
CpG: 25,chr15,37279449,37279724,275,25,168,18.2,61.1,0.98
CpG: 72,chr15,37791432,37792179,747,72,521,19.3,69.7,0.81
CpG: 63,chr15,37960656,37961398,742,63,464,17,62.5,0.91
CpG: 123,chr15,38077944,38079117,1173,123,711,21,60.6,1.15
CpG: 235,chr15,38298999,38301693,2694,235,1762,17.4,65.4,0.82
CpG: 67,chr15,38470458,38471124,666,67,483,20.1,72.5,0.77
CpG: 31,chr15,38473499,38473829,330,31,243,18.8,73.6,0.69
CpG: 148,chr15,38518262,38519727,1465,148,990,20.2,67.6,0.88
CpG: 51,chr15,38661790,38662205,415,51,299,24.6,72,0.95
CpG: 17,chr15,38701176,38701400,224,17,141,15.2,62.9,0.77
CpG: 43,chr15,38990102,38990436,334,43,229,25.7,68.6,1.1
CpG: 60,chr15,39006076,39006698,622,60,381,19.3,61.3,1.03
CpG: 27,chr15,39076767,39077097,330,27,230,16.4,69.7,0.68
CpG: 90,chr15,39112321,39113188,867,90,582,20.8,67.1,0.92
CpG: 212,chr15,39197075,39199167,2092,212,1358,20.3,64.9,0.97
CpG: 23,chr15,39857118,39857347,229,23,148,20.1,64.6,0.97
CpG: 129,chr15,39943217,39944364,1147,129,785,22.5,68.4,0.96
CpG: 94,chr15,40654873,40655846,973,94,615,19.3,63.2,0.98
CpG: 77,chr15,41447161,41447729,568,77,424,27.1,74.6,0.97
CpG: 72,chr15,41788815,41789416,601,72,404,24,67.2,1.07
CpG: 51,chr15,43170238,43170696,458,51,309,22.3,67.5,0.98
CpG: 55,chr15,43282256,43282824,568,55,368,19.4,64.8,0.94
CpG: 35,chr15,43477167,43477610,443,35,267,15.8,60.3,0.87
CpG: 65,chr15,44427443,44428332,889,65,544,14.6,61.2,0.78
CpG: 90,chr15,44619108,44619877,769,90,550,23.4,71.5,0.92
CpG: 31,chr15,44748436,44748702,266,31,176,23.3,66.2,1.09
CpG: 33,chr15,44787667,44787929,262,33,191,25.2,72.9,0.95
CpG: 47,chr15,45114269,45114877,608,47,391,15.5,64.3,0.75
CpG: 29,chr15,48789757,48790134,377,29,216,15.4,57.3,0.95
CpG: 34,chr15,50869482,50869839,357,34,248,19,69.5,0.79
CpG: 19,chr15,50889914,50890144,230,19,125,16.5,54.3,1.12
CpG: 49,chr15,51865129,51865666,537,49,355,18.2,66.1,0.84
CpG: 41,chr15,51877270,51877796,526,41,319,15.6,60.6,0.85
CpG: 103,chr15,51991000,51991973,973,103,638,21.2,65.6,0.99
CpG: 56,chr15,52040030,52040580,550,56,352,20.4,64,1
CpG: 49,chr15,52712361,52712754,393,49,279,24.9,71,0.99
CpG: 20,chr15,53344948,53345212,264,20,141,15.2,53.4,1.07
CpG: 17,chr15,53902440,53902649,209,17,128,16.3,61.2,0.93
CpG: 33,chr15,54571291,54571623,332,33,186,19.9,56,1.28
CpG: 22,chr15,54746045,54746301,256,22,165,17.2,64.5,0.86
CpG: 32,chr15,54952361,54952693,332,32,236,19.3,71.1,0.76
CpG: 37,chr15,55071916,55072237,321,37,229,23.1,71.3,0.91
CpG: 48,chr15,55090139,55090558,419,48,292,22.9,69.7,0.94
CpG: 58,chr15,55112229,55112906,677,58,413,17.1,61,0.92
CpG: 59,chr15,55557210,55557849,639,59,390,18.5,61,1
CpG: 63,chr15,55906297,55907107,810,63,496,15.6,61.2,0.83
CpG: 24,chr15,57694111,57694392,281,24,172,17.1,61.2,0.91
CpG: 89,chr15,57694872,57695894,1022,89,589,17.4,57.6,1.06
CpG: 62,chr15,57892027,57892605,578,62,391,21.5,67.6,0.94
CpG: 40,chr15,57912107,57912499,392,40,266,20.4,67.9,0.93
CpG: 16,chr15,57940020,57940226,206,16,125,15.5,60.7,0.87
CpG: 57,chr15,58033858,58034371,513,57,361,22.2,70.4,0.91
CpG: 140,chr15,58075672,58077186,1514,140,1043,18.5,68.9,0.81
CpG: 94,chr15,58134492,58135397,905,94,608,20.8,67.2,0.92
CpG: 38,chr15,58141294,58141643,349,38,240,21.8,68.8,0.93
CpG: 56,chr15,58214479,58215086,607,56,378,18.5,62.3,0.95
CpG: 56,chr15,58415331,58415902,571,56,354,19.6,62,1.03
CpG: 139,chr15,58822703,58824097,1394,139,945,19.9,67.8,0.87
CpG: 41,chr15,58872546,58873094,548,41,322,15,58.8,0.89
CpG: 105,chr15,58888711,58889742,1031,105,642,20.4,62.3,1.05
CpG: 42,chr15,58933575,58933986,411,42,280,20.4,68.1,0.88
CpG: 127,chr15,59081277,59082537,1260,127,810,20.2,64.3,0.98
CpG: 83,chr15,59314628,59315325,697,83,496,23.8,71.2,0.94
CpG: 44,chr15,59373959,59374401,442,44,281,19.9,63.6,0.99
CpG: 186,chr15,59647522,59649610,2088,186,1366,17.8,65.4,0.83
CpG: 165,chr15,60822970,60825075,2105,165,1309,15.7,62.2,0.81
CpG: 221,chr15,61984948,61988216,3268,221,1869,13.5,57.2,0.83
CpG: 31,chr15,62037917,62038184,267,31,188,23.2,70.4,0.94
CpG: 89,chr15,63997557,63998404,847,89,535,21,63.2,1.08
CpG: 81,chr15,64059993,64060807,814,81,502,19.9,61.7,1.05
CpG: 94,chr15,64312263,64313213,950,94,532,19.8,56,1.26
CpG: 86,chr15,64382175,64383019,844,86,538,20.4,63.7,1
CpG: 149,chr15,64920735,64922685,1950,149,1250,15.3,64.1,0.75
CpG: 99,chr15,65786963,65787734,771,99,544,25.7,70.6,1.04
CpG: 98,chr15,66285781,66286905,1124,98,696,17.4,61.9,0.91
CpG: 77,chr15,66577479,66578126,647,77,419,23.8,64.8,1.16
CpG: 113,chr15,66968584,66970105,1521,113,975,14.9,64.1,0.73
CpG: 17,chr15,67175470,67175675,205,17,117,16.6,57.1,1.03
CpG: 24,chr15,67175921,67176197,276,24,181,17.4,65.6,0.81
CpG: 65,chr15,67176740,67177521,781,65,521,16.6,66.7,0.75
CpG: 87,chr15,68258320,68259166,846,87,533,20.6,63,1.04
CpG: 186,chr15,72545925,72547811,1886,186,1247,19.7,66.1,0.91
CpG: 44,chr15,72809537,72810123,586,44,338,15,57.7,0.9
CpG: 38,chr15,73058048,73058500,452,38,269,16.8,59.5,0.96
CpG: 22,chr15,73060919,73061124,205,22,144,21.5,70.2,0.87
CpG: 88,chr15,73090254,73090909,655,88,469,26.9,71.6,1.05
CpG: 136,chr15,73184091,73185471,1380,136,789,19.7,57.2,1.2
CpG: 123,chr15,73422560,73423461,901,123,628,27.3,69.7,1.12
CpG: 45,chr15,73512350,73512836,486,45,345,18.5,71,0.75
CpG: 20,chr15,73547402,73547651,249,20,146,16.1,58.6,0.94
CpG: 71,chr15,73645273,73645992,719,71,445,19.7,61.9,1.04
CpG: 24,chr15,73695832,73696110,278,24,182,17.3,65.5,0.81
CpG: 38,chr15,73748195,73748625,430,38,250,17.7,58.1,1.05
CpG: 21,chr15,73809715,73809928,213,21,132,19.7,62,1.03
CpG: 87,chr15,73839369,73839970,601,87,447,29,74.4,1.07
CpG: 42,chr15,74487261,74487815,554,42,352,15.2,63.5,0.75
CpG: 286,chr15,74516053,74519799,3746,286,2382,15.3,63.6,0.76
CpG: 25,chr15,74529231,74529538,307,25,191,16.3,62.2,0.84
CpG: 34,chr15,74563907,74564167,260,34,168,26.2,64.6,1.29
CpG: 73,chr15,74671938,74672803,865,73,578,16.9,66.8,0.76
CpG: 59,chr15,74709023,74709594,571,59,384,20.7,67.3,0.91
CpG: 102,chr15,74720990,74721863,873,102,594,23.4,68,1.01
CpG: 19,chr15,74799698,74799953,255,19,159,14.9,62.4,0.78
CpG: 30,chr15,74955437,74955850,413,30,276,14.5,66.8,0.65
CpG: 78,chr15,75566464,75567062,598,78,453,26.1,75.8,0.91
CpG: 77,chr15,75616126,75616951,825,77,553,18.7,67,0.85
CpG: 24,chr15,75642261,75642522,261,24,167,18.4,64,0.91
CpG: 24,chr15,75678624,75678885,261,24,184,18.4,70.5,0.75
CpG: 43,chr15,75703981,75704540,559,43,354,15.4,63.3,0.77
CpG: 18,chr15,75713267,75713500,233,18,147,15.5,63.1,0.78
CpG: 38,chr15,75731604,75732011,407,38,282,18.7,69.3,0.82
CpG: 187,chr15,75746051,75748164,2113,187,1283,17.7,60.7,0.96
CpG: 62,chr15,75841554,75842095,541,62,359,22.9,66.4,1.05
CpG: 26,chr15,75862126,75862440,314,26,190,16.6,60.5,0.91
CpG: 22,chr15,75884092,75884350,258,22,163,17.1,63.2,0.88
CpG: 38,chr15,75893947,75894363,416,38,268,18.3,64.4,0.88
CpG: 173,chr15,75908825,75910851,2026,173,1244,17.1,61.4,0.91
CpG: 21,chr15,75921298,75921551,253,21,166,16.6,65.6,0.81
CpG: 31,chr15,75929488,75929942,454,31,281,13.7,61.9,0.71
CpG: 70,chr15,75940872,75941473,601,70,420,23.3,69.9,0.96
CpG: 50,chr15,75969057,75969509,452,50,301,22.1,66.6,1
CpG: 29,chr15,75974726,75975123,397,29,247,14.6,62.2,0.76
CpG: 92,chr15,75981448,75982225,777,92,518,23.7,66.7,1.07
CpG: 19,chr15,75993677,75993948,271,19,175,14,64.6,0.68
CpG: 116,chr15,75997522,75999000,1478,116,995,15.7,67.3,0.7
CpG: 109,chr15,76002957,76004677,1720,109,1094,12.7,63.6,0.63
CpG: 70,chr15,76009062,76009905,843,70,516,16.6,61.2,0.91
CpG: 65,chr15,76034371,76035090,719,65,485,18.1,67.5,0.81
CpG: 86,chr15,76069103,76069883,780,86,491,22.1,62.9,1.11
CpG: 94,chr15,76080388,76081110,722,94,512,26,70.9,1.04
CpG: 28,chr15,76090265,76090659,394,28,257,14.2,65.2,0.69
CpG: 25,chr15,76091588,76091804,216,25,160,23.1,74.1,0.86
CpG: 26,chr15,76172305,76172632,327,26,212,15.9,64.8,0.76
CpG: 28,chr15,76173076,76173438,362,28,210,15.5,58,0.92
CpG: 62,chr15,76174147,76175124,977,62,604,12.7,61.8,0.66
CpG: 50,chr15,76176731,76177408,677,50,419,14.8,61.9,0.77
CpG: 238,chr15,76178573,76181907,3334,238,2190,14.3,65.7,0.7
CpG: 22,chr15,76183532,76183795,263,22,167,16.7,63.5,0.85
CpG: 30,chr15,76197966,76198334,368,30,249,16.3,67.7,0.73
CpG: 64,chr15,76229146,76229943,797,64,513,16.1,64.4,0.78
CpG: 68,chr15,76231985,76232943,958,68,620,14.2,64.7,0.68
CpG: 46,chr15,76246768,76247202,434,46,309,21.2,71.2,0.84
CpG: 60,chr15,76294355,76295259,904,60,554,13.3,61.3,0.71
CpG: 50,chr15,76327215,76327728,513,50,315,19.5,61.4,1.04
CpG: 47,chr15,76330999,76331524,525,47,340,17.9,64.8,0.86
CpG: 22,chr15,76331840,76332116,276,22,173,15.9,62.7,0.82
CpG: 65,chr15,76343466,76343982,516,65,377,25.2,73.1,0.95
CpG: 110,chr15,76350430,76351727,1297,110,809,17,62.4,0.87
CpG: 75,chr15,76368838,76369595,757,75,519,19.8,68.6,0.85
CpG: 25,chr15,76380219,76380523,304,25,189,16.4,62.2,0.88
CpG: 24,chr15,76380757,76381096,339,24,192,14.2,56.6,0.88
CpG: 83,chr15,76457392,76458130,738,83,532,22.5,72.1,0.87
CpG: 72,chr15,76477162,76477911,749,72,520,19.2,69.4,0.8
CpG: 69,chr15,76511570,76512071,501,69,363,27.5,72.5,1.06
CpG: 194,chr15,76517581,76519787,2206,194,1465,17.6,66.4,0.8
CpG: 141,chr15,76522004,76523889,1885,141,1220,15,64.7,0.72
CpG: 82,chr15,76538046,76539019,973,82,623,16.9,64,0.82
CpG: 17,chr15,76540863,76541094,231,17,141,14.7,61,0.8
CpG: 30,chr15,76576291,76576551,260,30,184,23.1,70.8,0.92
CpG: 49,chr15,76607300,76607694,394,49,266,24.9,67.5,1.09
CpG: 24,chr15,76631819,76632140,321,24,205,15,63.9,0.73
CpG: 19,chr15,76639777,76640027,250,19,152,15.2,60.8,0.93
CpG: 51,chr15,76656774,76657248,474,51,342,21.5,72.2,0.83
CpG: 21,chr15,76659685,76659905,220,21,157,19.1,71.4,0.76
CpG: 54,chr15,76660100,76660751,651,54,420,16.6,64.5,0.84
CpG: 30,chr15,76666937,76667310,373,30,244,16.1,65.4,0.75
CpG: 45,chr15,76671545,76671944,399,45,297,22.6,74.4,0.82
CpG: 22,chr15,76697862,76698082,220,22,142,20,64.5,0.97
CpG: 26,chr15,76701486,76701868,382,26,234,13.6,61.3,0.73
CpG: 86,chr15,76710137,76710999,862,86,575,20,66.7,0.9
CpG: 37,chr15,76715489,76715973,484,37,295,15.3,61,0.83
CpG: 70,chr15,76722137,76722934,797,70,526,17.6,66,0.81
CpG: 46,chr15,76723403,76724059,656,46,397,14,60.5,0.77
CpG: 33,chr15,76724721,76725095,374,33,243,17.6,65,0.84
CpG: 121,chr15,76817113,76818347,1234,121,871,19.6,70.6,0.83
CpG: 63,chr15,76870805,76871545,740,63,489,17,66.1,0.78
CpG: 22,chr15,76879218,76879495,277,22,171,15.9,61.7,0.87
CpG: 61,chr15,76904006,76904671,665,61,404,18.3,60.8,1
CpG: 46,chr15,76911248,76911879,631,46,381,14.6,60.4,0.8
CpG: 60,chr15,76925150,76925767,617,60,433,19.4,70.2,0.79
CpG: 47,chr15,76948411,76948997,586,47,356,16,60.8,0.87
CpG: 97,chr15,77306231,77307249,1018,97,607,19.1,59.6,1.07
CpG: 16,chr15,77370115,77370325,210,16,113,15.2,53.8,1.05
CpG: 133,chr15,77841180,77842605,1425,133,959,18.7,67.3,0.83
CpG: 19,chr15,77857699,77857945,246,19,156,15.4,63.4,0.78
CpG: 24,chr15,77928841,77929138,297,24,188,16.2,63.3,0.81
CpG: 85,chr15,77955711,77956835,1124,85,727,15.1,64.7,0.72
CpG: 72,chr15,77970440,77971205,765,72,483,18.8,63.1,0.94
CpG: 40,chr15,77995104,77995554,450,40,300,17.8,66.7,0.84
CpG: 61,chr15,78119597,78120185,588,61,414,20.7,70.4,0.84
CpG: 16,chr15,78174277,78174501,224,16,135,14.3,60.3,0.79
CpG: 28,chr15,78204225,78204514,289,28,204,19.4,70.6,0.78
CpG: 21,chr15,78405626,78405862,236,21,148,17.8,62.7,0.91
CpG: 28,chr15,78406315,78406690,375,28,227,14.9,60.5,0.82
CpG: 64,chr15,78410074,78410683,609,64,393,21,64.5,1.02
CpG: 29,chr15,78428633,78428939,306,29,199,19,65,0.91
CpG: 25,chr15,78436813,78437123,310,25,224,16.1,72.3,0.62
CpG: 30,chr15,78539511,78539843,332,30,214,18.1,64.5,0.88
CpG: 50,chr15,78671939,78672648,709,50,463,14.1,65.3,0.67
CpG: 25,chr15,78672946,78673306,360,25,219,13.9,60.8,0.75
CpG: 31,chr15,78712773,78713098,325,31,174,19.1,53.5,1.33
CpG: 29,chr15,78718605,78718878,273,29,201,21.2,73.6,0.79
CpG: 19,chr15,78799095,78799374,279,19,187,13.6,67,0.63
CpG: 119,chr15,78802368,78803202,834,119,637,28.5,76.4,1.01
CpG: 26,chr15,78820781,78820984,203,26,139,25.6,68.5,1.09
CpG: 67,chr15,78842418,78843139,721,67,449,18.6,62.3,0.97
CpG: 16,chr15,78847491,78847711,220,16,138,14.5,62.7,0.77
CpG: 83,chr15,78877061,78877865,804,83,487,20.6,60.6,1.13
CpG: 47,chr15,78899457,78900015,558,47,344,16.8,61.6,0.89
CpG: 129,chr15,78913720,78914620,900,129,646,28.7,71.8,1.11
CpG: 20,chr15,78928020,78928259,239,20,155,16.7,64.9,0.8
CpG: 43,chr15,78934900,78935350,450,43,285,19.1,63.3,0.95
CpG: 24,chr15,78947735,78948013,278,24,175,17.3,62.9,0.87
CpG: 25,chr15,78967704,78968007,303,25,193,16.5,63.7,0.94
CpG: 50,chr15,78982709,78983320,611,50,354,16.4,57.9,0.98
CpG: 22,chr15,78992999,78993239,240,22,160,18.3,66.7,0.83
CpG: 97,chr15,79027892,79028861,969,97,667,20,68.8,0.85
CpG: 49,chr15,79030544,79031116,572,49,361,17.1,63.1,0.87
CpG: 102,chr15,79042665,79043393,728,102,518,28,71.2,1.13
CpG: 75,chr15,79062396,79062972,576,75,408,26,70.8,1.05
CpG: 42,chr15,79075135,79075494,359,42,248,23.4,69.1,0.98
CpG: 86,chr15,79108814,79109661,847,86,532,20.3,62.8,1.03
CpG: 58,chr15,79140843,79141472,629,58,396,18.4,63,0.93
CpG: 63,chr15,79163248,79163951,703,63,450,17.9,64,0.88
CpG: 44,chr15,79229174,79229693,519,44,343,17,66.1,0.78
CpG: 84,chr15,79251864,79252763,899,84,611,18.7,68,0.81
CpG: 89,chr15,79261072,79262022,950,89,658,18.7,69.3,0.79
CpG: 20,chr15,79270428,79270640,212,20,143,18.9,67.5,0.83
CpG: 24,chr15,79328245,79328489,244,24,162,19.7,66.4,0.9
CpG: 90,chr15,79347309,79348233,924,90,600,19.5,64.9,0.94
CpG: 62,chr15,79357313,79357816,503,62,331,24.7,65.8,1.16
CpG: 80,chr15,79402817,79403450,633,80,461,25.3,72.8,0.96
CpG: 66,chr15,79441492,79442137,645,66,374,20.5,58,1.27
CpG: 36,chr15,79485324,79485795,471,36,287,15.3,60.9,0.83
CpG: 97,chr15,79505148,79506145,997,97,610,19.5,61.2,1.04
CpG: 48,chr15,79511572,79512016,444,48,292,21.6,65.8,1.02
CpG: 53,chr15,79516277,79516758,481,53,315,22,65.5,1.04
CpG: 130,chr15,79545998,79547141,1143,130,753,22.7,65.9,1.05
CpG: 28,chr15,79604886,79605119,233,28,147,24,63.1,1.26
CpG: 61,chr15,79658655,79659420,765,61,473,15.9,61.8,0.84
CpG: 67,chr15,79670759,79671374,615,67,422,21.8,68.6,0.93
CpG: 112,chr15,79687330,79688220,890,112,634,25.2,71.2,0.99
CpG: 74,chr15,79690759,79691405,646,74,425,22.9,65.8,1.06
CpG: 92,chr15,79742139,79742880,741,92,482,24.8,65,1.19
CpG: 36,chr15,79774227,79774627,400,36,267,18,66.8,0.81
CpG: 139,chr15,79803781,79804965,1184,139,790,23.5,66.7,1.06
CpG: 36,chr15,79828604,79829021,417,36,278,17.3,66.7,0.79
CpG: 54,chr15,79834017,79834501,484,54,323,22.3,66.7,1
CpG: 23,chr15,79883409,79883635,226,23,161,20.4,71.2,0.81
CpG: 24,chr15,79927777,79928048,271,24,181,17.7,66.8,0.79
CpG: 57,chr15,79932385,79932801,416,57,306,27.4,73.6,1.02
CpG: 17,chr15,79933429,79933638,209,17,131,16.3,62.7,0.84
CpG: 20,chr15,80001637,80001856,219,20,145,18.3,66.2,0.84
CpG: 179,chr15,80012334,80014805,2471,179,1505,14.5,60.9,0.78
CpG: 36,chr15,80083159,80083585,426,36,237,16.9,55.6,1.09
CpG: 67,chr15,80091111,80091883,772,67,466,17.4,60.4,0.95
CpG: 60,chr15,80133017,80133591,574,60,391,20.9,68.1,0.9
CpG: 90,chr15,80173238,80174282,1044,90,594,17.2,56.9,1.07
CpG: 46,chr15,80211358,80211956,598,46,374,15.4,62.5,0.79
CpG: 19,chr15,80212122,80212389,267,19,163,14.2,61,0.77
CpG: 60,chr15,80233876,80234421,545,60,384,22,70.5,0.89
CpG: 99,chr15,80255094,80256136,1042,99,663,19,63.6,0.94
CpG: 56,chr15,80263905,80264458,553,56,366,20.3,66.2,0.93
CpG: 102,chr15,80287124,80288381,1257,102,725,16.2,57.7,0.98
CpG: 37,chr15,80372166,80372656,490,37,330,15.1,67.3,0.67
CpG: 66,chr15,80671431,80672139,708,66,476,18.6,67.2,0.83
CpG: 130,chr15,80710963,80712149,1186,130,793,21.9,66.9,1.03
CpG: 52,chr15,80948113,80948758,645,52,395,16.1,61.2,0.86
CpG: 63,chr15,80977727,80978251,524,63,379,24,72.3,0.93
CpG: 84,chr15,81190166,81191037,871,84,592,19.3,68,0.84
CpG: 27,chr15,81360570,81360946,376,27,231,14.4,61.4,0.78
CpG: 65,chr15,81399335,81400166,831,65,522,15.6,62.8,0.8
CpG: 59,chr15,81466197,81466957,760,59,488,15.5,64.2,0.8
CpG: 33,chr15,81523003,81523405,402,33,281,16.4,69.9,0.67
CpG: 155,chr15,81585125,81586774,1649,155,1054,18.8,63.9,0.92
CpG: 26,chr15,81663844,81664100,256,26,164,20.3,64.1,1.02
CpG: 18,chr15,81664283,81664525,242,18,138,14.9,57,0.92
CpG: 155,chr15,81693572,81695044,1472,155,1080,21.1,73.4,0.79
CpG: 84,chr15,81729285,81730210,925,84,591,18.2,63.9,0.89
CpG: 37,chr15,81745014,81745344,330,37,211,22.4,63.9,1.1
CpG: 27,chr15,81745743,81746031,288,27,198,18.8,68.8,0.83
CpG: 20,chr15,81771790,81772012,222,20,153,18,68.9,0.84
CpG: 103,chr15,81810601,81811771,1170,103,736,17.6,62.9,0.89
CpG: 16,chr15,81856168,81856385,217,16,132,14.7,60.8,0.81
CpG: 63,chr15,81857785,81858553,768,63,489,16.4,63.7,0.81
CpG: 21,chr15,81859067,81859271,204,21,135,20.6,66.2,0.94
CpG: 18,chr15,81859644,81859877,233,18,126,15.5,54.1,1.1
CpG: 39,chr15,81872316,81872762,446,39,285,17.5,63.9,0.86
CpG: 50,chr15,81925826,81926377,551,50,372,18.1,67.5,0.8
CpG: 75,chr15,81960281,81961112,831,75,534,18.1,64.3,0.88
CpG: 30,chr15,81980459,81980818,359,30,218,16.7,60.7,0.92
CpG: 69,chr15,82015897,82016579,682,69,461,20.2,67.6,0.91
CpG: 75,chr15,82046980,82047649,669,75,450,22.4,67.3,1.01
CpG: 40,chr15,82070004,82070309,305,40,216,26.2,70.8,1.05
CpG: 65,chr15,82127653,82128348,695,65,453,18.7,65.2,0.88
CpG: 118,chr15,82146885,82147958,1073,118,729,22,67.9,0.97
CpG: 65,chr15,82207158,82207889,731,65,491,17.8,67.2,0.81
CpG: 127,chr15,82211859,82212960,1101,127,717,23.1,65.1,1.09
CpG: 18,chr15,82224180,82224403,223,18,143,16.1,64.1,0.79
CpG: 65,chr15,82244142,82244794,652,65,437,19.9,67,0.89
CpG: 29,chr15,82274943,82275216,273,29,192,21.2,70.3,0.86
CpG: 36,chr15,82338754,82339079,325,36,223,22.2,68.6,0.95
CpG: 44,chr15,82340991,82341413,422,44,309,20.9,73.2,0.79
CpG: 47,chr15,82345859,82346310,451,47,302,20.8,67,0.95
CpG: 68,chr15,82353923,82354675,752,68,483,18.1,64.2,0.88
CpG: 108,chr15,82898793,82900007,1214,108,730,17.8,60.1,1.01
CpG: 31,chr15,82911627,82911981,354,31,254,17.5,71.8,0.7
CpG: 21,chr15,82963242,82963451,209,21,123,20.1,58.9,1.17
CpG: 28,chr15,82987200,82987524,324,28,211,17.3,65.1,0.88
CpG: 22,chr15,83056531,83056837,306,22,191,14.4,62.4,0.74
CpG: 49,chr15,83122357,83122862,505,49,336,19.4,66.5,0.88
CpG: 73,chr15,83148850,83149431,581,73,420,25.1,72.3,0.97
CpG: 63,chr15,83171713,83172374,661,63,445,19.1,67.3,0.85
CpG: 71,chr15,83251083,83251828,745,71,521,19.1,69.9,0.79
CpG: 61,chr15,83349950,83350539,589,61,405,20.7,68.8,0.88
CpG: 63,chr15,83366863,83367533,670,63,437,18.8,65.2,0.91
CpG: 38,chr15,83464171,83464553,382,38,213,19.9,55.8,1.29
CpG: 20,chr15,83489523,83489733,210,20,121,19,57.6,1.22
CpG: 27,chr15,83510816,83511034,218,27,145,24.8,66.5,1.15
CpG: 75,chr15,83526605,83527545,940,75,608,16,64.7,0.76
CpG: 64,chr15,83555241,83555754,513,64,379,25,73.9,0.92
CpG: 59,chr15,83594689,83595267,578,59,378,20.4,65.4,0.96
CpG: 92,chr15,83724482,83725238,756,92,543,24.3,71.8,0.94
CpG: 55,chr15,84105448,84105929,481,55,315,22.9,65.5,1.07
CpG: 49,chr15,84167757,84168291,534,49,352,18.4,65.9,0.85
CpG: 37,chr15,84192062,84192488,426,37,283,17.4,66.4,0.8
CpG: 42,chr15,84231912,84232333,421,42,300,20,71.3,0.79
CpG: 15,chr15,84406549,84406755,206,15,127,14.6,61.7,0.77
CpG: 49,chr15,84446017,84446399,382,49,289,25.7,75.7,0.94
CpG: 52,chr15,84557416,84557876,460,52,327,22.6,71.1,0.9
CpG: 43,chr15,84663134,84663440,306,43,230,28.1,75.2,1.07
CpG: 89,chr15,84680904,84681714,810,89,580,22,71.6,0.86
CpG: 251,chr15,84853463,84856560,3097,251,1843,16.2,59.5,0.91
CpG: 124,chr15,84922961,84924068,1107,124,755,22.4,68.2,0.96
CpG: 29,chr15,84987556,84987785,229,29,142,25.3,62,1.34
CpG: 65,chr15,85036799,85037283,484,65,342,26.9,70.7,1.1
CpG: 49,chr15,85131665,85132180,515,49,329,19,63.9,0.94
CpG: 41,chr15,85206017,85206390,373,41,275,22,73.7,0.83
CpG: 65,chr15,85336122,85336899,777,65,515,16.7,66.3,0.76
CpG: 17,chr15,85510565,85510766,201,17,129,16.9,64.2,0.83
CpG: 42,chr15,85537341,85537789,448,42,294,18.8,65.6,0.87
CpG: 18,chr15,85543705,85543907,202,18,127,17.8,62.9,0.92
CpG: 131,chr15,85576298,85578144,1846,131,1165,14.2,63.1,0.72
CpG: 175,chr15,85580411,85582062,1651,175,1091,21.2,66.1,0.97
CpG: 70,chr15,85625626,85626162,536,70,393,26.1,73.3,0.97
CpG: 53,chr15,85634422,85635033,611,53,412,17.3,67.4,0.77
CpG: 26,chr15,85645974,85646308,334,26,212,15.6,63.5,0.78
CpG: 34,chr15,85660761,85661096,335,34,232,20.3,69.3,0.85
CpG: 201,chr15,85670332,85672100,1768,201,1137,22.7,64.3,1.1
CpG: 120,chr15,85734824,85736079,1255,120,887,19.1,70.7,0.77
CpG: 58,chr15,85811149,85811955,806,58,499,14.4,61.9,0.78
CpG: 56,chr15,85821436,85821894,458,56,346,24.5,75.5,0.86
CpG: 21,chr15,85832229,85832474,245,21,152,17.1,62,0.94
CpG: 36,chr15,85859679,85860044,365,36,239,19.7,65.5,0.93
CpG: 45,chr15,85878996,85879453,457,45,307,19.7,67.2,0.87
CpG: 30,chr15,85978642,85979038,396,30,242,15.2,61.1,0.83
CpG: 35,chr15,86031208,86031677,469,35,284,14.9,60.6,0.82
CpG: 163,chr15,86032465,86034199,1734,163,1085,18.8,62.6,0.96
CpG: 105,chr15,86058486,86059218,732,105,521,28.7,71.2,1.14
CpG: 60,chr15,86185289,86185821,532,60,357,22.6,67.1,1.01
CpG: 75,chr15,86213884,86214718,834,75,540,18,64.7,0.86
CpG: 119,chr15,87544014,87545233,1219,119,736,19.5,60.4,1.07
CpG: 196,chr15,87624070,87625706,1636,196,1072,24,65.5,1.12
CpG: 144,chr15,88751169,88752424,1255,144,779,22.9,62.1,1.19
CpG: 97,chr15,88819049,88820117,1068,97,669,18.2,62.6,0.93
CpG: 19,chr15,88837432,88837638,206,19,145,18.4,70.4,0.75
CpG: 231,chr15,88861825,88863864,2039,231,1374,22.7,67.4,1
CpG: 28,chr15,88890660,88890981,321,28,222,17.4,69.2,0.73
CpG: 51,chr15,88954448,88955003,555,51,375,18.4,67.6,0.83
CpG: 30,chr15,88982749,88983169,420,30,274,14.3,65.2,0.68
CpG: 35,chr15,89060095,89060423,328,35,229,21.3,69.8,0.88
CpG: 79,chr15,89067581,89068614,1033,79,626,15.3,60.6,0.84
CpG: 16,chr15,89076234,89076459,225,16,146,14.2,64.9,0.68
CpG: 96,chr15,89088970,89089753,783,96,563,24.5,71.9,0.95
CpG: 46,chr15,89122928,89123448,520,46,319,17.7,61.3,0.94
CpG: 24,chr15,89128456,89128782,326,24,193,14.7,59.2,0.85
CpG: 64,chr15,89140089,89140792,703,64,479,18.2,68.1,0.8
CpG: 41,chr15,89146448,89146977,529,41,332,15.5,62.8,0.79
CpG: 37,chr15,89149271,89149579,308,37,224,24,72.7,0.93
CpG: 46,chr15,89160438,89161110,672,46,415,13.7,61.8,0.72
CpG: 25,chr15,89167457,89167709,252,25,164,19.8,65.1,0.94
CpG: 57,chr15,89173048,89173700,652,57,438,17.5,67.2,0.78
CpG: 85,chr15,89180327,89181243,916,85,553,18.6,60.4,1.02
CpG: 59,chr15,89196014,89196641,627,59,425,18.8,67.8,0.83
CpG: 63,chr15,89211299,89211950,651,63,383,19.4,58.8,1.13
CpG: 86,chr15,89314658,89315550,892,86,616,19.3,69.1,0.82
CpG: 56,chr15,89355317,89356036,719,56,465,15.6,64.7,0.75
CpG: 68,chr15,89373511,89374175,664,68,440,20.5,66.3,0.93
CpG: 45,chr15,89378613,89379158,545,45,360,16.5,66.1,0.76
CpG: 29,chr15,89410048,89410386,338,29,231,17.2,68.3,0.74
CpG: 66,chr15,89429313,89429985,672,66,443,19.6,65.9,0.91
CpG: 61,chr15,89453649,89454326,677,61,433,18,64,0.92
CpG: 45,chr15,89457315,89457978,663,45,431,13.6,65,0.65
CpG: 149,chr15,89498706,89500344,1638,149,988,18.2,60.3,1.01
CpG: 39,chr15,89523944,89524282,338,39,205,23.1,60.7,1.27
CpG: 74,chr15,89547660,89548480,820,74,567,18,69.1,0.77
CpG: 65,chr15,89557772,89558421,649,65,458,20,70.6,0.81
CpG: 53,chr15,89591373,89591953,580,53,354,18.3,61,1
CpG: 52,chr15,89841521,89842041,520,52,358,20,68.8,0.84
CpG: 48,chr15,90224109,90224639,530,48,349,18.1,65.8,0.86
CpG: 79,chr15,90679085,90680178,1093,79,657,14.5,60.1,0.8
CpG: 15,chr15,90951164,90951379,215,15,127,14,59.1,0.84
CpG: 98,chr15,91049148,91050047,899,98,595,21.8,66.2,1
CpG: 22,chr15,91199432,91199666,234,22,160,18.8,68.4,0.82
CpG: 120,chr15,91572409,91573287,878,120,662,27.3,75.4,0.96
CpG: 58,chr15,92396922,92397500,578,58,408,20.1,70.6,0.82
CpG: 79,chr15,93274814,93275775,961,79,520,16.4,54.1,1.15
CpG: 121,chr15,93336072,93337374,1302,121,668,18.6,51.3,1.41
CpG: 54,chr15,93398143,93398538,395,54,236,27.3,59.7,1.54
CpG: 33,chr15,93500631,93501035,404,33,232,16.3,57.4,1
CpG: 33,chr15,93503209,93503663,454,33,270,14.5,59.5,0.82
CpG: 77,chr15,93519015,93519601,586,77,436,26.3,74.4,0.97
CpG: 114,chr15,93595302,93596105,803,114,621,28.4,77.3,0.96
CpG: 92,chr15,94403228,94404370,1142,92,758,16.1,66.4,0.75
CpG: 26,chr15,94523226,94523538,312,26,184,16.7,59,0.97
CpG: 58,chr15,94543264,94544009,745,58,491,15.6,65.9,0.72
CpG: 64,chr15,94589337,94589944,607,64,425,21.1,70,0.86
CpG: 78,chr15,94628899,94629527,628,78,405,24.8,64.5,1.2
CpG: 28,chr15,95228829,95229252,423,28,255,13.2,60.3,0.73
CpG: 86,chr15,95527746,95528712,966,86,574,17.8,59.4,1.01
CpG: 41,chr15,95654268,95654715,447,41,323,18.3,72.3,0.71
CpG: 74,chr15,95790472,95791333,861,74,520,17.2,60.4,0.94
CpG: 293,chr15,96284886,96288510,3624,293,1877,16.2,51.8,1.2
CpG: 159,chr15,96459953,96461411,1458,159,884,21.8,60.6,1.19
CpG: 160,chr15,96641022,96643044,2022,160,1173,15.8,58,0.94
CpG: 134,chr15,96698736,96699990,1254,134,764,21.4,60.9,1.15
CpG: 77,chr15,96709474,96710225,751,77,529,20.5,70.4,0.84
CpG: 20,chr15,96766772,96766991,219,20,137,18.3,62.6,0.96
CpG: 36,chr15,97054448,97054857,409,36,284,17.6,69.4,0.79
CpG: 92,chr15,97246949,97247838,889,92,519,20.7,58.4,1.22
CpG: 21,chr15,97323527,97323768,241,21,140,17.4,58.1,1.04
CpG: 53,chr15,97705428,97705912,484,53,312,21.9,64.5,1.07
CpG: 70,chr15,97784283,97784962,679,70,467,20.6,68.8,0.87
CpG: 87,chr15,97830984,97831735,751,87,566,23.2,75.4,0.83
CpG: 51,chr15,97907977,97908715,738,51,467,13.8,63.3,0.72
CpG: 49,chr15,97964079,97964431,352,49,257,27.8,73,1.06
CpG: 29,chr15,98001890,98002284,394,29,234,14.7,59.4,0.84
CpG: 48,chr15,98004393,98004893,500,48,361,19.2,72.2,0.74
CpG: 75,chr15,98092802,98093642,840,75,552,17.9,65.7,0.83
CpG: 69,chr15,98145199,98145843,644,69,457,21.4,71,0.85
CpG: 74,chr15,98167780,98168736,956,74,633,15.5,66.2,0.71
CpG: 18,chr15,98256832,98257066,234,18,147,15.4,62.8,0.78
CpG: 40,chr15,98295938,98296320,382,40,264,20.9,69.1,0.88
CpG: 17,chr15,98437490,98437734,244,17,133,13.9,54.5,0.99
CpG: 86,chr15,98533652,98534489,837,86,546,20.5,65.2,0.97
CpG: 102,chr15,98567242,98568233,991,102,618,20.6,62.4,1.06
CpG: 70,chr15,98609353,98610114,761,70,547,18.4,71.9,0.75
CpG: 75,chr15,98634571,98635349,778,75,498,19.3,64,0.94
CpG: 37,chr15,98662663,98663022,359,37,242,20.6,67.4,0.94
CpG: 27,chr15,98677157,98677482,325,27,215,16.6,66.2,0.76
CpG: 91,chr15,98762433,98763412,979,91,698,18.6,71.3,0.75
CpG: 24,chr15,98772545,98772852,307,24,198,15.6,64.5,0.75
CpG: 63,chr15,98776320,98777008,688,63,466,18.3,67.7,0.8
CpG: 19,chr15,98778078,98778295,217,19,136,17.5,62.7,0.93
CpG: 45,chr15,98789582,98790158,576,45,389,15.6,67.5,0.69
CpG: 107,chr15,98791671,98792931,1260,107,794,17,63,0.86
CpG: 25,chr15,98804068,98804308,240,25,159,20.8,66.2,0.96
CpG: 61,chr15,98805367,98806113,746,61,462,16.4,61.9,0.85
CpG: 22,chr15,98806866,98807094,228,22,155,19.3,68,0.84
CpG: 59,chr15,98830780,98831575,795,59,481,14.8,60.5,0.82
CpG: 98,chr15,98871273,98872361,1088,98,692,18,63.6,0.89
CpG: 39,chr15,98881075,98881471,396,39,268,19.7,67.7,0.87
CpG: 69,chr15,98894026,98894548,522,69,364,26.4,69.7,1.09
CpG: 24,chr15,98894822,98895074,252,24,147,19,58.3,1.12
CpG: 21,chr15,98897982,98898204,222,21,143,18.9,64.4,0.92
CpG: 73,chr15,98917600,98918328,728,73,497,20.1,68.3,0.86
CpG: 76,chr15,98933890,98934683,793,76,494,19.2,62.3,0.99
CpG: 46,chr15,98953020,98953569,549,46,346,16.8,63,0.85
CpG: 24,chr15,98993165,98993413,248,24,146,19.4,58.9,1.15
CpG: 20,chr15,99006114,99006332,218,20,136,18.3,62.4,0.95
CpG: 39,chr15,99030210,99030667,457,39,286,17.1,62.6,0.87
CpG: 67,chr15,99055127,99055802,675,67,464,19.9,68.7,0.84
CpG: 25,chr15,99056850,99057158,308,25,192,16.2,62.3,0.87
CpG: 38,chr15,99074603,99075102,499,38,301,15.2,60.3,0.84
CpG: 103,chr15,99087196,99088551,1355,103,901,15.2,66.5,0.69
CpG: 35,chr15,99093622,99093959,337,35,234,20.8,69.4,0.86
CpG: 140,chr15,99096545,99098411,1866,140,1191,15,63.8,0.74
CpG: 102,chr15,99126144,99127244,1100,102,609,18.5,55.4,1.24
CpG: 101,chr15,99223721,99224863,1142,101,779,17.7,68.2,0.76
CpG: 49,chr15,99251675,99252222,547,49,340,17.9,62.2,0.94
CpG: 52,chr15,99294807,99295402,595,52,355,17.5,59.7,0.99
CpG: 81,chr15,99369932,99370592,660,81,498,24.5,75.5,0.86
CpG: 54,chr15,99392836,99393490,654,54,415,16.5,63.5,0.84
CpG: 20,chr15,99425768,99426050,282,20,178,14.2,63.1,0.71
CpG: 78,chr15,99457098,99458145,1047,78,715,14.9,68.3,0.64
CpG: 27,chr15,99470393,99470792,399,27,230,13.5,57.6,0.82
CpG: 41,chr15,99474374,99474776,402,41,277,20.4,68.9,0.86
CpG: 45,chr15,99583752,99584238,486,45,347,18.5,71.4,0.73
CpG: 59,chr15,99590462,99590944,482,59,342,24.5,71,0.97
CpG: 54,chr15,99651304,99651771,467,54,307,23.1,65.7,1.11
CpG: 91,chr15,99670258,99671104,846,91,566,21.5,66.9,0.96
CpG: 47,chr15,99702043,99702498,455,47,290,20.7,63.7,1.02
CpG: 54,chr15,99725628,99726125,497,54,350,21.7,70.4,0.88
CpG: 68,chr15,99771850,99772691,841,68,508,16.2,60.4,0.93
CpG: 17,chr15,99780771,99780975,204,17,129,16.7,63.2,0.85
CpG: 41,chr15,99875242,99875576,334,41,221,24.6,66.2,1.12
CpG: 115,chr15,99972474,99973733,1259,115,776,18.3,61.6,0.99
CpG: 77,chr15,100038537,100039329,792,77,509,19.4,64.3,0.94
CpG: 102,chr15,100227623,100228623,1000,102,526,20.4,52.6,1.47
CpG: 17,chr15,100280851,100281074,223,17,153,15.2,68.6,0.65
CpG: 19,chr15,100304969,100305225,256,19,154,14.8,60.2,0.82
CpG: 101,chr15,100422476,100423518,1042,101,693,19.4,66.5,0.88
CpG: 88,chr15,100468503,100469420,917,88,593,19.2,64.7,0.92
CpG: 77,chr15,100494781,100495503,722,77,521,21.3,72.2,0.83
CpG: 83,chr15,100551398,100552269,871,83,567,19.1,65.1,0.93
CpG: 19,chr15,100578247,100578501,254,19,152,15,59.8,0.84
CpG: 51,chr15,100599376,100599989,613,51,376,16.6,61.3,0.91
CpG: 30,chr15,100614533,100614938,405,30,240,14.8,59.3,0.84
CpG: 88,chr15,100615510,100616267,757,88,533,23.2,70.4,0.94
CpG: 90,chr15,100636507,100637134,627,90,483,28.7,77,0.97
CpG: 69,chr15,100728988,100729740,752,69,531,18.4,70.6,0.74
CpG: 69,chr15,100761580,100762240,660,69,482,20.9,73,0.78
CpG: 26,chr15,100768479,100768803,324,26,214,16,66,0.77
CpG: 56,chr15,100870918,100871460,542,56,366,20.7,67.5,0.91
CpG: 35,chr15,100983757,100984032,275,35,168,25.5,61.1,1.36
CpG: 21,chr15,101039574,101039815,241,21,138,17.4,57.3,1.1
CpG: 25,chr15,101040072,101040420,348,25,201,14.4,57.8,0.86
CpG: 115,chr15,101046214,101047429,1215,115,786,18.9,64.7,0.9
CpG: 196,chr15,101052673,101054340,1667,196,1075,23.5,64.5,1.13
CpG: 112,chr15,101077730,101079062,1332,112,872,16.8,65.5,0.79
CpG: 97,chr15,101173640,101174647,1007,97,619,19.3,61.5,1.03
CpG: 70,chr15,101224090,101224780,690,70,486,20.3,70.4,0.84
CpG: 49,chr15,101231559,101231985,426,49,280,23,65.7,1.08
CpG: 42,chr15,101246338,101246699,361,42,245,23.3,67.9,1.02
CpG: 55,chr15,101253977,101254468,491,55,294,22.4,59.9,1.28
CpG: 65,chr15,101266445,101267076,631,65,421,20.6,66.7,0.93
CpG: 64,chr15,101283796,101284488,692,64,432,18.5,62.4,0.95
CpG: 51,chr15,101412210,101412817,607,51,403,16.8,66.4,0.76
CpG: 44,chr15,101438541,101439021,480,44,324,18.3,67.5,0.81
CpG: 21,chr15,101479272,101479537,265,21,178,15.8,67.2,0.7
CpG: 16,chr15,101491241,101491471,230,16,151,13.9,65.7,0.65
CpG: 30,chr15,101977374,101977599,225,30,181,26.7,80.4,0.82
CpG: 25,chr15,102028122,102028430,308,25,207,16.2,67.2,0.73
CpG: 108,chr15,102073600,102074631,1031,108,678,21,65.8,0.97
CpG: 67,chr15,102100163,102100797,634,67,451,21.1,71.1,0.86
CpG: 68,chr15,102135875,102136516,641,68,460,21.2,71.8,0.83
CpG: 31,chr15,102144569,102144883,314,31,213,19.7,67.8,0.87
CpG: 79,chr15,102203440,102204211,771,79,428,20.5,55.5,1.33
CpG: 26,chr15,102224538,102224746,208,26,156,25,75,0.91
CpG: 20,chr15,102246169,102246413,244,20,166,16.4,68,0.73
CpG: 81,chr15,102246974,102248011,1037,81,665,15.6,64.1,0.81
CpG: 37,chr15,102257142,102257477,335,37,241,22.1,71.9,0.85
CpG: 59,chr15,102279294,102279790,496,59,367,23.8,74,0.89
CpG: 36,chr15,102296139,102296500,361,36,228,19.9,63.2,1.02
CpG: 30,chr15,102326046,102326371,325,30,205,18.5,63.1,0.94
CpG: 32,chr15,102331667,102332028,361,32,222,17.7,61.5,0.95
CpG: 51,chr15,102350427,102350890,463,51,299,22,64.6,1.06
CpG: 65,chr15,102355521,102356292,771,65,532,16.9,69,0.71
CpG: 25,chr15,102358199,102358530,331,25,207,15.1,62.5,0.77
CpG: 103,chr15,102405311,102406900,1589,103,888,13,55.9,0.86
CpG: 76,chr15,102470312,102471244,932,76,498,16.3,53.4,1.14
CpG: 35,chr15,102510504,102510923,419,35,286,16.7,68.3,0.72
CpG: 42,chr15,102516579,102517134,555,42,352,15.1,63.4,0.82
CpG: 52,chr15,102518060,102518669,609,52,392,17.1,64.4,0.84
CpG: 39,chr15,102625238,102625668,430,39,289,18.1,67.2,0.8
CpG: 48,chr15,102670744,102671157,413,48,288,23.2,69.7,0.97
CpG: 44,chr15,102671865,102672453,588,44,337,15,57.3,0.91
CpG: 40,chr15,102692906,102693224,318,40,226,25.2,71.1,1
CpG: 19,chr15,102737416,102737627,211,19,130,18,61.6,0.96
CpG: 76,chr15,102746546,102747492,946,76,579,16.1,61.2,0.87
CpG: 81,chr15,102921305,102922192,887,81,604,18.3,68.1,0.79
CpG: 29,chr15,102927187,102927519,332,29,194,17.5,58.4,1.04
CpG: 25,chr15,102934944,102935226,282,25,185,17.7,65.6,0.87
CpG: 68,chr15,102936834,102937456,622,68,418,21.9,67.2,0.97
CpG: 38,chr15,102942926,102943259,333,38,217,22.8,65.2,1.08
CpG: 81,chr15,102954317,102955305,988,81,625,16.4,63.3,0.82
CpG: 19,chr15,102956303,102956549,246,19,157,15.4,63.8,0.76
CpG: 19,chr15,102966501,102966713,212,19,134,17.9,63.2,0.91
CpG: 27,chr15,102967304,102967662,358,27,226,15.1,63.1,0.76
CpG: 80,chr15,102981650,102982309,659,80,454,24.3,68.9,1.03
CpG: 55,chr15,102990469,102991058,589,55,388,18.7,65.9,0.86
CpG: 23,chr15,103010737,103010979,242,23,143,19,59.1,1.09
CpG: 82,chr15,103014200,103015327,1127,82,693,14.6,61.5,0.77
CpG: 27,chr15,103027464,103027814,350,27,205,15.4,58.6,0.94
CpG: 19,chr15,103032735,103032961,226,19,117,16.8,51.8,1.26
CpG: 22,chr15,103034760,103035025,265,22,163,16.6,61.5,0.91
CpG: 20,chr15,103035731,103035967,236,20,149,16.9,63.1,0.88
CpG: 19,chr15,103059375,103059628,253,19,140,15,55.3,1.02
CpG: 71,chr15,103085923,103086798,875,71,566,16.2,64.7,0.78
CpG: 36,chr15,103102145,103102622,477,36,302,15.1,63.3,0.75
CpG: 43,chr15,103146759,103147150,391,43,244,22,62.4,1.13
CpG: 44,chr15,103168914,103169374,460,44,279,19.1,60.7,1.05
CpG: 25,chr15,103170129,103170423,294,25,198,17,67.3,0.76
CpG: 40,chr15,103182264,103182683,419,40,300,19.1,71.6,0.75
CpG: 97,chr15,103239377,103240720,1343,97,729,14.4,54.3,0.98
CpG: 43,chr15,103305072,103305366,294,43,208,29.3,70.7,1.18
CpG: 18,chr15,103314017,103314247,230,18,150,15.7,65.2,0.81
CpG: 40,chr15,103323216,103323584,368,40,292,21.7,79.3,0.77
CpG: 52,chr15,103366094,103366731,637,52,387,16.3,60.8,0.91
CpG: 35,chr15,103502790,103503114,324,35,222,21.6,68.5,0.93
CpG: 47,chr15,103537682,103538175,493,47,350,19.1,71,0.76
CpG: 22,chr15,103827185,103827395,210,22,136,21,64.8,1
CpG: 182,chr16,91225320,91227642,2322,182,1396,15.7,60.1,0.87
CpG: 52,chr16,3743947,3744604,657,52,420,15.8,63.9,0.78
CpG: 35,chr16,3872260,3872728,468,35,292,15,62.4,0.77
CpG: 87,chr16,3884214,3884995,781,87,549,22.3,70.3,0.9
CpG: 26,chr16,3908918,3909244,326,26,217,16,66.6,0.72
CpG: 46,chr16,4003534,4003987,453,46,292,20.3,64.5,0.98
CpG: 55,chr16,4077466,4078059,593,55,386,18.5,65.1,0.88
CpG: 134,chr16,4212834,4214506,1672,134,843,16,50.4,1.27
CpG: 24,chr16,4267957,4268267,310,24,211,15.5,68.1,0.67
CpG: 130,chr16,4419636,4420698,1062,130,751,24.5,70.7,1
CpG: 29,chr16,4474998,4475296,298,29,186,19.5,62.4,1
CpG: 30,chr16,4541728,4541980,252,30,174,23.8,69,1
CpG: 84,chr16,4558597,4559691,1094,84,694,15.4,63.4,0.76
CpG: 38,chr16,4586600,4587001,401,38,277,19,69.1,0.79
CpG: 88,chr16,4594011,4595147,1136,88,623,15.5,54.8,1.03
CpG: 55,chr16,4624513,4625028,515,55,349,21.4,67.8,0.94
CpG: 29,chr16,4639960,4640359,399,29,271,14.5,67.9,0.63
CpG: 18,chr16,4679141,4679355,214,18,145,16.8,67.8,0.74
CpG: 20,chr16,4679542,4679826,284,20,181,14.1,63.7,0.7
CpG: 35,chr16,4684006,4684336,330,35,230,21.2,69.7,0.88
CpG: 53,chr16,4726299,4726876,577,53,359,18.4,62.2,0.95
CpG: 80,chr16,4789406,4790347,941,80,614,17,65.2,0.8
CpG: 88,chr16,4879231,4879998,767,88,523,22.9,68.2,1
CpG: 45,chr16,4880425,4881005,580,45,339,15.5,58.4,0.92
CpG: 41,chr16,4886293,4886668,375,41,258,21.9,68.8,0.92
CpG: 37,chr16,4939045,4939501,456,37,289,16.2,63.4,0.82
CpG: 69,chr16,4963893,4964574,681,69,476,20.3,69.9,0.83
CpG: 49,chr16,5013212,5013781,569,49,341,17.2,59.9,0.97
CpG: 152,chr16,5049361,5050782,1421,152,948,21.4,66.7,0.97
CpG: 17,chr16,5131655,5131884,229,17,152,14.8,66.4,0.67
CpG: 46,chr16,5132270,5132725,455,46,291,20.2,64,0.99
CpG: 77,chr16,5203359,5204020,661,77,465,23.3,70.3,0.94
CpG: 27,chr16,5233591,5233841,250,27,150,21.6,60,1.21
CpG: 44,chr16,5255699,5256119,420,44,303,21,72.1,0.82
CpG: 31,chr16,5306734,5307115,381,31,262,16.3,68.8,0.69
CpG: 74,chr16,5884850,5885725,875,74,535,16.9,61.1,0.91
CpG: 23,chr16,6348945,6349153,208,23,148,22.1,71.2,0.93
CpG: 47,chr16,8424540,8425107,567,47,382,16.6,67.4,0.82
CpG: 36,chr16,8513265,8513607,342,36,244,21.1,71.3,0.83
CpG: 57,chr16,8637253,8638035,782,57,449,14.6,57.4,0.89
CpG: 81,chr16,8671592,8672502,910,81,625,17.8,68.7,0.76
CpG: 133,chr16,8737708,8739261,1553,133,786,17.1,50.6,1.34
CpG: 185,chr16,8829338,8831232,1894,185,1252,19.5,66.1,0.9
CpG: 24,chr16,9992252,9992477,225,24,142,21.3,63.1,1.08
CpG: 46,chr16,9993620,9994261,641,46,370,14.4,57.7,0.86
CpG: 86,chr16,9994667,9995752,1085,86,701,15.9,64.6,0.77
CpG: 54,chr16,10192719,10193313,594,54,381,18.2,64.1,0.89
CpG: 36,chr16,10313665,10314006,341,36,244,21.1,71.6,0.85
CpG: 22,chr16,10395054,10395291,237,22,156,18.6,65.8,0.89
CpG: 38,chr16,10411849,10412188,339,38,242,22.4,71.4,0.88
CpG: 67,chr16,10542419,10543148,729,67,486,18.4,66.7,0.83
CpG: 50,chr16,10545250,10545750,500,50,311,20,62.2,1.04
CpG: 17,chr16,10564198,10564469,271,17,161,12.5,59.4,0.77
CpG: 175,chr16,10784214,10786191,1977,175,1293,17.7,65.4,0.83
CpG: 61,chr16,10834966,10835408,442,61,332,27.6,75.1,0.98
CpG: 77,chr16,10992394,10993319,925,77,591,16.6,63.9,0.82
CpG: 105,chr16,11065974,11067077,1103,105,758,19,68.7,0.81
CpG: 89,chr16,11134076,11134968,892,89,570,20,63.9,0.98
CpG: 104,chr16,11175775,11176512,737,104,526,28.2,71.4,1.11
CpG: 62,chr16,11202991,11203741,750,62,454,16.5,60.5,0.9
CpG: 126,chr16,11253399,11254629,1230,126,820,20.5,66.7,0.92
CpG: 26,chr16,11909092,11909407,315,26,205,16.5,65.1,0.78
CpG: 117,chr16,11983763,11984990,1227,117,746,19.1,60.8,1.03
CpG: 67,chr16,13109636,13110238,602,67,400,22.3,66.4,1.01
CpG: 84,chr16,13256261,13257064,803,84,535,20.9,66.6,0.96
CpG: 35,chr16,13437063,13437320,257,35,178,27.2,69.3,1.14
CpG: 17,chr16,13437779,13438016,237,17,131,14.3,55.3,0.94
CpG: 52,chr16,13448055,13448702,647,52,449,16.1,69.4,0.67
CpG: 34,chr16,13667905,13668218,313,34,212,21.7,67.7,0.95
CpG: 55,chr16,13671831,13672447,616,55,411,17.9,66.7,0.81
CpG: 65,chr16,13754443,13755138,695,65,441,18.7,63.5,0.93
CpG: 49,chr16,13780593,13780982,389,49,279,25.2,71.7,0.98
CpG: 73,chr16,13818870,13819710,840,73,487,17.4,58,1.03
CpG: 41,chr16,13868019,13868377,358,41,254,22.9,70.9,0.91
CpG: 78,chr16,13902623,13903411,788,78,514,19.8,65.2,0.94
CpG: 43,chr16,13940703,13941101,398,43,280,21.6,70.4,0.88
CpG: 34,chr16,14158908,14159311,403,34,258,16.9,64,0.86
CpG: 62,chr16,14163055,14163687,632,62,428,19.6,67.7,0.89
CpG: 21,chr16,14292353,14292558,205,21,144,20.5,70.2,0.84
CpG: 32,chr16,14317136,14317486,350,32,215,18.3,61.4,1
CpG: 56,chr16,14361307,14361824,517,56,357,21.7,69.1,0.91
CpG: 29,chr16,14705819,14706128,309,29,195,18.8,63.1,0.97
CpG: 43,chr16,15084934,15085247,313,43,232,27.5,74.1,1
CpG: 63,chr16,15594030,15594560,530,63,374,23.8,70.6,1.01
CpG: 90,chr16,15637061,15638107,1046,90,647,17.2,61.9,0.91
CpG: 21,chr16,15863195,15863494,299,21,161,14,53.8,0.97
CpG: 158,chr16,15886710,15888235,1525,158,1032,20.7,67.7,0.9
CpG: 37,chr16,16146612,16146946,334,37,233,22.2,69.8,0.99
CpG: 57,chr16,16213151,16213818,667,57,415,17.1,62.2,0.89
CpG: 87,chr16,16302895,16303619,724,87,515,24,71.1,0.95
CpG: 53,chr16,16358539,16359085,546,53,376,19.4,68.9,0.83
CpG: 62,chr16,16599644,16600154,510,62,351,24.3,68.8,1.05
CpG: 24,chr16,16829032,16829374,342,24,211,14,61.7,0.74
CpG: 37,chr16,16870717,16871063,346,37,240,21.4,69.4,0.92
CpG: 83,chr16,16983228,16984067,839,83,518,19.8,61.7,1.05
CpG: 40,chr16,17070149,17070427,278,40,206,28.8,74.1,1.07
CpG: 27,chr16,17110934,17111265,331,27,193,16.3,58.3,0.96
CpG: 80,chr16,17131581,17132606,1025,80,661,15.6,64.5,0.77
CpG: 93,chr16,17146855,17147974,1119,93,720,16.6,64.3,0.81
CpG: 62,chr16,17200952,17201416,464,62,353,26.7,76.1,0.92
CpG: 160,chr16,17208560,17210499,1939,160,1237,16.5,63.8,0.81
CpG: 85,chr16,17233359,17234141,782,85,539,21.7,68.9,0.92
CpG: 125,chr16,17276224,17278159,1935,125,1235,12.9,63.8,0.65
CpG: 18,chr16,17405341,17405594,253,18,163,14.2,64.4,0.85
CpG: 55,chr16,17405778,17406357,579,55,392,19,67.7,0.84
CpG: 89,chr16,17451781,17452843,1062,89,685,16.8,64.5,0.81
CpG: 39,chr16,17508816,17509223,407,39,264,19.2,64.9,0.92
CpG: 74,chr16,17530598,17531307,709,74,459,20.9,64.7,1
CpG: 21,chr16,17576597,17576806,209,21,141,20.1,67.5,0.95
CpG: 39,chr16,17619309,17619682,373,39,255,20.9,68.4,0.9
CpG: 32,chr16,17722635,17722942,307,32,216,20.8,70.4,0.9
CpG: 26,chr16,17734077,17734299,222,26,170,23.4,76.6,0.82
CpG: 72,chr16,17759486,17760287,801,72,512,18,63.9,0.88
CpG: 87,chr16,17797467,17798713,1246,87,780,14,62.6,0.73
CpG: 84,chr16,17802833,17803612,779,84,523,21.6,67.1,0.96
CpG: 33,chr16,17804235,17804603,368,33,247,17.9,67.1,0.8
CpG: 102,chr16,17806754,17807741,987,102,661,20.7,67,0.93
CpG: 62,chr16,17815381,17816009,628,62,430,19.7,68.5,0.85
CpG: 110,chr16,17833449,17834329,880,110,571,25,64.9,1.2
CpG: 78,chr16,17891134,17891910,776,78,554,20.1,71.4,0.79
CpG: 15,chr16,17898927,17899138,211,15,121,14.2,57.3,0.87
CpG: 27,chr16,17911108,17911341,233,27,159,23.2,68.2,1.01
CpG: 113,chr16,17914207,17915177,970,113,677,23.3,69.8,0.96
CpG: 39,chr16,17921791,17922241,450,39,276,17.3,61.3,0.92
CpG: 123,chr16,17927319,17928633,1314,123,872,18.7,66.4,0.85
CpG: 57,chr16,18066321,18066909,588,57,340,19.4,57.8,1.16
CpG: 47,chr16,18088801,18089244,443,47,303,21.2,68.4,0.92
CpG: 130,chr16,18127268,18128271,1003,130,716,25.9,71.4,1.02
CpG: 62,chr16,18234755,18235310,555,62,355,22.3,64,1.1
CpG: 133,chr16,18248030,18249295,1265,133,861,21,68.1,0.91
CpG: 80,chr16,18288775,18289520,745,80,489,21.5,65.6,1
CpG: 39,chr16,18343763,18344081,318,39,227,24.5,71.4,0.99
CpG: 66,chr16,18348135,18348973,838,66,571,15.8,68.1,0.69
CpG: 47,chr16,18392518,18392991,473,47,336,19.9,71,0.79
CpG: 20,chr16,18398096,18398312,216,20,148,18.5,68.5,0.79
CpG: 44,chr16,18426235,18426661,426,44,279,20.7,65.5,0.97
CpG: 69,chr16,18498666,18499327,661,69,451,20.9,68.2,0.91
CpG: 150,chr16,18581662,18583035,1373,150,875,21.8,63.7,1.09
CpG: 90,chr16,18586255,18587212,957,90,525,18.8,54.9,1.25
CpG: 78,chr16,18588042,18589039,997,78,658,15.6,66,0.72
CpG: 26,chr16,18590442,18590723,281,26,183,18.5,65.1,0.89
CpG: 32,chr16,18591672,18591958,286,32,198,22.4,69.2,0.94
CpG: 105,chr16,18620742,18621814,1072,105,733,19.6,68.4,0.84
CpG: 85,chr16,18626112,18626774,662,85,475,25.7,71.8,1
CpG: 56,chr16,18629481,18630133,652,56,364,17.2,55.8,1.12
CpG: 78,chr16,18777114,18777946,832,78,527,18.8,63.3,0.94
CpG: 28,chr16,18812243,18812647,404,28,246,13.9,60.9,0.75
CpG: 35,chr16,18836678,18837010,332,35,222,21.1,66.9,0.95
CpG: 129,chr16,18876343,18877764,1421,129,890,18.2,62.6,0.93
CpG: 28,chr16,18976402,18976773,371,28,260,15.1,70.1,0.63
CpG: 33,chr16,19761053,19761371,318,33,218,20.8,68.6,0.92
CpG: 81,chr16,20097597,20098386,789,81,557,20.5,70.6,0.84
CpG: 71,chr16,20141057,20141558,501,71,361,28.3,72.1,1.12
CpG: 69,chr16,20240838,20241397,559,69,380,24.7,68,1.09
CpG: 40,chr16,20301978,20302472,494,40,314,16.2,63.6,0.8
CpG: 63,chr16,20425909,20426608,699,63,461,18,66,0.85
CpG: 28,chr16,20498869,20499147,278,28,175,20.1,62.9,1.02
CpG: 72,chr16,20516782,20517401,619,72,458,23.3,74,0.85
CpG: 25,chr16,20531102,20531450,348,25,237,14.4,68.1,0.62
CpG: 39,chr16,20535417,20535868,451,39,311,17.3,69,0.77
CpG: 49,chr16,20548195,20548752,557,49,344,17.6,61.8,0.92
CpG: 43,chr16,20591192,20591631,439,43,302,19.6,68.8,0.83
CpG: 34,chr16,20611337,20611814,477,34,277,14.3,58.1,0.85
CpG: 220,chr16,20619764,20622355,2591,220,1679,17,64.8,0.81
CpG: 36,chr16,20629746,20630039,293,36,219,24.6,74.7,0.88
CpG: 41,chr16,20651554,20652001,447,41,299,18.3,66.9,0.83
CpG: 90,chr16,20672553,20673506,953,90,575,18.9,60.3,1.05
CpG: 33,chr16,20693223,20693638,415,33,292,15.9,70.4,0.65
CpG: 33,chr16,20695815,20696213,398,33,245,16.6,61.6,0.88
CpG: 133,chr16,20716048,20718012,1964,133,1231,13.5,62.7,0.7
CpG: 80,chr16,20732786,20733764,978,80,601,16.4,61.5,0.87
CpG: 88,chr16,21204591,21205625,1034,88,641,17,62,0.89
CpG: 24,chr16,21214366,21214690,324,24,187,14.8,57.7,0.89
CpG: 38,chr16,21248358,21248824,466,38,315,16.3,67.6,0.72
CpG: 31,chr16,21333232,21333502,270,31,193,23,71.5,0.9
CpG: 53,chr16,21423075,21423569,494,53,331,21.5,67,0.96
CpG: 30,chr16,21612998,21613283,285,30,205,21.1,71.9,0.9
CpG: 86,chr16,21694141,21695013,872,86,537,19.7,61.6,1.04
CpG: 47,chr16,21794116,21794707,591,47,363,15.9,61.4,0.87
CpG: 18,chr16,21926270,21926484,214,18,136,16.8,63.6,0.83
CpG: 48,chr16,21947243,21947648,405,48,299,23.7,73.8,0.87
CpG: 73,chr16,22009184,22010017,833,73,479,17.5,57.5,1.06
CpG: 180,chr16,22161353,22163364,2011,180,1275,17.9,63.4,0.9
CpG: 104,chr16,22265286,22266198,912,104,620,22.8,68,1.01
CpG: 93,chr16,22439207,22440193,986,93,623,18.9,63.2,0.97
CpG: 39,chr16,22656809,22657280,471,39,317,16.6,67.3,0.74
CpG: 79,chr16,22857344,22858214,870,79,558,18.2,64.1,0.89
CpG: 117,chr16,23107282,23108513,1231,117,762,19,61.9,1.01
CpG: 42,chr16,23127687,23128101,414,42,274,20.3,66.2,0.93
CpG: 48,chr16,23224892,23225504,612,48,385,15.7,62.9,0.79
CpG: 19,chr16,23431240,23431460,220,19,137,17.3,62.3,0.9
CpG: 21,chr16,23890614,23890859,245,21,162,17.1,66.1,0.79
CpG: 20,chr16,23927413,23927642,229,20,142,17.5,62,0.92
CpG: 21,chr16,23983311,23983527,216,21,143,19.4,66.2,0.89
CpG: 53,chr16,23987451,23988223,772,53,406,13.7,52.6,1.01
CpG: 45,chr16,23988656,23988951,295,45,217,30.5,73.6,1.13
CpG: 59,chr16,24393278,24394073,795,59,419,14.8,52.7,1.07
CpG: 88,chr16,26105188,26105929,741,88,501,23.8,67.6,1.04
CpG: 39,chr16,26581488,26581862,374,39,263,20.9,70.3,0.85
CpG: 30,chr16,26967938,26968299,361,30,243,16.6,67.3,0.73
CpG: 48,chr16,27388783,27389263,480,48,303,20,63.1,1.01
CpG: 160,chr16,28445018,28446945,1927,160,1191,16.6,61.8,0.87
CpG: 78,chr16,28564357,28565093,736,78,471,21.2,64,1.04
CpG: 109,chr16,28928815,28930187,1372,109,788,15.9,57.4,0.96
CpG: 27,chr16,29210007,29210265,258,27,188,20.9,72.9,0.83
CpG: 30,chr16,29579258,29579598,340,30,229,17.6,67.4,0.78
CpG: 53,chr16,29813798,29814290,492,53,353,21.5,71.7,0.84
CpG: 30,chr16,29945953,29946266,313,30,213,19.2,68.1,0.84
CpG: 45,chr16,30008860,30009249,389,45,278,23.1,71.5,0.92
CpG: 125,chr16,30063278,30064577,1299,125,794,19.2,61.1,1.03
CpG: 57,chr16,30066222,30067063,841,57,526,13.6,62.5,0.7
CpG: 49,chr16,30070091,30070695,604,49,354,16.2,58.6,0.94
CpG: 22,chr16,30283072,30283337,265,22,178,16.6,67.2,0.75
CpG: 87,chr16,30308375,30309235,860,87,598,20.2,69.5,0.84
CpG: 26,chr16,30309506,30309843,337,26,199,15.4,59.1,0.92
CpG: 104,chr16,30387971,30389014,1043,104,669,19.9,64.1,0.98
CpG: 24,chr16,30510658,30510926,268,24,175,17.9,65.3,0.84
CpG: 61,chr16,30550146,30550743,597,61,418,20.4,70,0.84
CpG: 18,chr16,30587453,30587656,203,18,124,17.7,61.1,0.96
CpG: 138,chr16,30599616,30601338,1722,138,1061,16,61.6,0.85
CpG: 76,chr16,31080707,31081540,833,76,525,18.2,63,0.92
CpG: 118,chr16,31200253,31201394,1141,118,792,20.7,69.4,0.86
CpG: 76,chr16,31274696,31275318,622,76,454,24.4,73,0.92
CpG: 105,chr16,31428725,31430036,1311,105,813,16,62,0.84
CpG: 29,chr16,31663525,31663895,370,29,223,15.7,60.3,0.87
CpG: 29,chr16,31932874,31933211,337,29,228,17.2,67.7,0.75
CpG: 26,chr16,31933753,31934042,289,26,199,18,68.9,0.76
CpG: 93,chr16,31948044,31948757,713,93,492,26.1,69,1.1
CpG: 48,chr16,32002858,32003267,409,48,292,23.5,71.4,0.93
CpG: 63,chr16,32078760,32079326,566,63,394,22.3,69.6,0.94
CpG: 54,chr16,32099391,32099926,535,54,374,20.2,69.9,0.84
CpG: 26,chr16,32165261,32165595,334,26,213,15.6,63.8,0.78
CpG: 92,chr16,32246436,32247305,869,92,538,21.2,61.9,1.11
CpG: 61,chr16,32277383,32277883,500,61,353,24.4,70.6,1
CpG: 82,chr16,32332125,32332988,863,82,595,19,68.9,0.8
CpG: 30,chr16,32419656,32420059,403,30,252,14.9,62.5,0.77
CpG: 71,chr16,32430617,32431411,794,71,522,17.9,65.7,0.86
CpG: 77,chr16,32608664,32609393,729,77,510,21.1,70,0.9
CpG: 73,chr16,32643816,32644603,787,73,413,18.6,52.5,1.38
CpG: 24,chr16,32868003,32868226,223,24,156,21.5,70,0.95
CpG: 113,chr16,32877447,32878499,1052,113,731,21.5,69.5,0.89
CpG: 75,chr16,32913971,32914673,702,75,501,21.4,71.4,0.85
CpG: 69,chr16,33056173,33057121,948,69,562,14.6,59.3,0.84
CpG: 77,chr16,33062241,33062813,572,77,416,26.9,72.7,1.02
CpG: 68,chr16,33184963,33185567,604,68,434,22.5,71.9,0.87
CpG: 60,chr16,33251354,33251967,613,60,396,19.6,64.6,0.98
CpG: 76,chr16,33380612,33381449,837,76,444,18.2,53,1.29
CpG: 21,chr16,33576715,33577008,293,21,184,14.3,62.8,0.74
CpG: 60,chr16,33684328,33684938,610,60,333,19.7,54.6,1.33
CpG: 87,chr16,33829579,33830376,797,87,535,21.8,67.1,0.98
CpG: 31,chr16,33966755,33967081,326,31,221,19,67.8,0.84
CpG: 49,chr16,34572703,34573169,466,49,326,21,70,0.89
CpG: 37,chr16,34573665,34574089,424,37,238,17.5,56.1,1.14
CpG: 39,chr16,34690530,34691019,489,39,298,16,60.9,0.87
CpG: 44,chr16,34745083,34745420,337,44,240,26.1,71.2,1.03
CpG: 62,chr16,35022231,35023015,784,62,419,15.8,53.4,1.11
CpG: 227,chr16,35154338,35156977,2639,227,1586,17.2,60.1,0.95
CpG: 58,chr16,35363462,35364020,558,58,392,20.8,70.3,0.85
CpG: 68,chr16,35490207,35490993,786,68,524,17.3,66.7,0.8
CpG: 121,chr16,35541306,35542689,1383,121,929,17.5,67.2,0.79
CpG: 15,chr16,35651149,35651363,214,15,131,14,61.2,0.75
CpG: 65,chr16,35660009,35660664,655,65,459,19.8,70.1,0.81
CpG: 21,chr16,35735397,35735624,227,21,136,18.5,59.9,1.03
CpG: 73,chr16,35768871,35769540,669,73,492,21.8,73.5,0.81
CpG: 47,chr16,35770163,35770619,456,47,302,20.6,66.2,0.94
CpG: 33,chr16,35871024,35871388,364,33,241,18.1,66.2,0.84
CpG: 50,chr16,35938487,35939163,676,50,424,14.8,62.7,0.75
CpG: 107,chr16,35983174,35984086,912,107,594,23.5,65.1,1.14
CpG: 35,chr16,36041111,36041632,521,35,291,13.4,55.9,0.86
CpG: 82,chr16,36071331,36072129,798,82,527,20.6,66,0.94
CpG: 15,chr16,36509682,36509885,203,15,107,14.8,52.7,1.08
CpG: 26,chr16,36693838,36694122,284,26,194,18.3,68.3,0.8
CpG: 53,chr16,36828052,36828673,621,53,370,17.1,59.6,0.97
CpG: 66,chr16,36875092,36875675,583,66,424,22.6,72.7,0.86
CpG: 40,chr16,37011660,37012088,428,40,273,18.7,63.8,0.94
CpG: 65,chr16,37384329,37385060,731,65,497,17.8,68,0.78
CpG: 54,chr16,37539317,37540062,745,54,446,14.5,59.9,0.82
CpG: 54,chr16,37654017,37654570,553,54,367,19.5,66.4,0.89
CpG: 45,chr16,37776881,37777389,508,45,353,17.7,69.5,0.76
CpG: 139,chr16,37868072,37869164,1092,139,785,25.5,71.9,0.99
CpG: 45,chr16,37916232,37916611,379,45,266,23.7,70.2,0.97
CpG: 144,chr16,38088236,38089788,1552,144,998,18.6,64.3,0.9
CpG: 32,chr16,38346898,38347251,353,32,224,18.1,63.5,0.9
CpG: 24,chr16,38445742,38446050,308,24,186,15.6,60.4,0.86
CpG: 16,chr16,38447359,38447562,203,16,129,15.8,63.5,0.79
CpG: 50,chr16,38452467,38452985,518,50,365,19.3,70.5,0.79
CpG: 52,chr16,38483179,38483904,725,52,444,14.3,61.2,0.78
CpG: 16,chr16,38484183,38484403,220,16,133,14.5,60.5,0.84
CpG: 60,chr16,38522225,38522863,638,60,422,18.8,66.1,0.86
CpG: 42,chr16,38549950,38550302,352,42,259,23.9,73.6,0.9
CpG: 45,chr16,38562692,38563197,505,45,332,17.8,65.7,0.83
CpG: 63,chr16,38712700,38713353,653,63,407,19.3,62.3,0.99
CpG: 71,chr16,38742158,38742675,517,71,399,27.5,77.2,0.93
CpG: 70,chr16,38902192,38902730,538,70,410,26,76.2,0.9
CpG: 34,chr16,39984466,39984898,432,34,276,15.7,63.9,0.79
CpG: 28,chr16,41533256,41533520,264,28,176,21.2,66.7,0.96
CpG: 29,chr16,42190217,42190447,230,29,167,25.2,72.6,0.96
CpG: 110,chr16,42874974,42876399,1425,110,864,15.4,60.6,0.84
CpG: 19,chr16,43618397,43618634,237,19,152,16,64.1,0.79
CpG: 91,chr16,43979330,43980136,806,91,537,22.6,66.6,1.02
CpG: 39,chr16,44063072,44063450,378,39,243,20.6,64.3,1
CpG: 92,chr16,44139650,44140488,838,92,585,22,69.8,0.96
CpG: 73,chr16,44173003,44173764,761,73,508,19.2,66.8,0.86
CpG: 31,chr16,44194880,44195272,392,31,236,15.8,60.2,1.01
CpG: 59,chr16,44331980,44332745,765,59,509,15.4,66.5,0.71
CpG: 57,chr16,44347322,44347812,490,57,346,23.3,70.6,0.95
CpG: 22,chr16,44557880,44558099,219,22,150,20.1,68.5,0.86
CpG: 47,chr16,44558288,44558804,516,47,345,18.2,66.9,0.82
CpG: 41,chr16,44724358,44724780,422,41,295,19.4,69.9,0.81
CpG: 36,chr16,44745851,44746204,353,36,229,20.4,64.9,0.97
CpG: 56,chr16,45158612,45159270,658,56,433,17,65.8,0.81
CpG: 17,chr16,45408630,45408836,206,17,125,16.5,60.7,0.96
CpG: 33,chr16,45742693,45742974,281,33,205,23.5,73,0.9
CpG: 34,chr16,45844306,45844689,383,34,276,17.8,72.1,0.69
CpG: 21,chr16,46010395,46010642,247,21,169,17,68.4,0.73
CpG: 125,chr16,46496299,46497934,1635,125,903,15.3,55.2,1.01
CpG: 23,chr16,48750198,48750421,223,23,159,20.6,71.3,0.81
CpG: 87,chr16,48993563,48994528,965,87,644,18,66.7,0.81
CpG: 55,chr16,49699035,49699631,596,55,406,18.5,68.1,0.83
CpG: 88,chr16,49855196,49856024,828,88,609,21.3,73.6,0.8
CpG: 15,chr16,50045814,50046020,206,15,132,14.6,64.1,0.72
CpG: 47,chr16,50429976,50430361,385,47,274,24.4,71.2,0.96
CpG: 87,chr16,50431468,50432480,1012,87,603,17.2,59.6,0.97
CpG: 96,chr16,50528675,50529648,973,96,643,19.7,66.1,0.91
CpG: 41,chr16,50732426,50732884,458,41,289,17.9,63.1,0.9
CpG: 76,chr16,52031424,52032329,905,76,605,16.8,66.9,0.76
CpG: 74,chr16,52452264,52453325,1061,74,611,13.9,57.6,0.84
CpG: 104,chr16,55821623,55822627,1004,104,686,20.7,68.3,0.89
CpG: 55,chr16,55895019,55895429,410,55,301,26.8,73.4,1
CpG: 34,chr16,55905331,55905830,499,34,283,13.6,56.7,0.85
CpG: 42,chr16,55933853,55934513,660,42,372,12.7,56.4,0.81
CpG: 32,chr16,55966397,55966705,308,32,201,20.8,65.3,0.98
CpG: 120,chr16,55973657,55974697,1040,120,719,23.1,69.1,0.97
CpG: 103,chr16,56029195,56030169,974,103,629,21.1,64.6,1.01
CpG: 62,chr16,56037424,56038049,625,62,401,19.8,64.2,0.98
CpG: 60,chr16,56075388,56076128,740,60,441,16.2,59.6,0.91
CpG: 61,chr16,56717091,56717610,519,61,363,23.5,69.9,0.96
CpG: 77,chr16,57121467,57122311,844,77,559,18.2,66.2,0.83
CpG: 52,chr16,57166841,57167420,579,52,367,18,63.4,0.89
CpG: 29,chr16,57231323,57231712,389,29,237,14.9,60.9,0.84
CpG: 36,chr16,57549173,57549464,291,36,187,24.7,64.3,1.2
CpG: 50,chr16,57606479,57606948,469,50,315,21.3,67.2,0.95
CpG: 25,chr16,57696296,57696584,288,25,177,17.4,61.5,0.94
CpG: 91,chr16,58408229,58409122,893,91,586,20.4,65.6,0.96
CpG: 65,chr16,58522891,58523592,701,65,477,18.5,68,0.8
CpG: 68,chr16,58670167,58670829,662,68,479,20.5,72.4,0.79
CpG: 18,chr16,58675150,58675356,206,18,113,17.5,54.9,1.16
CpG: 42,chr16,58727918,58728350,432,42,323,19.4,74.8,0.75
CpG: 50,chr16,59471716,59472121,405,50,301,24.7,74.3,0.93
CpG: 72,chr16,59600544,59601137,593,72,428,24.3,72.2,0.94
CpG: 41,chr16,59639143,59639555,412,41,271,19.9,65.8,0.93
CpG: 26,chr16,60606148,60606518,370,26,248,14.1,67,0.63
CpG: 36,chr16,62786520,62786917,397,36,259,18.1,65.2,0.85
CpG: 47,chr16,62846598,62847166,568,47,385,16.5,67.8,0.73
CpG: 30,chr16,62854151,62854454,303,30,229,19.8,75.6,0.72
CpG: 21,chr16,63857057,63857326,269,21,176,15.6,65.4,0.73
CpG: 37,chr16,63863901,63864428,527,37,328,14,62.2,0.75
CpG: 57,chr16,64770526,64771233,707,57,425,16.1,60.1,0.9
CpG: 128,chr16,64851218,64852937,1719,128,927,14.9,53.9,1.03
CpG: 32,chr16,65105544,65105790,246,32,179,26,72.8,0.99
CpG: 56,chr16,65562260,65562883,623,56,405,18,65,0.86
CpG: 72,chr16,65814922,65815853,931,72,585,15.5,62.8,0.79
CpG: 45,chr16,67620133,67620701,568,45,367,15.8,64.6,0.77
CpG: 80,chr16,70313962,70314562,600,80,448,26.7,74.7,0.97
CpG: 60,chr16,72663079,72663798,719,60,478,16.7,66.5,0.76
CpG: 47,chr16,75592775,75593199,424,47,304,22.2,71.7,0.87
CpG: 25,chr16,75766681,75766976,295,25,178,16.9,60.3,0.94
CpG: 18,chr16,76293287,76293490,203,18,111,17.7,54.7,1.19
CpG: 152,chr16,76372282,76373503,1221,152,871,24.9,71.3,0.98
CpG: 112,chr16,77013509,77014320,811,112,560,27.6,69.1,1.16
CpG: 68,chr16,78301661,78302372,711,68,481,19.1,67.7,0.85
CpG: 155,chr16,78375947,78377099,1152,155,861,26.9,74.7,0.98
CpG: 84,chr16,78576252,78576916,664,84,455,25.3,68.5,1.08
CpG: 56,chr16,84703010,84703522,512,56,313,21.9,61.1,1.25
CpG: 53,chr16,84735205,84735819,614,53,360,17.3,58.6,1.01
CpG: 30,chr16,84774096,84774492,396,30,268,15.2,67.7,0.68
CpG: 118,chr16,84834468,84835966,1498,118,882,15.8,58.9,0.91
CpG: 15,chr16,84962789,84962996,207,15,115,14.5,55.6,0.94
CpG: 25,chr16,85079904,85080275,371,25,217,13.5,58.5,0.8
CpG: 150,chr16,85172583,85174130,1547,150,1052,19.4,68,0.84
CpG: 101,chr16,85801990,85803312,1322,101,845,15.3,63.9,0.75
CpG: 106,chr16,85899485,85901102,1617,106,965,13.1,59.7,0.74
CpG: 45,chr16,87354187,87354567,380,45,257,23.7,67.6,1.07
CpG: 54,chr16,87432079,87432740,661,54,431,16.3,65.2,0.8
CpG: 37,chr16,87440272,87440675,403,37,261,18.4,64.8,0.88
CpG: 58,chr16,87454909,87455621,712,58,414,16.3,58.1,0.97
CpG: 60,chr16,87495390,87496040,650,60,405,18.5,62.3,0.98
CpG: 79,chr16,87698718,87699558,840,79,469,18.8,55.8,1.25
CpG: 34,chr16,88289482,88289911,429,34,271,15.9,63.2,0.8
CpG: 16,chr16,89867462,89867681,219,16,125,14.6,57.1,0.9
CpG: 30,chr16,89884771,89885231,460,30,287,13,62.4,0.67
CpG: 22,chr16,90011465,90011735,270,22,158,16.3,58.5,0.98
CpG: 150,chr16,90142402,90144347,1945,150,1229,15.4,63.2,0.77
CpG: 87,chr16,90220411,90221299,888,87,537,19.6,60.5,1.07
CpG: 161,chr16,90283569,90284933,1364,161,947,23.6,69.4,0.98
CpG: 118,chr16,90385733,90386970,1237,118,760,19.1,61.4,1.01
CpG: 20,chr16,90524263,90524485,222,20,140,18,63.1,0.91
CpG: 57,chr16,90726931,90727527,596,57,391,19.1,65.6,0.89
CpG: 37,chr16,90810130,90810499,369,37,253,20.1,68.6,0.85
CpG: 108,chr16,90830065,90831464,1399,108,879,15.4,62.8,0.79
CpG: 96,chr16,90934297,90935370,1073,96,693,17.9,64.6,0.86
CpG: 99,chr16,91010640,91011598,958,99,638,20.7,66.6,0.93
CpG: 89,chr16,91043898,91044723,825,89,516,21.6,62.5,1.1
CpG: 29,chr16,91220068,91220464,396,29,245,14.6,61.9,0.77
CpG: 18,chr16,91228328,91228538,210,18,123,17.1,58.6,1.11
CpG: 178,chr16,91269577,91271739,2162,178,1377,16.5,63.7,0.82
CpG: 52,chr16,91372742,91373310,568,52,381,18.3,67.1,0.83
CpG: 35,chr16,91406195,91406591,396,35,280,17.7,70.7,0.72
CpG: 24,chr16,91464946,91465266,320,24,204,15,63.8,0.79
CpG: 57,chr16,91484935,91485537,602,57,426,18.9,70.8,0.77
CpG: 52,chr16,91546907,91547393,486,52,315,21.4,64.8,1.02
CpG: 21,chr16,91561652,91561879,227,21,146,18.5,64.3,0.91
CpG: 73,chr16,91597230,91598030,800,73,464,18.2,58,1.09
CpG: 25,chr16,91618733,91619047,314,25,194,15.9,61.8,0.85
CpG: 150,chr16,91646731,91648493,1762,150,1045,17,59.3,0.97
CpG: 42,chr16,91659907,91660476,569,42,321,14.8,56.4,0.93
CpG: 87,chr16,91688346,91689042,696,87,454,25,65.2,1.18
CpG: 27,chr16,91728389,91728782,393,27,240,13.7,61.1,0.76
CpG: 78,chr16,91729405,91730158,753,78,432,20.7,57.4,1.26
CpG: 44,chr16,91931351,91931751,400,44,272,22,68,0.95
CpG: 123,chr16,92057976,92058954,978,123,695,25.2,71.1,1
CpG: 89,chr16,92465799,92466553,754,89,526,23.6,69.8,0.99
CpG: 68,chr16,92498351,92499233,882,68,607,15.4,68.8,0.68
CpG: 56,chr16,92605600,92606133,533,56,372,21,69.8,0.92
CpG: 28,chr16,92695557,92695816,259,28,175,21.6,67.6,0.95
CpG: 143,chr16,92696818,92698891,2073,143,1262,13.8,60.9,0.74
CpG: 24,chr16,93489579,93489862,283,24,177,17,62.5,0.87
CpG: 47,chr16,93603616,93604112,496,47,327,19,65.9,0.89
CpG: 43,chr16,93607795,93608245,450,43,280,19.1,62.2,0.99
CpG: 68,chr16,93683220,93683831,611,68,424,22.3,69.4,0.93
CpG: 89,chr16,93711564,93712394,830,89,604,21.4,72.8,0.83
CpG: 97,chr16,93832013,93832736,723,97,537,26.8,74.3,0.98
CpG: 81,chr16,93883489,93884417,928,81,601,17.5,64.8,0.83
CpG: 18,chr16,93919529,93919755,226,18,154,15.9,68.1,0.69
CpG: 28,chr16,94079059,94079453,394,28,238,14.2,60.4,0.78
CpG: 15,chr16,94079639,94079844,205,15,110,14.6,53.7,1.02
CpG: 230,chr16,94083472,94086127,2655,230,1657,17.3,62.4,0.89
CpG: 23,chr16,94086715,94087055,340,23,194,13.5,57.1,0.85
CpG: 74,chr16,94125181,94125923,742,74,495,19.9,66.7,0.9
CpG: 37,chr16,94289952,94290184,232,37,180,31.9,77.6,1.07
CpG: 61,chr16,94313259,94313779,520,61,378,23.5,72.7,0.91
CpG: 46,chr16,94328130,94328593,463,46,324,19.9,70,0.84
CpG: 155,chr16,94370269,94371633,1364,155,970,22.7,71.1,0.9
CpG: 99,chr16,94526253,94527207,954,99,621,20.8,65.1,0.98
CpG: 195,chr16,94568960,94571088,2128,195,1121,18.3,52.7,1.35
CpG: 41,chr16,94997408,94997830,422,41,277,19.4,65.6,0.91
CpG: 40,chr16,95585410,95585829,419,40,291,19.1,69.5,0.81
CpG: 106,chr16,95701863,95702893,1030,106,727,20.6,70.6,0.84
CpG: 58,chr16,95990620,95991108,488,58,347,23.8,71.1,0.97
CpG: 137,chr16,96081652,96082726,1074,137,699,25.5,65.1,1.21
CpG: 127,chr16,96127037,96128212,1175,127,756,21.6,64.3,1.06
CpG: 68,chr16,96145138,96145794,656,68,443,20.7,67.5,0.91
CpG: 62,chr16,96159093,96159734,641,62,411,19.3,64.1,0.94
CpG: 62,chr16,96191818,96192388,570,62,399,21.8,70,0.91
CpG: 29,chr16,96280784,96281114,330,29,226,17.6,68.5,0.76
CpG: 52,chr16,97170504,97171041,537,52,326,19.4,60.7,1.05
CpG: 49,chr16,97356529,97356988,459,49,327,21.4,71.2,0.85
CpG: 62,chr16,97610392,97611183,791,62,487,15.7,61.6,0.85
CpG: 84,chr16,97763144,97763933,789,84,528,21.3,66.9,0.97
CpG: 74,chr16,97851170,97851922,752,74,462,19.7,61.4,1.07
CpG: 69,chr16,97922153,97922819,666,69,452,20.7,67.9,0.9
CpG: 80,chr16,97962022,97962859,837,80,501,19.1,59.9,1.07
CpG: 360,chr17,39843168,39846346,3178,360,2199,22.7,69.2,0.95
CpG: 165,chr17,29490149,29492205,2056,165,1164,16.1,56.6,1
CpG: 86,chr17,33684723,33685657,934,86,582,18.4,62.3,0.95
CpG: 55,chr17,3084325,3084952,627,55,424,17.5,67.6,0.79
CpG: 136,chr17,3114402,3115694,1292,136,806,21.1,62.4,1.09
CpG: 49,chr17,3314198,3314559,361,49,273,27.1,75.6,0.95
CpG: 70,chr17,3326389,3327232,843,70,528,16.6,62.6,0.86
CpG: 39,chr17,3557391,3557765,374,39,243,20.9,65,0.99
CpG: 80,chr17,4907860,4908741,881,80,526,18.2,59.7,1.02
CpG: 224,chr17,4994039,4996845,2806,224,1420,16,50.6,1.25
CpG: 24,chr17,5189808,5190057,249,24,181,19.3,72.7,0.73
CpG: 19,chr17,5342099,5342310,211,19,130,18,61.6,0.95
CpG: 124,chr17,5492094,5493333,1239,124,846,20,68.3,0.86
CpG: 134,chr17,5840932,5841919,987,134,678,27.2,68.7,1.16
CpG: 17,chr17,5934951,5935164,213,17,145,16,68.1,0.79
CpG: 80,chr17,5940893,5941840,947,80,556,16.9,58.7,0.99
CpG: 60,chr17,6079433,6080058,625,60,393,19.2,62.9,0.97
CpG: 69,chr17,6106525,6107370,845,69,454,16.3,53.7,1.13
CpG: 32,chr17,6132178,6132558,380,32,230,16.8,60.5,0.93
CpG: 32,chr17,6253651,6254011,360,32,247,17.8,68.6,0.76
CpG: 54,chr17,6256745,6257192,447,54,322,24.2,72,0.94
CpG: 94,chr17,6270324,6271112,788,94,546,23.9,69.3,1.01
CpG: 31,chr17,6316722,6317055,333,31,224,18.6,67.3,0.83
CpG: 55,chr17,6321331,6321778,447,55,324,24.6,72.5,0.94
CpG: 32,chr17,6324533,6324893,360,32,247,17.8,68.6,0.76
CpG: 16,chr17,6466927,6467139,212,16,134,15.1,63.2,0.76
CpG: 96,chr17,6476492,6477282,790,96,547,24.3,69.2,1.02
CpG: 54,chr17,6490135,6490582,447,54,326,24.2,72.9,0.91
CpG: 36,chr17,6493954,6494314,360,36,251,20,69.7,0.82
CpG: 17,chr17,6580412,6580632,220,17,135,15.5,61.4,0.89
CpG: 28,chr17,6601615,6601899,284,28,195,19.7,68.7,0.93
CpG: 17,chr17,6639689,6639907,218,17,137,15.6,62.8,0.79
CpG: 57,chr17,6655118,6655880,762,57,447,15,58.7,0.87
CpG: 87,chr17,6782725,6783580,855,87,577,20.4,67.5,0.9
CpG: 57,chr17,6827790,6828321,531,57,355,21.5,66.9,0.97
CpG: 75,chr17,6947995,6948787,792,75,540,18.9,68.2,0.82
CpG: 81,chr17,6960837,6961684,847,81,510,19.1,60.2,1.06
CpG: 60,chr17,6978494,6979108,614,60,436,19.5,71,0.86
CpG: 76,chr17,7169741,7170523,782,76,534,19.4,68.3,0.87
CpG: 53,chr17,7826990,7827415,425,53,316,24.9,74.4,0.9
CpG: 69,chr17,7945547,7946285,738,69,502,18.7,68,0.81
CpG: 60,chr17,8147583,8148197,614,60,436,19.5,71,0.86
CpG: 80,chr17,8165031,8165882,851,80,514,18.8,60.4,1.03
CpG: 120,chr17,8283449,8284683,1234,120,845,19.4,68.5,0.83
CpG: 49,chr17,8311026,8311453,427,49,296,23,69.3,0.97
CpG: 128,chr17,8340563,8341894,1331,128,930,19.2,69.9,0.79
CpG: 101,chr17,8433485,8434837,1352,101,869,14.9,64.3,0.73
CpG: 31,chr17,8524785,8525144,359,31,242,17.3,67.4,0.76
CpG: 150,chr17,8800757,8802426,1669,150,1051,18,63,0.91
CpG: 24,chr17,9669331,9669561,230,24,146,20.9,63.5,1.04
CpG: 39,chr17,10318116,10318532,416,39,246,18.8,59.1,1.09
CpG: 128,chr17,10319232,10320317,1085,128,646,23.6,59.5,1.34
CpG: 18,chr17,10335413,10335668,255,18,152,14.1,59.6,0.81
CpG: 66,chr17,10840166,10840834,668,66,420,19.8,62.9,1
CpG: 16,chr17,12271739,12271967,228,16,126,14,55.3,0.92
CpG: 86,chr17,12318211,12318926,715,86,532,24.1,74.4,0.87
CpG: 64,chr17,12506944,12507526,582,64,416,22,71.5,0.86
CpG: 82,chr17,12741440,12742489,1049,82,661,15.6,63,0.83
CpG: 106,chr17,12769058,12770009,951,106,652,22.3,68.6,0.95
CpG: 100,chr17,12915652,12916868,1216,100,741,16.4,60.9,0.89
CpG: 38,chr17,12960318,12960670,352,38,232,21.6,65.9,1
CpG: 128,chr17,12991738,12992897,1159,128,774,22.1,66.8,0.99
CpG: 88,chr17,13007717,13008525,808,88,549,21.8,67.9,0.95
CpG: 171,chr17,13759926,13761710,1784,171,1047,19.2,58.7,1.11
CpG: 107,chr17,14202986,14203913,927,107,639,23.1,68.9,0.99
CpG: 43,chr17,14279451,14279816,365,43,258,23.6,70.7,0.95
CpG: 26,chr17,14280469,14280692,223,26,155,23.3,69.5,0.97
CpG: 77,chr17,14942933,14943937,1004,77,584,15.3,58.2,0.91
CpG: 45,chr17,14960760,14961160,400,45,286,22.5,71.5,0.91
CpG: 22,chr17,14961674,14961963,289,22,201,15.2,69.6,0.73
CpG: 44,chr17,14978600,14978989,389,44,244,22.6,62.7,1.15
CpG: 60,chr17,14992436,14993057,621,60,325,19.3,52.3,1.47
CpG: 22,chr17,14993257,14993546,289,22,201,15.2,69.6,0.73
CpG: 44,chr17,15009972,15010361,389,44,244,22.6,62.7,1.15
CpG: 60,chr17,15023804,15024425,621,60,325,19.3,52.3,1.47
CpG: 22,chr17,15024625,15024914,289,22,201,15.2,69.6,0.73
CpG: 44,chr17,15041340,15041736,396,44,244,22.2,61.6,1.18
CpG: 153,chr17,15374640,15376785,2145,153,1287,14.3,60,0.79
CpG: 25,chr17,15380709,15380966,257,25,167,19.5,65,0.93
CpG: 18,chr17,15396034,15396270,236,18,130,15.3,55.1,1.04
CpG: 30,chr17,15498096,15498416,320,30,212,18.8,66.2,0.88
CpG: 57,chr17,15499793,15500326,533,57,348,21.4,65.3,1
CpG: 55,chr17,15526910,15527366,456,55,334,24.1,73.2,0.9
CpG: 32,chr17,15536496,15536863,367,32,254,17.4,69.2,0.8
CpG: 35,chr17,15564126,15564562,436,35,276,16.1,63.3,0.81
CpG: 20,chr17,15705695,15705900,205,20,130,19.5,63.4,1.11
CpG: 17,chr17,15730845,15731079,234,17,129,14.5,55.1,0.99
CpG: 127,chr17,15825474,15826841,1367,127,846,18.6,61.9,0.98
CpG: 66,chr17,15830543,15831266,723,66,499,18.3,69,0.8
CpG: 23,chr17,17345998,17346213,215,23,143,21.4,66.5,0.97
CpG: 24,chr17,17373975,17374290,315,24,191,15.2,60.6,0.83
CpG: 140,chr17,17623866,17625547,1681,140,1121,16.7,66.7,0.75
CpG: 26,chr17,17827101,17827344,243,26,184,21.4,75.7,0.87
CpG: 29,chr17,17838089,17838395,306,29,191,19,62.4,0.98
CpG: 15,chr17,17844076,17844291,215,15,127,14,59.1,0.81
CpG: 46,chr17,17849945,17850442,497,46,324,18.5,65.2,0.88
CpG: 40,chr17,17909916,17910403,487,40,303,16.4,62.2,0.85
CpG: 67,chr17,20945198,20945930,732,67,452,18.3,61.7,0.97
CpG: 18,chr17,21009077,21009303,226,18,142,15.9,62.8,0.98
CpG: 20,chr17,21489081,21489297,216,20,151,18.5,69.9,0.77
CpG: 45,chr17,21532327,21532782,455,45,319,19.8,70.1,0.8
CpG: 23,chr17,21921007,21921282,275,23,187,16.7,68,0.75
CpG: 51,chr17,21962272,21962929,657,51,402,15.5,61.2,0.83
CpG: 59,chr17,22081013,22081597,584,59,394,20.2,67.5,0.9
CpG: 27,chr17,22361184,22361514,330,27,205,16.4,62.1,0.85
CpG: 22,chr17,22876643,22876863,220,22,166,20,75.5,0.7
CpG: 32,chr17,23546654,23547146,492,32,276,13,56.1,0.83
CpG: 35,chr17,23557751,23558165,414,35,269,16.9,65,0.8
CpG: 53,chr17,23563772,23564289,517,53,343,20.5,66.3,0.93
CpG: 51,chr17,23576154,23576825,671,51,426,15.2,63.5,0.79
CpG: 20,chr17,23592667,23592870,203,20,127,19.7,62.6,1.1
CpG: 24,chr17,23610339,23610614,275,24,177,17.5,64.4,0.86
CpG: 61,chr17,23644592,23645441,849,61,554,14.4,65.3,0.68
CpG: 22,chr17,23666650,23666884,234,22,162,18.8,69.2,0.79
CpG: 37,chr17,23673528,23673933,405,37,246,18.3,60.7,1.06
CpG: 71,chr17,23676533,23677533,1000,71,620,14.2,62,0.74
CpG: 26,chr17,23679473,23679821,348,26,230,14.9,66.1,0.69
CpG: 66,chr17,23699782,23700318,536,66,397,24.6,74.1,0.9
CpG: 72,chr17,23726212,23726871,659,72,453,21.9,68.7,0.94
CpG: 77,chr17,23739814,23740569,755,77,502,20.4,66.5,0.92
CpG: 53,chr17,23742116,23742754,638,53,419,16.6,65.7,0.77
CpG: 21,chr17,23745686,23745933,247,21,154,17,62.3,0.9
CpG: 52,chr17,23771105,23771695,590,52,378,17.6,64.1,0.86
CpG: 35,chr17,23785848,23786246,398,35,267,17.6,67.1,0.78
CpG: 20,chr17,23790460,23790683,223,20,152,17.9,68.2,0.78
CpG: 122,chr17,23802818,23803998,1180,122,749,20.7,63.5,1.03
CpG: 25,chr17,23806918,23807174,256,25,178,19.5,69.5,0.81
CpG: 72,chr17,23819189,23820217,1028,72,572,14,55.6,0.92
CpG: 45,chr17,23828656,23829032,376,45,250,23.9,66.5,1.08
CpG: 24,chr17,23924582,23924881,299,24,199,16.1,66.6,0.74
CpG: 58,chr17,24073081,24073646,565,58,384,20.5,68,0.89
CpG: 73,chr17,24141162,24141875,713,73,455,20.5,63.8,1.02
CpG: 26,chr17,24163589,24163806,217,26,151,24,69.6,0.99
CpG: 69,chr17,24169074,24169782,708,69,454,19.5,64.1,0.95
CpG: 134,chr17,24205294,24206971,1677,134,1077,16,64.2,0.78
CpG: 49,chr17,24208765,24209322,557,49,391,17.6,70.2,0.72
CpG: 27,chr17,24220509,24220795,286,27,185,18.9,64.7,0.93
CpG: 65,chr17,24251123,24251745,622,65,418,20.9,67.2,0.94
CpG: 88,chr17,24351677,24352599,922,88,632,19.1,68.5,0.81
CpG: 72,chr17,24414416,24415153,737,72,478,19.5,64.9,0.95
CpG: 45,chr17,24426587,24427016,429,45,303,21,70.6,0.88
CpG: 14,chr17,24454655,24454858,203,14,128,13.8,63.1,0.7
CpG: 51,chr17,24455043,24455443,400,51,274,25.5,68.5,1.09
CpG: 121,chr17,24470132,24471383,1251,121,754,19.3,60.3,1.07
CpG: 44,chr17,24478694,24479220,526,44,334,16.7,63.5,0.83
CpG: 85,chr17,24488338,24489311,973,85,555,17.5,57,1.07
CpG: 28,chr17,24505098,24505436,338,28,225,16.6,66.6,0.75
CpG: 29,chr17,24506530,24506872,342,29,234,17,68.4,0.77
CpG: 30,chr17,24527641,24527957,316,30,207,19,65.5,0.92
CpG: 48,chr17,24533196,24533842,646,48,408,14.9,63.2,0.75
CpG: 112,chr17,24549685,24550867,1182,112,824,19,69.7,0.78
CpG: 58,chr17,24632353,24632960,607,58,389,19.1,64.1,0.93
CpG: 56,chr17,24649840,24650287,447,56,329,25.1,73.6,0.93
CpG: 37,chr17,24658163,24658587,424,37,262,17.5,61.8,0.92
CpG: 65,chr17,24669511,24670147,636,65,394,20.4,61.9,1.09
CpG: 30,chr17,24687419,24687727,308,30,200,19.5,64.9,0.95
CpG: 29,chr17,24689728,24690008,280,29,182,20.7,65,0.99
CpG: 84,chr17,24695752,24696608,856,84,477,19.6,55.7,1.27
CpG: 21,chr17,24707495,24707706,211,21,135,19.9,64,0.99
CpG: 74,chr17,24719572,24720369,797,74,501,18.6,62.9,0.95
CpG: 38,chr17,24724065,24724494,429,38,275,17.7,64.1,0.88
CpG: 88,chr17,24752550,24753529,979,88,632,18,64.6,0.86
CpG: 58,chr17,24804050,24804566,516,58,353,22.5,68.4,0.97
CpG: 87,chr17,24849806,24850852,1046,87,675,16.6,64.5,0.81
CpG: 83,chr17,24886158,24887103,945,83,585,17.6,61.9,0.92
CpG: 73,chr17,24894888,24895493,605,73,403,24.1,66.6,1.09
CpG: 16,chr17,24895802,24896019,217,16,124,14.7,57.1,0.9
CpG: 26,chr17,24896622,24896894,272,26,174,19.1,64,0.99
CpG: 68,chr17,24936456,24937064,608,68,412,22.4,67.8,1.01
CpG: 61,chr17,24960316,24960930,614,61,422,19.9,68.7,0.88
CpG: 69,chr17,25013695,25014442,747,69,507,18.5,67.9,0.82
CpG: 155,chr17,25015254,25016862,1608,155,1007,19.3,62.6,0.99
CpG: 27,chr17,25115780,25116052,272,27,169,19.9,62.1,1.04
CpG: 37,chr17,25133340,25133660,320,37,216,23.1,67.5,1.03
CpG: 88,chr17,25184133,25185217,1084,88,663,16.2,61.2,0.88
CpG: 83,chr17,25188187,25189036,849,83,531,19.6,62.5,1.02
CpG: 25,chr17,25222475,25222749,274,25,186,18.2,67.9,0.8
CpG: 70,chr17,25239879,25240594,715,70,475,19.6,66.4,0.89
CpG: 31,chr17,25255902,25256272,370,31,230,16.8,62.2,0.87
CpG: 108,chr17,25272923,25273903,980,108,663,22,67.7,0.96
CpG: 16,chr17,25385717,25385926,209,16,148,15.3,70.8,0.61
CpG: 20,chr17,25392290,25392523,233,20,151,17.2,64.8,0.82
CpG: 159,chr17,25432655,25434369,1714,159,1126,18.6,65.7,0.86
CpG: 24,chr17,25474647,25474896,249,24,152,19.3,61,1.03
CpG: 104,chr17,25570143,25571451,1308,104,859,15.9,65.7,0.74
CpG: 33,chr17,25579040,25579410,370,33,242,17.8,65.4,0.84
CpG: 41,chr17,25717394,25717682,288,41,224,28.5,77.8,0.95
CpG: 32,chr17,25773596,25773960,364,32,227,17.6,62.4,0.92
CpG: 39,chr17,25792071,25792557,486,39,300,16,61.7,0.85
CpG: 70,chr17,25796281,25797210,929,70,582,15.1,62.6,0.77
CpG: 96,chr17,25808596,25809716,1120,96,656,17.1,58.6,1
CpG: 20,chr17,25813481,25813760,279,20,176,14.3,63.1,0.73
CpG: 29,chr17,25819487,25819817,330,29,230,17.6,69.7,0.76
CpG: 103,chr17,25832531,25833676,1145,103,755,18,65.9,0.83
CpG: 27,chr17,25837031,25837307,276,27,162,19.6,58.7,1.15
CpG: 46,chr17,25844122,25844638,516,46,355,17.8,68.8,0.78
CpG: 52,chr17,25861288,25861702,414,52,291,25.1,70.3,1.04
CpG: 48,chr17,25868303,25868806,503,48,361,19.1,71.8,0.74
CpG: 59,chr17,25875044,25875794,750,59,440,15.7,58.7,0.92
CpG: 83,chr17,25919123,25919901,778,83,537,21.3,69,0.94
CpG: 38,chr17,25941756,25942033,277,38,201,27.4,72.6,1.05
CpG: 77,chr17,25951561,25952194,633,77,447,24.3,70.6,0.98
CpG: 91,chr17,25985202,25986096,894,91,592,20.4,66.2,0.93
CpG: 142,chr17,26067599,26069727,2128,142,1311,13.3,61.6,0.71
CpG: 39,chr17,26095146,26095524,378,39,256,20.6,67.7,0.9
CpG: 23,chr17,26113053,26113331,278,23,178,16.5,64,0.82
CpG: 32,chr17,26113477,26113822,345,32,192,18.6,55.7,1.2
CpG: 34,chr17,26123457,26123754,297,34,191,22.9,64.3,1.11
CpG: 86,chr17,26138373,26139249,876,86,562,19.6,64.2,0.95
CpG: 32,chr17,26200921,26201220,299,32,190,21.4,63.5,1.1
CpG: 30,chr17,26203280,26203664,384,30,244,15.6,63.5,0.78
CpG: 44,chr17,26243869,26244386,517,44,348,17,67.3,0.76
CpG: 77,chr17,26252827,26253600,773,77,505,19.9,65.3,0.93
CpG: 98,chr17,26414558,26415566,1008,98,605,19.4,60,1.08
CpG: 57,chr17,26431803,26432317,514,57,351,22.2,68.3,0.95
CpG: 97,chr17,26438676,26439351,675,97,504,28.7,74.7,1.03
CpG: 103,chr17,26507982,26508904,922,103,642,22.3,69.6,0.92
CpG: 53,chr17,26561369,26561832,463,53,343,22.9,74.1,0.83
CpG: 39,chr17,26676341,26676736,395,39,260,19.7,65.8,0.94
CpG: 96,chr17,26715401,26716379,978,96,598,19.6,61.1,1.05
CpG: 35,chr17,26780984,26781461,477,35,284,14.7,59.5,0.85
CpG: 105,chr17,26838631,26839820,1189,105,724,17.7,60.9,0.96
CpG: 34,chr17,26841124,26841502,378,34,270,18,71.4,0.71
CpG: 47,chr17,26844182,26844781,599,47,341,15.7,56.9,0.97
CpG: 94,chr17,26849719,26851049,1330,94,787,14.1,59.2,0.81
CpG: 20,chr17,26886097,26886330,233,20,146,17.2,62.7,0.88
CpG: 80,chr17,26916788,26917604,816,80,510,19.6,62.5,1.01
CpG: 20,chr17,26924140,26924392,252,20,161,15.9,63.9,0.8
CpG: 49,chr17,26932925,26933471,546,49,392,17.9,71.8,0.7
CpG: 68,chr17,26939286,26939959,673,68,461,20.2,68.5,0.87
CpG: 35,chr17,26946650,26946900,250,35,187,28,74.8,1.01
CpG: 22,chr17,26948668,26948873,205,22,120,21.5,58.5,1.27
CpG: 58,chr17,26972900,26973367,467,58,338,24.8,72.4,0.95
CpG: 74,chr17,27056926,27057580,654,74,476,22.6,72.8,0.86
CpG: 31,chr17,27113527,27113961,434,31,276,14.3,63.6,0.71
CpG: 19,chr17,27115835,27116095,260,19,163,14.6,62.7,0.74
CpG: 40,chr17,27133597,27134012,415,40,284,19.3,68.4,0.84
CpG: 135,chr17,27203581,27204610,1029,135,725,26.2,70.5,1.06
CpG: 18,chr17,27415155,27415387,232,18,122,15.5,52.6,1.12
CpG: 34,chr17,27434718,27435170,452,34,283,15,62.6,0.78
CpG: 19,chr17,27472907,27473150,243,19,150,15.6,61.7,0.83
CpG: 27,chr17,27502679,27502998,319,27,206,16.9,64.6,0.81
CpG: 186,chr17,27511923,27513835,1912,186,1258,19.5,65.8,0.9
CpG: 34,chr17,27520719,27521101,382,34,251,17.8,65.7,0.83
CpG: 265,chr17,27555110,27557950,2840,265,1877,18.7,66.1,0.86
CpG: 56,chr17,27565423,27566003,580,56,410,19.3,70.7,0.78
CpG: 127,chr17,27622664,27623791,1127,127,731,22.5,64.9,1.08
CpG: 69,chr17,27634914,27635509,595,69,430,23.2,72.3,0.89
CpG: 20,chr17,27639117,27639359,242,20,144,16.5,59.5,0.95
CpG: 42,chr17,27655472,27655927,455,42,275,18.5,60.4,1.03
CpG: 44,chr17,27684973,27685388,415,44,299,21.2,72,0.83
CpG: 32,chr17,27702566,27702894,328,32,228,19.5,69.5,0.82
CpG: 19,chr17,27719921,27720170,249,19,162,15.3,65.1,0.72
CpG: 78,chr17,27820084,27820929,845,78,527,18.5,62.4,0.96
CpG: 30,chr17,27840001,27840372,371,30,247,16.2,66.6,0.74
CpG: 91,chr17,27856368,27857145,777,91,554,23.4,71.3,0.94
CpG: 16,chr17,27887383,27887586,203,16,130,15.8,64,0.77
CpG: 33,chr17,27907455,27907811,356,33,234,18.5,65.7,0.86
CpG: 104,chr17,27908928,27910010,1082,104,682,19.2,63,0.97
CpG: 36,chr17,28076029,28076382,353,36,246,20.4,69.7,0.84
CpG: 56,chr17,28079760,28080271,511,56,359,21.9,70.3,0.89
CpG: 25,chr17,28080586,28080888,302,25,209,16.6,69.2,0.69
CpG: 96,chr17,28141588,28142823,1235,96,664,15.5,53.8,1.07
CpG: 86,chr17,28176933,28177665,732,86,520,23.5,71,0.94
CpG: 20,chr17,28223678,28223931,253,20,164,15.8,64.8,0.76
CpG: 54,chr17,28232542,28233035,493,54,354,21.9,71.8,0.92
CpG: 18,chr17,28297058,28297272,214,18,128,16.8,59.8,0.94
CpG: 69,chr17,28313305,28313909,604,69,431,22.8,71.4,0.9
CpG: 92,chr17,28328431,28329335,904,92,618,20.4,68.4,0.87
CpG: 31,chr17,28341113,28341546,433,31,297,14.3,68.6,0.61
CpG: 118,chr17,28350004,28351532,1528,118,967,15.4,63.3,0.77
CpG: 30,chr17,28364248,28364571,323,30,223,18.6,69,0.78
CpG: 65,chr17,28485497,28485948,451,65,322,28.8,71.4,1.13
CpG: 30,chr17,28518079,28518436,357,30,230,16.8,64.4,0.81
CpG: 69,chr17,28522803,28523478,675,69,465,20.4,68.9,0.86
CpG: 28,chr17,28575497,28575772,275,28,200,20.4,72.7,0.77
CpG: 119,chr17,28621403,28622674,1271,119,826,18.7,65,0.9
CpG: 28,chr17,28689641,28689865,224,28,167,25,74.6,0.9
CpG: 149,chr17,28691110,28692594,1484,149,1014,20.1,68.3,0.86
CpG: 22,chr17,28769345,28769599,254,22,178,17.3,70.1,0.71
CpG: 19,chr17,28769973,28770224,251,19,169,15.1,67.3,0.67
CpG: 108,chr17,28800661,28801834,1173,108,723,18.4,61.6,0.97
CpG: 18,chr17,28806387,28806615,228,18,140,15.8,61.4,0.86
CpG: 66,chr17,28952168,28952767,599,66,411,22,68.6,0.96
CpG: 38,chr17,29007662,29007954,292,38,211,26,72.3,1.01
CpG: 90,chr17,29032104,29032943,839,90,548,21.5,65.3,1.03
CpG: 157,chr17,29093602,29095714,2112,157,1276,14.9,60.4,0.82
CpG: 23,chr17,29098428,29098663,235,23,151,19.6,64.3,0.96
CpG: 93,chr17,29237439,29238470,1031,93,666,18,64.6,0.88
CpG: 36,chr17,29263768,29264209,441,36,275,16.3,62.4,0.84
CpG: 37,chr17,29268880,29269247,367,37,215,20.2,58.6,1.18
CpG: 24,chr17,29322196,29322448,252,24,163,19,64.7,0.93
CpG: 26,chr17,29326590,29326916,326,26,210,16,64.4,0.8
CpG: 75,chr17,29347446,29348017,571,75,415,26.3,72.7,1
CpG: 22,chr17,29437287,29437524,237,22,163,18.6,68.8,0.8
CpG: 28,chr17,29549644,29549948,304,28,228,18.4,75,0.66
CpG: 70,chr17,29614717,29615297,580,70,426,24.1,73.4,0.9
CpG: 51,chr17,29660487,29661063,576,51,353,17.7,61.3,0.94
CpG: 34,chr17,29716816,29717153,337,34,205,20.2,60.8,1.12
CpG: 19,chr17,29759953,29760211,258,19,137,14.7,53.1,1.04
CpG: 31,chr17,29842083,29842375,292,31,206,21.2,70.5,0.87
CpG: 23,chr17,29852400,29852613,213,23,131,21.6,61.5,1.16
CpG: 145,chr17,29886904,29888441,1537,145,1039,18.9,67.6,0.83
CpG: 66,chr17,29889021,29889939,918,66,602,14.4,65.6,0.67
CpG: 91,chr17,30004196,30005089,893,91,636,20.4,71.2,0.8
CpG: 26,chr17,30483517,30483896,379,26,223,13.7,58.8,0.8
CpG: 84,chr17,30575621,30576642,1021,84,522,16.5,51.1,1.26
CpG: 24,chr17,30612355,30612692,337,24,226,14.2,67.1,0.63
CpG: 45,chr17,30901532,30902025,493,45,362,18.3,73.4,0.68
CpG: 45,chr17,31057597,31058018,421,45,294,21.4,69.8,0.88
CpG: 33,chr17,31276991,31277406,415,33,258,15.9,62.2,0.83
CpG: 50,chr17,31296158,31296715,557,50,376,18,67.5,0.8
CpG: 33,chr17,31386279,31386642,363,33,245,18.2,67.5,0.8
CpG: 52,chr17,31511958,31512400,442,52,308,23.5,69.7,0.97
CpG: 31,chr17,31519970,31520332,362,31,234,17.1,64.6,0.83
CpG: 120,chr17,31564227,31565621,1394,120,725,17.2,52,1.28
CpG: 82,chr17,31636472,31637457,985,82,640,16.6,65,0.79
CpG: 105,chr17,31658101,31658997,896,105,597,23.4,66.6,1.06
CpG: 15,chr17,31849937,31850142,205,15,130,14.6,63.4,0.74
CpG: 132,chr17,31854882,31856152,1270,132,823,20.8,64.8,1.03
CpG: 58,chr17,32036290,32036686,396,58,285,29.3,72,1.14
CpG: 42,chr17,32100027,32100473,446,42,301,18.8,67.5,0.83
CpG: 42,chr17,32113697,32114183,486,42,317,17.3,65.2,0.81
CpG: 24,chr17,32143438,32143722,284,24,195,16.9,68.7,0.72
CpG: 55,chr17,32162206,32162803,597,55,398,18.4,66.7,0.84
CpG: 42,chr17,32165748,32166261,513,42,364,16.4,71,0.66
CpG: 28,chr17,32189104,32189426,322,28,206,17.4,64,0.85
CpG: 88,chr17,32283950,32284830,880,88,461,20,52.4,1.46
CpG: 126,chr17,32320337,32321699,1362,126,868,18.5,63.7,0.92
CpG: 35,chr17,32350437,32350898,461,35,279,15.2,60.5,0.85
CpG: 23,chr17,32388820,32389053,233,23,170,19.7,73,0.75
CpG: 27,chr17,32392410,32392670,260,27,180,20.8,69.2,0.87
CpG: 66,chr17,32396209,32396879,670,66,450,19.7,67.2,0.89
CpG: 29,chr17,32415827,32416108,281,29,183,20.6,65.1,0.98
CpG: 17,chr17,32452620,32452846,226,17,152,15,67.3,0.74
CpG: 25,chr17,32492310,32492603,293,25,182,17.1,62.1,0.88
CpG: 28,chr17,32787855,32788134,279,28,202,20.1,72.4,0.77
CpG: 21,chr17,32924784,32924988,204,21,136,20.6,66.7,0.93
CpG: 20,chr17,32966000,32966236,236,20,145,16.9,61.4,0.9
CpG: 24,chr17,33358432,33358707,275,24,180,17.5,65.5,0.81
CpG: 21,chr17,33524151,33524369,218,21,144,19.3,66.1,0.88
CpG: 27,chr17,33629088,33629329,241,27,166,22.4,68.9,0.95
CpG: 23,chr17,33649799,33650140,341,23,222,13.5,65.1,0.66
CpG: 39,chr17,33718441,33718835,394,39,246,19.8,62.4,1.04
CpG: 48,chr17,33759887,33760378,491,48,319,19.6,65,0.99
CpG: 27,chr17,33781177,33781439,262,27,180,20.6,68.7,0.87
CpG: 114,chr17,33817308,33818339,1031,114,724,22.1,70.2,0.9
CpG: 30,chr17,33824456,33824707,251,30,157,23.9,62.5,1.23
CpG: 40,chr17,33843042,33843462,420,40,278,19,66.2,0.87
CpG: 19,chr17,33883494,33883746,252,19,161,15.1,63.9,0.77
CpG: 81,chr17,33890161,33890965,804,81,510,20.1,63.4,1
CpG: 108,chr17,33908464,33909829,1365,108,880,15.8,64.5,0.76
CpG: 32,chr17,33911573,33912013,440,32,273,14.5,62,0.77
CpG: 29,chr17,33915891,33916239,348,29,217,16.7,62.4,0.92
CpG: 60,chr17,33919793,33920580,787,60,490,15.2,62.3,0.79
CpG: 119,chr17,33929192,33930553,1361,119,911,17.5,66.9,0.78
CpG: 80,chr17,33940190,33941285,1095,80,644,14.6,58.8,0.85
CpG: 31,chr17,33951226,33951600,374,31,245,16.6,65.5,0.77
CpG: 75,chr17,33955281,33956284,1003,75,607,15,60.5,0.82
CpG: 85,chr17,33977756,33978755,999,85,647,17,64.8,0.81
CpG: 119,chr17,33999256,34000398,1142,119,742,20.8,65,0.99
CpG: 105,chr17,34024351,34025378,1027,105,695,20.4,67.7,0.89
CpG: 51,chr17,34027641,34028189,548,51,381,18.6,69.5,0.77
CpG: 103,chr17,34031517,34032483,966,103,600,21.3,62.1,1.11
CpG: 389,chr17,34118396,34122981,4585,389,3054,17,66.6,0.77
CpG: 34,chr17,34187673,34188066,393,34,258,17.3,65.6,0.8
CpG: 41,chr17,34204424,34204954,530,41,350,15.5,66,0.76
CpG: 80,chr17,34264511,34265096,585,80,421,27.4,72,1.06
CpG: 24,chr17,34309633,34309855,222,24,138,21.6,62.2,1.14
CpG: 89,chr17,34586859,34587906,1047,89,695,17,66.4,0.77
CpG: 58,chr17,34591986,34592713,727,58,492,16,67.7,0.7
CpG: 22,chr17,34603263,34603497,234,22,150,18.8,64.1,1.03
CpG: 39,chr17,34604012,34604475,463,39,298,16.8,64.4,0.82
CpG: 38,chr17,34605628,34606121,493,38,340,15.4,69,0.65
CpG: 41,chr17,34630771,34631135,364,41,275,22.5,75.5,0.83
CpG: 33,chr17,34632059,34632401,342,33,219,19.3,64,1.02
CpG: 60,chr17,34647012,34647646,634,60,440,18.9,69.4,0.81
CpG: 164,chr17,34671162,34672755,1593,164,1091,20.6,68.5,0.89
CpG: 53,chr17,34679881,34680508,627,53,419,16.9,66.8,0.77
CpG: 114,chr17,34836307,34837687,1380,114,860,16.5,62.3,0.85
CpG: 54,chr17,34850133,34850644,511,54,318,21.1,62.2,1.11
CpG: 96,chr17,34894150,34895486,1336,96,782,14.4,58.5,0.85
CpG: 45,chr17,34898533,34898905,372,45,275,24.2,73.9,0.96
CpG: 17,chr17,34905343,34905561,218,17,134,15.6,61.5,0.83
CpG: 34,chr17,34931162,34931518,356,34,236,19.1,66.3,0.88
CpG: 41,chr17,34951984,34952575,591,41,361,13.9,61.1,0.75
CpG: 212,chr17,34957341,34959315,1974,212,1293,21.5,65.5,1
CpG: 208,chr17,34970259,34972233,1974,208,1287,21.1,65.2,0.99
CpG: 33,chr17,34977521,34977817,296,33,190,22.3,64.2,1.11
CpG: 23,chr17,34978286,34978573,287,23,174,16,60.6,0.87
CpG: 78,chr17,34981715,34982490,775,78,503,20.1,64.9,0.96
CpG: 94,chr17,35000826,35001618,792,94,582,23.7,73.5,0.9
CpG: 68,chr17,35046178,35047024,846,68,533,16.1,63,0.81
CpG: 45,chr17,35059013,35059649,636,45,388,14.2,61,0.76
CpG: 33,chr17,35065321,35065788,467,33,281,14.1,60.2,0.78
CpG: 64,chr17,35089144,35089715,571,64,387,22.4,67.8,0.98
CpG: 81,chr17,35120808,35121786,978,81,637,16.6,65.1,0.78
CpG: 38,chr17,35126171,35126539,368,38,253,20.7,68.8,0.87
CpG: 81,chr17,35135108,35135823,715,81,476,22.7,66.6,1.04
CpG: 20,chr17,35156367,35156609,242,20,150,16.5,62,0.91
CpG: 92,chr17,35164491,35165403,912,92,600,20.2,65.8,0.94
CpG: 61,chr17,35195613,35196227,614,61,405,19.9,66,0.92
CpG: 27,chr17,35234965,35235208,243,27,178,22.2,73.3,0.85
CpG: 15,chr17,35236535,35236737,202,15,128,14.9,63.4,0.78
CpG: 58,chr17,35241352,35241932,580,58,372,20,64.1,0.97
CpG: 23,chr17,35242155,35242477,322,23,189,14.3,58.7,0.84
CpG: 115,chr17,35262981,35264128,1147,115,748,20.1,65.2,0.95
CpG: 65,chr17,35320617,35321254,637,65,424,20.4,66.6,0.92
CpG: 82,chr17,35342336,35343249,913,82,609,18,66.7,0.81
CpG: 49,chr17,35359103,35359664,561,49,363,17.5,64.7,0.83
CpG: 104,chr17,35379546,35380650,1104,104,728,18.8,65.9,0.87
CpG: 100,chr17,35394038,35395093,1055,100,705,19,66.8,0.85
CpG: 98,chr17,35424788,35425860,1072,98,710,18.3,66.2,0.84
CpG: 91,chr17,35439133,35440071,938,91,627,19.4,66.8,0.87
CpG: 102,chr17,35469967,35470988,1021,102,684,20,67,0.89
CpG: 54,chr17,35516658,35517295,637,54,385,17,60.4,0.95
CpG: 56,chr17,35667375,35667947,572,56,355,19.6,62.1,1.02
CpG: 44,chr17,35700409,35700996,587,44,341,15,58.1,0.89
CpG: 52,chr17,35821786,35822437,651,52,383,16,58.8,0.93
CpG: 31,chr17,35823129,35823497,368,31,256,16.8,69.6,0.75
CpG: 27,chr17,35835357,35835711,354,27,218,15.3,61.6,0.86
CpG: 23,chr17,35837060,35837278,218,23,159,21.1,72.9,0.8
CpG: 27,chr17,35838173,35838412,239,27,163,22.6,68.2,1
CpG: 39,chr17,35841318,35841702,384,39,241,20.3,62.8,1.03
CpG: 40,chr17,35861174,35861583,409,40,284,19.6,69.4,0.81
CpG: 29,chr17,35865724,35866068,344,29,237,16.9,68.9,0.71
CpG: 40,chr17,35866398,35866869,471,40,315,17,66.9,0.76
CpG: 65,chr17,35879640,35880165,525,65,362,24.8,69,1.05
CpG: 69,chr17,35896840,35897494,654,69,425,21.1,65,1
CpG: 24,chr17,35909911,35910135,224,24,148,21.4,66.1,0.98
CpG: 101,chr17,35916085,35917155,1070,101,638,18.9,59.6,1.09
CpG: 62,chr17,35969409,35969972,563,62,389,22,69.1,0.93
CpG: 162,chr17,35979024,35980725,1701,162,1141,19,67.1,0.85
CpG: 18,chr17,36042025,36042231,206,18,132,17.5,64.1,0.85
CpG: 86,chr17,36083218,36084219,1001,86,614,17.2,61.3,0.91
CpG: 17,chr17,36110763,36110967,204,17,122,16.7,59.8,0.93
CpG: 29,chr17,36111233,36111453,220,29,147,26.4,66.8,1.19
CpG: 110,chr17,36144897,36145990,1093,110,722,20.1,66.1,0.93
CpG: 35,chr17,36157942,36158206,264,35,199,26.5,75.4,0.95
CpG: 42,chr17,36161661,36162048,387,42,270,21.7,69.8,0.89
CpG: 104,chr17,36167418,36168500,1082,104,702,19.2,64.9,0.92
CpG: 40,chr17,36178969,36179329,360,40,262,22.2,72.8,0.84
CpG: 39,chr17,36205914,36206225,311,39,219,25.1,70.4,1.02
CpG: 40,chr17,36231266,36231586,320,40,235,25,73.4,0.93
CpG: 33,chr17,36248872,36249182,310,33,212,21.3,68.4,0.91
CpG: 26,chr17,36257569,36257894,325,26,214,16,65.8,0.74
CpG: 117,chr17,36270990,36271922,932,117,672,25.1,72.1,0.98
CpG: 54,chr17,36836926,36837447,521,54,359,20.7,68.9,0.88
CpG: 53,chr17,36942898,36943413,515,53,366,20.6,71.1,0.84
CpG: 59,chr17,36947064,36947614,550,59,381,21.5,69.3,0.89
CpG: 31,chr17,36958464,36958744,280,31,166,22.1,59.3,1.27
CpG: 24,chr17,36988617,36988909,292,24,184,16.4,63,0.83
CpG: 37,chr17,37002645,37003006,361,37,245,20.5,67.9,0.92
CpG: 60,chr17,37046103,37046668,565,60,424,21.2,75,0.8
CpG: 44,chr17,37050633,37051202,569,44,402,15.5,70.7,0.62
CpG: 67,chr17,37197000,37197632,632,67,436,21.2,69,0.89
CpG: 81,chr17,39848220,39848823,603,81,431,26.9,71.5,1.05
CpG: 21,chr17,40880012,40880283,271,21,170,15.5,62.7,0.79
CpG: 36,chr17,40934424,40934808,384,36,225,18.8,58.6,1.09
CpG: 68,chr17,42316099,42316855,756,68,509,18,67.3,0.81
CpG: 88,chr17,42876150,42876818,668,88,503,26.3,75.3,0.93
CpG: 106,chr17,43016494,43017660,1166,106,743,18.2,63.7,0.9
CpG: 75,chr17,43629719,43630425,706,75,514,21.2,72.8,0.81
CpG: 40,chr17,43666850,43667324,474,40,309,16.9,65.2,0.79
CpG: 47,chr17,43801766,43802126,360,47,270,26.1,75,0.93
CpG: 63,chr17,44105459,44106013,554,63,372,22.7,67.1,1.03
CpG: 37,chr17,44188509,44188990,481,37,291,15.4,60.5,0.84
CpG: 180,chr17,44734450,44736635,2185,180,1311,16.5,60,0.92
CpG: 72,chr17,44776990,44777627,637,72,462,22.6,72.5,0.87
CpG: 125,chr17,45432941,45434265,1324,125,817,18.9,61.7,0.99
CpG: 40,chr17,45506771,45507118,347,40,237,23.1,68.3,0.99
CpG: 24,chr17,45534806,45535129,323,24,199,14.9,61.6,0.78
CpG: 126,chr17,45544794,45545946,1152,126,793,21.9,68.8,0.93
CpG: 22,chr17,45546788,45547088,300,22,186,14.7,62,0.78
CpG: 69,chr17,45549017,45549715,698,69,490,19.8,70.2,0.81
CpG: 52,chr17,45555602,45556285,683,52,445,15.2,65.2,0.72
CpG: 55,chr17,45563846,45564417,571,55,404,19.3,70.8,0.8
CpG: 85,chr17,45572480,45573436,956,85,662,17.8,69.2,0.74
CpG: 58,chr17,45595310,45595950,640,58,445,18.1,69.5,0.8
CpG: 26,chr17,45630235,45630577,342,26,215,15.2,62.9,0.84
CpG: 117,chr17,45685303,45686756,1453,117,974,16.1,67,0.73
CpG: 31,chr17,45733938,45734175,237,31,172,26.2,72.6,1
CpG: 48,chr17,45805324,45806022,698,48,456,13.8,65.3,0.66
CpG: 190,chr17,46030385,46032510,2125,190,1320,17.9,62.1,0.94
CpG: 34,chr17,46110925,46111313,388,34,261,17.5,67.3,0.78
CpG: 20,chr17,46160786,46161066,280,20,168,14.3,60,0.8
CpG: 69,chr17,46202358,46203009,651,69,424,21.2,65.1,1.01
CpG: 75,chr17,46247856,46248515,659,75,443,22.8,67.2,1.02
CpG: 74,chr17,46297850,46298653,803,74,531,18.4,66.1,0.86
CpG: 53,chr17,46327802,46328498,696,53,435,15.2,62.5,0.78
CpG: 111,chr17,46383388,46384503,1115,111,623,19.9,55.9,1.29
CpG: 45,chr17,46445024,46445511,487,45,351,18.5,72.1,0.76
CpG: 32,chr17,46455409,46455852,443,32,252,14.4,56.9,0.98
CpG: 30,chr17,46460769,46461013,244,30,178,24.6,73,0.97
CpG: 43,chr17,46487210,46487681,471,43,277,18.3,58.8,1.06
CpG: 34,chr17,46496688,46496998,310,34,204,21.9,65.8,1.05
CpG: 43,chr17,46545978,46546435,457,43,306,18.8,67,0.84
CpG: 146,chr17,46554990,46556376,1386,146,941,21.1,67.9,0.95
CpG: 21,chr17,46591648,46591898,250,21,167,16.8,66.8,0.76
CpG: 86,chr17,46628812,46629565,753,86,540,22.8,71.7,0.9
CpG: 51,chr17,46645985,46646515,530,51,334,19.2,63,0.97
CpG: 55,chr17,46650347,46650943,596,55,413,18.5,69.3,0.8
CpG: 19,chr17,46652982,46653195,213,19,132,17.8,62,0.93
CpG: 35,chr17,46674014,46674430,416,35,252,16.8,60.6,1
CpG: 54,chr17,46680623,46681204,581,54,386,18.6,66.4,0.85
CpG: 52,chr17,46704686,46705240,554,52,373,18.8,67.3,0.83
CpG: 108,chr17,46711310,46712307,997,108,709,21.7,71.1,0.86
CpG: 20,chr17,46728982,46729187,205,20,140,19.5,68.3,0.86
CpG: 50,chr17,46751919,46752337,418,50,301,23.9,72,0.93
CpG: 28,chr17,46772839,46773137,298,28,207,18.8,69.5,0.79
CpG: 105,chr17,46856498,46857512,1014,105,663,20.7,65.4,0.97
CpG: 42,chr17,46889446,46889983,537,42,343,15.6,63.9,0.78
CpG: 73,chr17,46890516,46891181,665,73,461,22,69.3,0.92
CpG: 15,chr17,46891283,46891485,202,15,122,14.9,60.4,0.82
CpG: 19,chr17,46980450,46980708,258,19,145,14.7,56.2,0.93
CpG: 69,chr17,47009941,47010533,592,69,417,23.3,70.4,0.95
CpG: 26,chr17,47140270,47140611,341,26,204,15.2,59.8,0.86
CpG: 44,chr17,47368840,47369346,506,44,311,17.4,61.5,0.93
CpG: 51,chr17,47410250,47410753,503,51,291,20.3,57.9,1.26
CpG: 28,chr17,47436425,47436687,262,28,169,21.4,64.5,1.05
CpG: 41,chr17,47468357,47468798,441,41,297,18.6,67.3,0.82
CpG: 30,chr17,47502082,47502388,306,30,201,19.6,65.7,0.91
CpG: 52,chr17,47593321,47593824,503,52,327,20.7,65,0.98
CpG: 15,chr17,47594793,47595003,210,15,131,14.3,62.4,0.78
CpG: 59,chr17,47610911,47611690,779,59,454,15.1,58.3,0.89
CpG: 45,chr17,47629346,47629748,402,45,252,22.4,62.7,1.17
CpG: 56,chr17,47672400,47672829,429,56,324,26.1,75.5,0.92
CpG: 98,chr17,47687880,47689191,1311,98,823,15,62.8,0.76
CpG: 71,chr17,47694468,47695447,979,71,542,14.5,55.4,0.95
CpG: 146,chr17,47736933,47738552,1619,146,1141,18,70.5,0.73
CpG: 45,chr17,47834157,47834650,493,45,335,18.3,68,0.79
CpG: 26,chr17,47872439,47872721,282,26,159,18.4,56.4,1.16
CpG: 21,chr17,47904322,47904530,208,21,144,20.2,69.2,0.88
CpG: 29,chr17,47909566,47909907,341,29,189,17,55.4,1.11
CpG: 43,chr17,47922202,47922748,546,43,328,15.8,60.1,0.87
CpG: 99,chr17,47923720,47924688,968,99,678,20.5,70,0.84
CpG: 20,chr17,47925048,47925253,205,20,148,19.5,72.2,0.75
CpG: 23,chr17,47936190,47936488,298,23,178,15.4,59.7,0.89
CpG: 30,chr17,47974183,47974437,254,30,168,23.6,66.1,1.08
CpG: 33,chr17,47975244,47975582,338,33,241,19.5,71.3,0.77
CpG: 31,chr17,48031560,48031922,362,31,249,17.1,68.8,0.73
CpG: 19,chr17,48042034,48042240,206,19,129,18.4,62.6,0.97
CpG: 22,chr17,48095752,48096001,249,22,153,17.7,61.4,0.94
CpG: 29,chr17,48096832,48097131,299,29,186,19.4,62.2,1
CpG: 42,chr17,48097612,48097998,386,42,272,21.8,70.5,0.88
CpG: 122,chr17,48409010,48410280,1270,122,832,19.2,65.5,0.9
CpG: 17,chr17,48786309,48786529,220,17,130,15.5,59.1,0.9
CpG: 52,chr17,48931717,48932316,599,52,360,17.4,60.1,0.96
CpG: 25,chr17,48932642,48932890,248,25,175,20.2,70.6,0.82
CpG: 26,chr17,49428250,49428549,299,26,199,17.4,66.6,0.79
CpG: 39,chr17,49615013,49615451,438,39,284,17.8,64.8,0.86
CpG: 80,chr17,50189903,50190663,760,80,512,21.1,67.4,0.95
CpG: 108,chr17,50292684,50293791,1107,108,776,19.5,70.1,0.8
CpG: 142,chr17,50508687,50510009,1322,142,850,21.5,64.3,1.04
CpG: 80,chr17,51178634,51179581,947,80,549,16.9,58,1.01
CpG: 96,chr17,51812627,51813649,1022,96,579,18.8,56.7,1.17
CpG: 134,chr17,51831760,51833245,1485,134,894,18,60.2,1
CpG: 25,chr17,52602339,52602580,241,25,167,20.7,69.3,0.88
CpG: 99,chr17,53479000,53479942,942,99,624,21,66.2,0.96
CpG: 121,chr17,53566976,53568220,1244,121,846,19.5,68,0.85
CpG: 54,chr17,53688993,53689412,419,54,269,25.8,64.2,1.27
CpG: 24,chr17,54298519,54298859,340,24,219,14.1,64.4,0.73
CpG: 63,chr17,55445480,55446118,638,63,443,19.7,69.4,0.82
CpG: 23,chr17,55482600,55482840,240,23,157,19.2,65.4,0.91
CpG: 25,chr17,55712392,55712695,303,25,172,16.5,56.8,1.1
CpG: 37,chr17,55878661,55879024,363,37,248,20.4,68.3,0.89
CpG: 35,chr17,55892083,55892384,301,35,217,23.3,72.1,0.91
CpG: 33,chr17,55944973,55945222,249,33,180,26.5,72.3,1.03
CpG: 22,chr17,55956145,55956363,218,22,154,20.2,70.6,0.82
CpG: 38,chr17,55959016,55959405,389,38,222,19.5,57.1,1.2
CpG: 39,chr17,55970424,55970767,343,39,249,22.7,72.6,0.89
CpG: 16,chr17,56000528,56000729,201,16,137,15.9,68.2,0.69
CpG: 57,chr17,56009070,56009607,537,57,374,21.2,69.6,0.88
CpG: 68,chr17,56036271,56036845,574,68,394,23.7,68.6,1.04
CpG: 42,chr17,56040209,56040603,394,42,232,21.3,58.9,1.25
CpG: 52,chr17,56074568,56075137,569,52,377,18.3,66.3,0.88
CpG: 59,chr17,56079292,56079874,582,59,386,20.3,66.3,0.96
CpG: 66,chr17,56119964,56120812,848,66,565,15.6,66.6,0.7
CpG: 110,chr17,56123812,56124909,1097,110,794,20.1,72.4,0.77
CpG: 50,chr17,56139577,56140083,506,50,371,19.8,73.3,0.74
CpG: 19,chr17,56141808,56142011,203,19,136,18.7,67,0.86
CpG: 16,chr17,56148781,56148985,204,16,129,15.7,63.2,0.84
CpG: 31,chr17,56162184,56162539,355,31,230,17.5,64.8,0.86
CpG: 46,chr17,56183691,56184086,395,46,263,23.3,66.6,1.05
CpG: 28,chr17,56255947,56256229,282,28,177,19.9,62.8,1.01
CpG: 104,chr17,56256645,56257632,987,104,654,21.1,66.3,0.96
CpG: 107,chr17,56303224,56304503,1279,107,813,16.7,63.6,0.83
CpG: 97,chr17,56325572,56326445,873,97,590,22.2,67.6,0.98
CpG: 21,chr17,56422765,56423077,312,21,177,13.5,56.7,1.24
CpG: 111,chr17,56425027,56425905,878,111,636,25.3,72.4,0.96
CpG: 25,chr17,56427969,56428173,204,25,155,24.5,76,0.86
CpG: 32,chr17,56428815,56429197,382,32,248,16.8,64.9,0.82
CpG: 67,chr17,56461764,56462513,749,67,498,17.9,66.5,0.83
CpG: 52,chr17,56473926,56474601,675,52,441,15.4,65.3,0.73
CpG: 91,chr17,56475692,56476627,935,91,667,19.5,71.3,0.77
CpG: 107,chr17,56511298,56512467,1169,107,808,18.3,69.1,0.77
CpG: 29,chr17,56566338,56566625,287,29,195,20.2,67.9,0.97
CpG: 169,chr17,56584148,56585552,1404,169,917,24.1,65.3,1.13
CpG: 27,chr17,56603535,56603798,263,27,176,20.5,66.9,1
CpG: 37,chr17,56609527,56609958,431,37,253,17.2,58.7,1
CpG: 80,chr17,56613296,56614198,902,80,585,17.7,64.9,0.85
CpG: 70,chr17,56626416,56626971,555,70,392,25.2,70.6,1.01
CpG: 76,chr17,56673148,56673948,800,76,519,19,64.9,0.91
CpG: 121,chr17,56716608,56718080,1472,121,913,16.4,62,0.86
CpG: 69,chr17,56751360,56751895,535,69,358,25.8,66.9,1.15
CpG: 86,chr17,56756886,56757665,779,86,568,22.1,72.9,0.83
CpG: 23,chr17,56762028,56762269,241,23,174,19.1,72.2,0.75
CpG: 41,chr17,56764639,56765058,419,41,261,19.6,62.3,1.03
CpG: 29,chr17,56829800,56830218,418,29,250,13.9,59.8,0.78
CpG: 59,chr17,56830890,56831414,524,59,349,22.5,66.6,1.02
CpG: 88,chr17,56935051,56935866,815,88,522,21.6,64,1.07
CpG: 56,chr17,56990083,56990700,617,56,375,18.2,60.8,0.98
CpG: 26,chr17,56997385,56997633,248,26,172,21,69.4,0.9
CpG: 59,chr17,57010984,57011806,822,59,481,14.4,58.5,0.85
CpG: 19,chr17,57022546,57022760,214,19,147,17.8,68.7,0.75
CpG: 71,chr17,57031133,57031927,794,71,454,17.9,57.2,1.12
CpG: 109,chr17,57059359,57060774,1415,109,867,15.4,61.3,0.82
CpG: 59,chr17,57062044,57062855,811,59,538,14.5,66.3,0.66
CpG: 25,chr17,57087448,57087687,239,25,159,20.9,66.5,0.95
CpG: 48,chr17,57105296,57105796,500,48,324,19.2,64.8,0.93
CpG: 27,chr17,57247388,57247719,331,27,222,16.3,67.1,0.73
CpG: 22,chr17,57249286,57249536,250,22,178,17.6,71.2,0.76
CpG: 21,chr17,57250575,57250825,250,21,157,16.8,62.8,0.85
CpG: 45,chr17,57275157,57275756,599,45,355,15,59.3,0.87
CpG: 18,chr17,59013119,59013320,201,18,121,17.9,60.2,0.99
CpG: 240,chr17,62879992,62883010,3018,240,1793,15.9,59.4,0.9
CpG: 21,chr17,63498949,63499180,231,21,168,18.2,72.7,0.72
CpG: 135,chr17,63499398,63500633,1235,135,776,21.9,62.8,1.12
CpG: 20,chr17,63849609,63849840,231,20,153,17.3,66.2,0.79
CpG: 144,chr17,63863235,63864594,1359,144,953,21.2,70.1,0.86
CpG: 81,chr17,64331374,64332299,925,81,574,17.5,62.1,0.91
CpG: 162,chr17,64600623,64602201,1578,162,1090,20.5,69.1,0.86
CpG: 165,chr17,65612617,65614037,1420,165,939,23.2,66.1,1.07
CpG: 67,chr17,65772281,65772887,606,67,428,22.1,70.6,0.89
CpG: 134,chr17,65782573,65783979,1406,134,775,19.1,55.1,1.27
CpG: 18,chr17,65849938,65850156,218,18,150,16.5,68.8,0.71
CpG: 88,chr17,65884163,65885192,1029,88,610,17.1,59.3,0.98
CpG: 85,chr17,65950714,65951346,632,85,488,26.9,77.2,0.93
CpG: 146,chr17,66076306,66077599,1293,146,850,22.6,65.7,1.05
CpG: 53,chr17,66101245,66101770,525,53,333,20.2,63.4,1.01
CpG: 31,chr17,66111528,66111801,273,31,203,22.7,74.4,0.87
CpG: 42,chr17,66123483,66123852,369,42,251,22.8,68,1.06
CpG: 22,chr17,66379499,66379752,253,22,167,17.4,66,0.83
CpG: 178,chr17,66448436,66449896,1460,178,1029,24.4,70.5,0.98
CpG: 87,chr17,66519033,66519912,879,87,571,19.8,65,0.94
CpG: 160,chr17,67353392,67355035,1643,160,1102,19.5,67.1,0.87
CpG: 69,chr17,67697110,67697827,717,69,504,19.2,70.3,0.8
CpG: 49,chr17,68003884,68004335,451,49,297,21.7,65.9,1.01
CpG: 26,chr17,68273759,68273977,218,26,161,23.9,73.9,0.91
CpG: 64,chr17,68836838,68837476,638,64,407,20.1,63.8,0.99
CpG: 82,chr17,68841172,68842033,861,82,620,19,72,0.74
CpG: 72,chr17,69075583,69076524,941,72,608,15.3,64.6,0.73
CpG: 107,chr17,69156673,69157546,873,107,655,24.5,75,0.87
CpG: 171,chr17,69382485,69384286,1801,171,1091,19,60.6,1.04
CpG: 28,chr17,69387388,69387771,383,28,192,14.6,50.1,1.17
CpG: 75,chr17,69417141,69417876,735,75,485,20.4,66,0.94
CpG: 88,chr17,69439150,69440119,969,88,651,18.2,67.2,0.8
CpG: 96,chr17,69969025,69969888,863,96,585,22.2,67.8,0.97
CpG: 23,chr17,69970320,69970623,303,23,190,15.2,62.7,0.79
CpG: 22,chr17,70516168,70516453,285,22,185,15.4,64.9,0.75
CpG: 17,chr17,70657569,70657782,213,17,131,16,61.5,0.85
CpG: 21,chr17,70662573,70662785,212,21,138,19.8,65.1,0.94
CpG: 45,chr17,70818058,70818412,354,45,256,25.4,72.3,1.01
CpG: 20,chr17,70834525,70834798,273,20,169,14.7,61.9,0.78
CpG: 24,chr17,70851698,70852013,315,24,188,15.2,59.7,0.86
CpG: 18,chr17,70852397,70852628,231,18,129,15.6,55.8,1
CpG: 81,chr17,70852767,70853824,1057,81,619,15.3,58.6,0.9
CpG: 81,chr17,70990160,70990921,761,81,541,21.3,71.1,0.84
CpG: 95,chr17,71001713,71002777,1064,95,647,17.9,60.8,0.97
CpG: 98,chr17,71183169,71184172,1003,98,579,19.5,57.7,1.17
CpG: 68,chr17,71310456,71311277,821,68,531,16.6,64.7,0.8
CpG: 135,chr17,71474748,71475973,1225,135,827,22,67.5,0.97
CpG: 63,chr17,71526590,71527207,617,63,386,20.4,62.6,1.05
CpG: 82,chr17,71551812,71552520,708,82,497,23.2,70.2,0.94
CpG: 58,chr17,71598348,71598932,584,58,376,19.9,64.4,0.96
CpG: 90,chr17,71616052,71616998,946,90,624,19,66,0.88
CpG: 75,chr17,71782570,71783072,502,75,405,29.9,80.7,0.93
CpG: 34,chr17,71869551,71870004,453,34,260,15,57.4,0.91
CpG: 22,chr17,72603440,72603654,214,22,147,20.6,68.7,0.88
CpG: 66,chr17,72604122,72604800,678,66,466,19.5,68.7,0.83
CpG: 21,chr17,72836216,72836475,259,21,162,16.2,62.5,0.84
CpG: 87,chr17,72836603,72837697,1094,87,597,15.9,54.6,1.07
CpG: 50,chr17,72917882,72918436,554,50,366,18.1,66.1,0.83
CpG: 20,chr17,72919337,72919599,262,20,160,15.3,61.1,0.82
CpG: 63,chr17,73107861,73108488,627,63,427,20.1,68.1,0.87
CpG: 96,chr17,73709600,73710584,984,96,679,19.5,69,0.82
CpG: 28,chr17,73804744,73804964,220,28,156,25.5,70.9,1.02
CpG: 34,chr17,74047455,74047922,467,34,296,14.6,63.4,0.73
CpG: 125,chr17,74294397,74295790,1393,125,793,17.9,56.9,1.12
CpG: 66,chr17,74315984,74316613,629,66,429,21,68.2,0.91
CpG: 99,chr17,74338516,74339433,917,99,560,21.6,61.1,1.16
CpG: 32,chr17,74395469,74395798,329,32,215,19.5,65.3,0.92
CpG: 56,chr17,74489447,74489968,521,56,384,21.5,73.7,0.79
CpG: 127,chr17,74527820,74529348,1528,127,979,16.6,64.1,0.81
CpG: 103,chr17,75005540,75006469,929,103,692,22.2,74.5,0.8
CpG: 44,chr17,75551494,75552006,512,44,332,17.2,64.8,0.82
CpG: 26,chr17,78199717,78200011,294,26,172,17.7,58.5,1.05
CpG: 109,chr17,78200192,78201482,1290,109,801,16.9,62.1,0.88
CpG: 43,chr17,78417689,78418176,487,43,304,17.7,62.4,0.91
CpG: 18,chr17,78624809,78625029,220,18,128,16.4,58.2,0.97
CpG: 84,chr17,78736230,78737075,845,84,567,19.9,67.1,0.9
CpG: 76,chr17,78834894,78835689,795,76,534,19.1,67.2,0.85
CpG: 31,chr17,78916476,78916767,291,31,198,21.3,68,0.93
CpG: 47,chr17,78936648,78937267,619,47,368,15.2,59.5,0.86
CpG: 92,chr17,79020318,79021238,920,92,527,20,57.3,1.22
CpG: 42,chr17,79052193,79052787,594,42,392,14.1,66,0.65
CpG: 128,chr17,79354421,79355989,1568,128,1002,16.3,63.9,0.8
CpG: 59,chr17,79615046,79615639,593,59,440,19.9,74.2,0.72
CpG: 81,chr17,79713371,79714228,857,81,550,18.9,64.2,0.92
CpG: 40,chr17,79715711,79716132,421,40,286,19,67.9,0.82
CpG: 133,chr17,79895032,79896323,1291,133,859,20.6,66.5,0.95
CpG: 145,chr17,80061180,80062637,1457,145,868,19.9,59.6,1.12
CpG: 120,chr17,80206453,80207525,1072,120,714,22.4,66.6,1.01
CpG: 44,chr17,80289993,80290504,511,44,344,17.2,67.3,0.76
CpG: 113,chr17,80373093,80374015,922,113,617,24.5,66.9,1.09
CpG: 103,chr17,80479489,80480644,1155,103,634,17.8,54.9,1.18
CpG: 30,chr17,80482939,80483191,252,30,174,23.8,69,1
CpG: 21,chr17,80543498,80543773,275,21,154,15.3,56,0.99
CpG: 28,chr17,80577215,80577512,297,28,203,18.9,68.4,0.85
CpG: 61,chr17,80727461,80728125,664,61,378,18.4,56.9,1.15
CpG: 78,chr17,80944609,80945206,597,78,437,26.1,73.2,0.98
CpG: 40,chr17,81064890,81065191,301,40,220,26.6,73.1,1
CpG: 42,chr17,81670032,81670578,546,42,301,15.4,55.1,1.04
CpG: 31,chr17,83214696,83215048,352,31,259,17.6,73.6,0.71
CpG: 19,chr17,83215491,83215722,231,19,120,16.5,51.9,1.22
CpG: 31,chr17,83215860,83216123,263,31,181,23.6,68.8,1
CpG: 52,chr17,83276190,83276617,427,52,313,24.4,73.3,0.91
CpG: 84,chr17,83350797,83351408,611,84,406,27.5,66.4,1.25
CpG: 51,chr17,83514050,83514714,664,51,403,15.4,60.7,0.83
CpG: 117,chr17,83630954,83631945,991,117,634,23.6,64,1.15
CpG: 63,chr17,83705909,83706510,601,63,422,21,70.2,0.85
CpG: 48,chr17,83861542,83861941,399,48,290,24.1,72.7,0.91
CpG: 23,chr17,84067171,84067444,273,23,182,16.8,66.7,0.76
CpG: 50,chr17,84096559,84097062,503,50,332,19.9,66,0.91
CpG: 301,chr17,84185601,84188714,3113,301,1977,19.3,63.5,0.97
CpG: 57,chr17,84268913,84269769,856,57,541,13.3,63.2,0.68
CpG: 59,chr17,84465745,84466346,601,59,387,19.6,64.4,0.95
CpG: 76,chr17,84511792,84512458,666,76,468,22.8,70.3,0.93
CpG: 23,chr17,84676038,84676326,288,23,189,16,65.6,0.74
CpG: 62,chr17,84790283,84791020,737,62,466,16.8,63.2,0.84
CpG: 58,chr17,84958313,84958724,411,58,309,28.2,75.2,1
CpG: 17,chr17,85059720,85059967,247,17,131,13.8,53,0.98
CpG: 38,chr17,85090542,85090981,439,38,298,17.3,67.9,0.76
CpG: 33,chr17,85486587,85486944,357,33,212,18.5,59.4,1.05
CpG: 21,chr17,85608135,85608380,245,21,163,17.1,66.5,0.81
CpG: 26,chr17,85608944,85609182,238,26,167,21.8,70.2,0.92
CpG: 17,chr17,85612637,85612852,215,17,109,15.8,50.7,1.31
CpG: 30,chr17,85614989,85615345,356,30,246,16.9,69.1,0.83
CpG: 51,chr17,85617968,85618636,668,51,444,15.3,66.5,0.69
CpG: 61,chr17,85621504,85622067,563,61,376,21.7,66.8,0.97
CpG: 35,chr17,85623596,85623904,308,35,222,22.7,72.1,0.88
CpG: 35,chr17,85685053,85685475,422,35,281,16.6,66.6,0.75
CpG: 123,chr17,85687043,85688613,1570,123,834,15.7,53.1,1.11
CpG: 27,chr17,85689101,85689403,302,27,197,17.9,65.2,0.85
CpG: 62,chr17,85691896,85692854,958,62,568,12.9,59.3,0.74
CpG: 48,chr17,85800072,85800584,512,48,369,18.8,72.1,0.76
CpG: 18,chr17,85800721,85800965,244,18,157,14.8,64.3,0.72
CpG: 34,chr17,86144792,86145207,415,34,217,16.4,52.3,1.2
CpG: 31,chr17,86166439,86166839,400,31,235,15.5,58.8,0.91
CpG: 165,chr17,86167253,86168971,1718,165,1027,19.2,59.8,1.08
CpG: 18,chr17,86257793,86258030,237,18,175,15.2,73.8,0.87
CpG: 165,chr17,86753119,86755548,2429,165,1402,13.6,57.7,0.82
CpG: 70,chr17,86962877,86963752,875,70,476,16,54.4,1.09
CpG: 14,chr17,87012813,87013024,211,14,109,13.3,51.7,1.08
CpG: 14,chr17,87013143,87013354,211,14,109,13.3,51.7,1.08
CpG: 14,chr17,87013539,87013750,211,14,109,13.3,51.7,1.08
CpG: 79,chr17,87024778,87025594,816,79,550,19.4,67.4,0.85
CpG: 117,chr17,87107096,87108312,1216,117,807,19.2,66.4,0.88
CpG: 20,chr17,87133914,87134157,243,20,142,16.5,58.4,0.97
CpG: 33,chr17,87134638,87135157,519,33,286,12.7,55.1,0.84
CpG: 28,chr17,87265626,87265902,276,28,193,20.3,69.9,0.87
CpG: 107,chr17,87282457,87283532,1075,107,703,19.9,65.4,0.93
CpG: 136,chr17,87446108,87447406,1298,136,887,21,68.3,0.92
CpG: 75,chr17,87636416,87637283,867,75,507,17.3,58.5,1.02
CpG: 26,chr17,87640236,87640518,282,26,167,18.4,59.2,1.05
CpG: 65,chr17,87672359,87672989,630,65,398,20.6,63.2,1.06
CpG: 30,chr17,87694517,87694875,358,30,211,16.8,58.9,1.24
CpG: 92,chr17,87745987,87746792,805,92,548,22.9,68.1,1
CpG: 182,chr17,87796961,87798830,1869,182,1224,19.5,65.5,0.91
CpG: 128,chr17,87974680,87975793,1113,128,792,23,71.2,0.91
CpG: 144,chr17,88064153,88065900,1747,144,973,16.5,55.7,1.06
CpG: 38,chr17,88255881,88256461,580,38,357,13.1,61.6,0.7
CpG: 156,chr17,88440298,88441824,1526,156,932,20.4,61.1,1.1
CpG: 28,chr17,88486451,88486745,294,28,187,19,63.6,0.94
CpG: 32,chr17,88529888,88530150,262,32,187,24.4,71.4,0.96
CpG: 60,chr17,90454975,90455799,824,60,522,14.6,63.3,0.73
CpG: 105,chr17,91087924,91088778,854,105,604,24.6,70.7,0.98
CpG: 19,chr17,93202758,93202998,240,19,134,15.8,55.8,1.03
CpG: 28,chr17,94608157,94608485,328,28,200,17.1,61,0.92
CpG: 62,chr17,94749608,94750228,620,62,377,20,60.8,1.08
CpG: 59,chr18,36961681,36962396,715,59,435,16.5,60.8,0.92
CpG: 49,chr18,37486534,37487214,680,49,425,14.4,62.5,0.74
CpG: 127,chr18,3336789,3338073,1284,127,788,19.8,61.4,1.05
CpG: 45,chr18,3383028,3383497,469,45,338,19.2,72.1,0.74
CpG: 126,chr18,3507134,3508532,1398,126,937,18,67,0.82
CpG: 18,chr18,3864086,3864324,238,18,141,15.1,59.2,0.86
CpG: 25,chr18,4052556,4052769,213,25,138,23.5,64.8,1.12
CpG: 51,chr18,4352894,4353504,610,51,407,16.7,66.7,0.75
CpG: 37,chr18,4375547,4375931,384,37,232,19.3,60.4,1.06
CpG: 74,chr18,4634916,4635554,638,74,471,23.2,73.8,0.85
CpG: 60,chr18,4920375,4921106,731,60,451,16.4,61.7,0.87
CpG: 46,chr18,4921681,4922357,676,46,434,13.6,64.2,0.67
CpG: 41,chr18,5163121,5163619,498,41,309,16.5,62,0.86
CpG: 72,chr18,5334180,5334975,795,72,478,18.1,60.1,1.02
CpG: 172,chr18,5591347,5593505,2158,172,1155,15.9,53.5,1.12
CpG: 73,chr18,6135516,6136250,734,73,508,19.9,69.2,0.84
CpG: 81,chr18,6240807,6241596,789,81,532,20.5,67.4,0.91
CpG: 131,chr18,6489942,6491263,1321,131,794,19.8,60.1,1.1
CpG: 56,chr18,6516014,6516482,468,56,328,23.9,70.1,1
CpG: 50,chr18,6764956,6765507,551,50,376,18.1,68.2,0.79
CpG: 29,chr18,7002296,7002659,363,29,227,16,62.5,0.82
CpG: 33,chr18,7004628,7004906,278,33,181,23.7,65.1,1.13
CpG: 41,chr18,7626533,7626950,417,41,295,19.7,70.7,0.79
CpG: 74,chr18,7692915,7693417,502,74,358,29.5,71.3,1.16
CpG: 171,chr18,7868553,7870002,1449,171,962,23.6,66.4,1.08
CpG: 20,chr18,8693874,8694081,207,20,135,19.3,65.2,0.92
CpG: 218,chr18,9212147,9214929,2782,218,1705,15.7,61.3,0.83
CpG: 103,chr18,9449439,9450330,891,103,567,23.1,63.6,1.14
CpG: 74,chr18,9707417,9708180,763,74,478,19.4,62.6,1.01
CpG: 59,chr18,9957850,9958468,618,59,392,19.1,63.4,0.96
CpG: 40,chr18,10029762,10030102,340,40,237,23.5,69.7,0.98
CpG: 98,chr18,10181248,10182286,1038,98,685,18.9,66,0.87
CpG: 66,chr18,10325111,10325817,706,66,490,18.7,69.4,0.78
CpG: 119,chr18,10609529,10610465,936,119,680,25.4,72.6,0.96
CpG: 55,chr18,10617688,10618214,526,55,337,20.9,64.1,1.02
CpG: 68,chr18,10706209,10707045,836,68,546,16.3,65.3,0.77
CpG: 125,chr18,10725519,10726636,1117,125,718,22.4,64.3,1.08
CpG: 29,chr18,11048373,11048641,268,29,176,21.6,65.7,1.01
CpG: 33,chr18,11052638,11052989,351,33,231,18.8,65.8,0.92
CpG: 135,chr18,11054059,11055229,1170,135,827,23.1,70.7,0.93
CpG: 19,chr18,11059069,11059297,228,19,142,16.7,62.3,0.87
CpG: 24,chr18,11239701,11239924,223,24,163,21.5,73.1,0.85
CpG: 96,chr18,11657125,11658038,913,96,600,21,65.7,0.98
CpG: 156,chr18,11839163,11840888,1725,156,1051,18.1,60.9,0.98
CpG: 33,chr18,12121274,12121627,353,33,241,18.7,68.3,0.81
CpG: 34,chr18,12128805,12129169,364,34,237,18.7,65.1,0.88
CpG: 42,chr18,12168679,12168976,297,42,212,28.3,71.4,1.12
CpG: 53,chr18,12236212,12236716,504,53,344,21,68.3,0.9
CpG: 40,chr18,12305494,12305853,359,40,245,22.3,68.2,0.97
CpG: 38,chr18,12333853,12334322,469,38,330,16.2,70.4,0.66
CpG: 71,chr18,12643567,12644403,836,71,533,17,63.8,0.84
CpG: 28,chr18,12741279,12741568,289,28,195,19.4,67.5,0.87
CpG: 45,chr18,12862135,12862594,459,45,326,19.6,71,0.78
CpG: 56,chr18,12941420,12941956,536,56,359,20.9,67,0.94
CpG: 35,chr18,12973303,12973796,493,35,275,14.2,55.8,0.92
CpG: 55,chr18,13970139,13970852,713,55,469,15.4,65.8,0.72
CpG: 34,chr18,13971238,13971610,372,34,191,18.3,51.3,1.42
CpG: 148,chr18,14682100,14683310,1210,148,849,24.5,70.2,1
CpG: 100,chr18,14782917,14783711,794,100,539,25.2,67.9,1.1
CpG: 186,chr18,15061856,15064339,2483,186,1440,15,58,0.89
CpG: 24,chr18,15064645,15064928,283,24,179,17,63.3,0.85
CpG: 127,chr18,15149779,15151253,1474,127,932,17.2,63.2,0.86
CpG: 42,chr18,15759890,15760238,348,42,247,24.1,71,0.96
CpG: 21,chr18,16806909,16807133,224,21,158,18.8,70.5,0.76
CpG: 153,chr18,16808083,16809635,1552,153,922,19.7,59.4,1.12
CpG: 34,chr18,20058957,20059346,389,34,259,17.5,66.6,0.82
CpG: 50,chr18,20558001,20558498,497,50,360,20.1,72.4,0.77
CpG: 133,chr18,20745429,20746466,1037,133,756,25.7,72.9,0.97
CpG: 83,chr18,20895671,20896567,896,83,577,18.5,64.4,0.89
CpG: 51,chr18,20961351,20961830,479,51,337,21.3,70.4,0.86
CpG: 134,chr18,21001201,21002536,1335,134,884,20.1,66.2,0.92
CpG: 112,chr18,21299478,21300700,1222,112,855,18.3,70,0.78
CpG: 23,chr18,21651498,21651709,211,23,142,21.8,67.3,0.96
CpG: 34,chr18,21652712,21653205,493,34,304,13.8,61.7,0.74
CpG: 117,chr18,22343709,22344970,1261,117,706,18.6,56,1.18
CpG: 70,chr18,23039176,23040174,998,70,607,14,60.8,0.76
CpG: 42,chr18,23041263,23041637,374,42,269,22.5,71.9,0.87
CpG: 90,chr18,23310236,23310954,718,90,539,25.1,75.1,0.91
CpG: 30,chr18,23752258,23752631,373,30,246,16.1,66,0.74
CpG: 48,chr18,23803759,23804310,551,48,361,17.4,65.5,0.82
CpG: 74,chr18,23954400,23955097,697,74,468,21.2,67.1,0.97
CpG: 94,chr18,24020235,24021139,904,94,616,20.8,68.1,0.9
CpG: 40,chr18,24121557,24122038,481,40,304,16.6,63.2,0.83
CpG: 131,chr18,24205269,24206499,1230,131,727,21.3,59.1,1.23
CpG: 75,chr18,24466837,24467878,1041,75,620,14.4,59.6,0.82
CpG: 30,chr18,24470743,24471113,370,30,203,16.2,54.9,1.09
CpG: 75,chr18,24529450,24530328,878,75,543,17.1,61.8,0.91
CpG: 113,chr18,24603148,24604311,1163,113,765,19.4,65.8,0.9
CpG: 39,chr18,24653652,24654041,389,39,271,20.1,69.7,0.83
CpG: 102,chr18,24709231,24710350,1119,102,754,18.2,67.4,0.81
CpG: 86,chr18,25168534,25169303,769,86,544,22.4,70.7,0.89
CpG: 32,chr18,25486690,25487054,364,32,253,17.6,69.5,0.73
CpG: 25,chr18,25487218,25487562,344,25,228,14.5,66.3,0.66
CpG: 62,chr18,25678896,25679516,620,62,413,20,66.6,0.9
CpG: 39,chr18,25753120,25753598,478,39,301,16.3,63,0.84
CpG: 88,chr18,25754292,25755540,1248,88,734,14.1,58.8,0.82
CpG: 32,chr18,30272772,30273167,395,32,245,16.2,62,0.87
CpG: 67,chr18,31609342,31609965,623,67,390,21.5,62.6,1.1
CpG: 108,chr18,31633982,31635448,1466,108,900,14.7,61.4,0.79
CpG: 94,chr18,31759361,31760640,1279,94,831,14.7,65,0.7
CpG: 30,chr18,31788942,31789220,278,30,190,21.6,68.3,0.94
CpG: 60,chr18,31803980,31804512,532,60,340,22.6,63.9,1.12
CpG: 115,chr18,31910458,31911358,900,115,641,25.6,71.2,1.01
CpG: 57,chr18,31938999,31939376,377,57,267,30.2,70.8,1.21
CpG: 77,chr18,32067582,32068297,715,77,476,21.5,66.6,0.98
CpG: 104,chr18,32162806,32163600,794,104,574,26.2,72.3,1
CpG: 33,chr18,32240120,32240537,417,33,237,15.8,56.8,1
CpG: 44,chr18,32377246,32377767,521,44,345,16.9,66.2,0.77
CpG: 30,chr18,32559636,32559955,319,30,221,18.8,69.3,0.79
CpG: 45,chr18,32837201,32837621,420,45,274,21.4,65.2,1.01
CpG: 64,chr18,32939145,32939664,519,64,367,24.7,70.7,0.99
CpG: 34,chr18,33213715,33214111,396,34,260,17.2,65.7,0.8
CpG: 75,chr18,33463801,33464445,644,75,431,23.3,66.9,1.04
CpG: 52,chr18,33794657,33795151,494,52,330,21.1,66.8,0.95
CpG: 150,chr18,34005895,34007537,1642,150,1110,18.3,67.6,0.8
CpG: 95,chr18,34220798,34221561,763,95,552,24.9,72.3,0.95
CpG: 73,chr18,34330875,34331538,663,73,431,22,65,1.04
CpG: 79,chr18,34372891,34373534,643,79,444,24.6,69.1,1.04
CpG: 29,chr18,34409135,34409492,357,29,199,16.2,55.7,1.06
CpG: 70,chr18,34506391,34506954,563,70,370,24.9,65.7,1.15
CpG: 45,chr18,34624016,34624637,621,45,357,14.5,57.5,0.9
CpG: 44,chr18,34651353,34651844,491,44,298,17.9,60.7,1
CpG: 29,chr18,34720197,34720469,272,29,195,21.3,71.7,0.84
CpG: 38,chr18,34759386,34759806,420,38,283,18.1,67.4,0.8
CpG: 97,chr18,34776911,34777725,814,97,625,23.8,76.8,0.83
CpG: 32,chr18,34840554,34840854,300,32,219,21.3,73,0.8
CpG: 23,chr18,34859826,34860053,227,23,157,20.3,69.2,0.85
CpG: 70,chr18,34860474,34861222,748,70,524,18.7,70.1,0.76
CpG: 27,chr18,34887517,34887785,268,27,184,20.1,68.7,0.89
CpG: 102,chr18,34931397,34932559,1162,102,739,17.6,63.6,0.87
CpG: 94,chr18,34954057,34955064,1007,94,627,18.7,62.3,0.97
CpG: 96,chr18,35118494,35119504,1010,96,645,19,63.9,0.93
CpG: 33,chr18,35498629,35498921,292,33,209,22.6,71.6,0.88
CpG: 119,chr18,35562004,35563062,1058,119,716,22.5,67.7,0.99
CpG: 64,chr18,35598516,35599306,790,64,483,16.2,61.1,0.87
CpG: 255,chr18,35652355,35655329,2974,255,1942,17.1,65.3,0.81
CpG: 23,chr18,35662055,35662286,231,23,156,19.9,67.5,0.89
CpG: 22,chr18,35703036,35703240,204,22,128,21.6,62.7,1.1
CpG: 78,chr18,35771332,35772201,869,78,521,18,60,1.01
CpG: 208,chr18,35829534,35832011,2477,208,1575,16.8,63.6,0.84
CpG: 26,chr18,35860500,35860796,296,26,186,17.6,62.8,0.9
CpG: 52,chr18,35873259,35873857,598,52,415,17.4,69.4,0.72
CpG: 172,chr18,35887876,35890054,2178,172,1363,15.8,62.6,0.81
CpG: 29,chr18,35919005,35919290,285,29,188,20.4,66,0.94
CpG: 52,chr18,35920049,35920581,532,52,349,19.5,65.6,0.91
CpG: 49,chr18,35930380,35930853,473,49,330,20.7,69.8,0.85
CpG: 38,chr18,35933276,35933711,435,38,274,17.5,63,0.9
CpG: 31,chr18,35938514,35938774,260,31,195,23.8,75,0.86
CpG: 25,chr18,35939614,35939888,274,25,176,18.2,64.2,0.9
CpG: 31,chr18,35964843,35965235,392,31,216,15.8,55.1,1.05
CpG: 95,chr18,36017863,36018679,816,95,488,23.3,59.8,1.31
CpG: 75,chr18,36068119,36068831,712,75,512,21.1,71.9,0.83
CpG: 82,chr18,36196549,36197534,985,82,574,16.6,58.3,0.98
CpG: 119,chr18,36280644,36281563,919,119,638,25.9,69.4,1.08
CpG: 51,chr18,36287309,36287892,583,51,374,17.5,64.2,0.85
CpG: 84,chr18,36320049,36320702,653,84,488,25.7,74.7,0.92
CpG: 75,chr18,36348471,36349252,781,75,539,19.2,69,0.84
CpG: 77,chr18,36515204,36516074,870,77,555,17.7,63.8,0.87
CpG: 167,chr18,36559433,36561371,1938,167,1202,17.2,62,0.9
CpG: 26,chr18,36670084,36670339,255,26,164,20.4,64.3,0.99
CpG: 54,chr18,36679075,36679656,581,54,364,18.6,62.7,0.95
CpG: 44,chr18,36725676,36726233,557,44,329,15.8,59.1,0.91
CpG: 38,chr18,36734961,36735403,442,38,281,17.2,63.6,0.85
CpG: 63,chr18,36744134,36744895,761,63,456,16.6,59.9,0.92
CpG: 25,chr18,36760138,36760492,354,25,216,14.1,61,0.76
CpG: 34,chr18,36765215,36765542,327,34,205,20.8,62.7,1.06
CpG: 38,chr18,36782966,36783523,557,38,347,13.6,62.3,0.72
CpG: 16,chr18,36793720,36793957,237,16,138,13.5,58.2,0.8
CpG: 31,chr18,36801622,36802025,403,31,226,15.4,56.1,0.98
CpG: 54,chr18,36931568,36932215,647,54,402,16.7,62.1,0.88
CpG: 24,chr18,36939418,36939712,294,24,185,16.3,62.9,0.86
CpG: 24,chr18,36940596,36940872,276,24,170,17.4,61.6,0.95
CpG: 45,chr18,36947609,36948159,550,45,346,16.4,62.9,0.85
CpG: 57,chr18,36953981,36954702,721,57,434,15.8,60.2,0.9
CpG: 34,chr18,36960437,36960908,471,34,276,14.4,58.6,0.86
CpG: 22,chr18,36967776,36968053,277,22,178,15.9,64.3,0.78
CpG: 28,chr18,36969034,36969310,276,28,168,20.3,60.9,1.14
CpG: 30,chr18,36975139,36975478,339,30,204,17.7,60.2,1
CpG: 22,chr18,36980149,36980458,309,22,189,14.2,61.2,0.78
CpG: 30,chr18,36993686,36994023,337,30,208,17.8,61.7,0.95
CpG: 59,chr18,36999250,36999959,709,59,436,16.6,61.5,0.89
CpG: 19,chr18,37005415,37005622,207,19,134,18.4,64.7,0.9
CpG: 27,chr18,37006603,37006879,276,27,172,19.6,62.3,1.05
CpG: 29,chr18,37012133,37012411,278,29,173,20.9,62.2,1.11
CpG: 32,chr18,37020351,37020802,451,32,251,14.2,55.7,0.93
CpG: 61,chr18,37021445,37022221,776,61,478,15.7,61.6,0.85
CpG: 36,chr18,37089892,37090399,507,36,314,14.2,61.9,0.75
CpG: 93,chr18,37143448,37144497,1049,93,680,17.7,64.8,0.86
CpG: 31,chr18,37309100,37309533,433,31,278,14.3,64.2,0.7
CpG: 24,chr18,37423195,37423515,320,24,206,15,64.4,0.73
CpG: 22,chr18,37449458,37449742,284,22,182,15.5,64.1,0.76
CpG: 22,chr18,37475092,37475418,326,22,199,13.5,61,0.74
CpG: 20,chr18,37491259,37491518,259,20,167,15.4,64.5,0.74
CpG: 39,chr18,37498657,37499209,552,39,351,14.1,63.6,0.7
CpG: 37,chr18,37505887,37506400,513,37,321,14.4,62.6,0.74
CpG: 38,chr18,37515304,37515787,483,38,307,15.7,63.6,0.78
CpG: 47,chr18,37643919,37644310,391,47,236,24,60.4,1.32
CpG: 20,chr18,37669646,37669911,265,20,151,15.1,57,0.93
CpG: 23,chr18,37674501,37674796,295,23,186,15.6,63.1,0.79
CpG: 49,chr18,37681925,37682414,489,49,321,20,65.6,0.93
CpG: 49,chr18,37691458,37691947,489,49,321,20,65.6,0.93
CpG: 22,chr18,37694513,37694761,248,22,161,17.7,64.9,0.85
CpG: 46,chr18,37722058,37722540,482,46,312,19.1,64.7,0.91
CpG: 60,chr18,37732639,37733134,495,60,331,24.2,66.9,1.08
CpG: 26,chr18,37742254,37742517,263,26,173,19.8,65.8,0.92
CpG: 55,chr18,37743738,37744233,495,55,324,22.2,65.5,1.04
CpG: 25,chr18,37751792,37752055,263,25,174,19,66.2,0.88
CpG: 43,chr18,37753253,37753712,459,43,288,18.7,62.7,0.95
CpG: 37,chr18,37755688,37756215,527,37,282,14,53.5,0.98
CpG: 50,chr18,37763392,37763874,482,50,317,20.7,65.8,0.96
CpG: 58,chr18,37766284,37766983,699,58,397,16.6,56.8,1.04
CpG: 41,chr18,37767918,37768507,589,41,356,13.9,60.4,0.77
CpG: 116,chr18,37805998,37807484,1486,116,887,15.6,59.7,0.88
CpG: 75,chr18,37934920,37935684,764,75,521,19.6,68.2,0.84
CpG: 100,chr18,37954879,37956138,1259,100,816,15.9,64.8,0.76
CpG: 27,chr18,37969709,37969968,259,27,179,20.8,69.1,0.88
CpG: 27,chr18,38185988,38186279,291,27,191,18.6,65.6,0.88
CpG: 37,chr18,38189421,38189937,516,37,346,14.3,67.1,0.67
CpG: 28,chr18,38197778,38198120,342,28,206,16.4,60.2,0.9
CpG: 28,chr18,38199080,38199450,370,28,221,15.1,59.7,0.85
CpG: 39,chr18,38209686,38210120,434,39,292,18,67.3,0.79
CpG: 72,chr18,38211349,38211961,612,72,447,23.5,73,0.9
CpG: 38,chr18,38239256,38239594,338,38,237,22.5,70.1,0.92
CpG: 41,chr18,38250094,38250571,477,41,316,17.2,66.2,0.78
CpG: 17,chr18,38268911,38269114,203,17,124,16.7,61.1,0.9
CpG: 64,chr18,38296566,38297185,619,64,445,20.7,71.9,0.81
CpG: 40,chr18,38338763,38339051,288,40,219,27.8,76,0.97
CpG: 62,chr18,38418900,38419370,470,62,332,26.4,70.6,1.06
CpG: 76,chr18,38600646,38601554,908,76,577,16.7,63.5,0.83
CpG: 99,chr18,38992909,38993832,923,99,633,21.5,68.6,0.91
CpG: 190,chr18,39488954,39490890,1936,190,1218,19.6,62.9,0.99
CpG: 43,chr18,39491237,39491852,615,43,383,14,62.3,0.72
CpG: 57,chr18,40218941,40219571,630,57,407,18.1,64.6,0.88
CpG: 28,chr18,41950867,41951237,370,28,238,15.1,64.3,0.73
CpG: 84,chr18,42274945,42276033,1088,84,687,15.4,63.1,0.79
CpG: 123,chr18,42394358,42395917,1559,123,921,15.8,59.1,0.91
CpG: 31,chr18,42401357,42401676,319,31,230,19.4,72.1,0.76
CpG: 91,chr18,42511060,42512291,1231,91,671,14.8,54.5,1
CpG: 28,chr18,43207454,43207756,302,28,218,18.5,72.2,0.72
CpG: 61,chr18,43392690,43393281,591,61,399,20.6,67.5,0.93
CpG: 52,chr18,43437867,43438427,560,52,391,18.6,69.8,0.77
CpG: 26,chr18,43477589,43477838,249,26,144,20.9,57.8,1.25
CpG: 72,chr18,44380290,44381141,851,72,562,16.9,66,0.8
CpG: 53,chr18,44661646,44662253,607,53,395,17.5,65.1,0.83
CpG: 38,chr18,44812023,44812376,353,38,241,21.5,68.3,0.93
CpG: 76,chr18,44828213,44829021,808,76,466,18.8,57.7,1.13
CpG: 21,chr18,45146888,45147093,205,21,134,20.5,65.4,0.97
CpG: 113,chr18,45559315,45560643,1328,113,838,17,63.1,0.88
CpG: 98,chr18,46198145,46199234,1089,98,719,18,66,0.83
CpG: 23,chr18,46211930,46212233,303,23,190,15.2,62.7,0.81
CpG: 46,chr18,46280466,46280868,402,46,287,22.9,71.4,0.9
CpG: 51,chr18,46311621,46312145,524,51,334,19.5,63.7,0.97
CpG: 38,chr18,46465553,46465857,304,38,208,25,68.4,1.09
CpG: 22,chr18,46525164,46525406,242,22,146,18.2,60.3,1
CpG: 74,chr18,46525602,46526349,747,74,493,19.8,66,0.91
CpG: 69,chr18,46597284,46597789,505,69,378,27.3,74.9,1.03
CpG: 48,chr18,46727722,46728278,556,48,368,17.3,66.2,0.79
CpG: 99,chr18,46741398,46742523,1125,99,652,17.6,58,1.04
CpG: 32,chr18,46850128,46850589,461,32,297,13.9,64.4,0.67
CpG: 42,chr18,46958729,46959130,401,42,277,20.9,69.1,0.91
CpG: 47,chr18,47366343,47367098,755,47,455,12.5,60.3,0.69
CpG: 52,chr18,47368649,47369218,569,52,393,18.3,69.1,0.77
CpG: 19,chr18,48046656,48046905,249,19,145,15.3,58.2,0.92
CpG: 56,chr18,49755326,49755889,563,56,354,19.9,62.9,1.01
CpG: 99,chr18,49832521,49833220,699,99,520,28.3,74.4,1.03
CpG: 38,chr18,50053331,50053706,375,38,257,20.3,68.5,0.87
CpG: 39,chr18,50128201,50128593,392,39,272,19.9,69.4,0.84
CpG: 24,chr18,51003010,51003230,220,24,135,21.8,61.4,1.16
CpG: 53,chr18,51117617,51117987,370,53,283,28.6,76.5,0.98
CpG: 55,chr18,52465569,52465967,398,55,285,27.6,71.6,1.09
CpG: 103,chr18,52528602,52529593,991,103,672,20.8,67.8,0.92
CpG: 69,chr18,52768100,52768989,889,69,527,15.5,59.3,0.89
CpG: 66,chr18,53176157,53177027,870,66,556,15.2,63.9,0.74
CpG: 77,chr18,53245281,53246033,752,77,476,20.5,63.3,1.04
CpG: 41,chr18,53417790,53418197,407,41,280,20.1,68.8,0.87
CpG: 19,chr18,53462842,53463091,249,19,157,15.3,63.1,0.78
CpG: 141,chr18,53463720,53465309,1589,141,972,17.7,61.2,0.95
CpG: 18,chr18,53552340,53552569,229,18,149,15.7,65.1,0.75
CpG: 55,chr18,53744268,53744834,566,55,367,19.4,64.8,0.93
CpG: 107,chr18,53861783,53862914,1131,107,592,18.9,52.3,1.39
CpG: 14,chr18,53996091,53996295,204,14,104,13.7,51,1.06
CpG: 16,chr18,54987840,54988043,203,16,132,15.8,65,0.75
CpG: 28,chr18,56432125,56432394,269,28,185,20.8,68.8,0.88
CpG: 43,chr18,56561972,56562623,651,43,432,13.2,66.4,0.61
CpG: 84,chr18,56572801,56573559,758,84,508,22.2,67,0.99
CpG: 205,chr18,56707292,56709053,1761,205,1226,23.3,69.6,0.96
CpG: 101,chr18,56924915,56925953,1038,101,693,19.5,66.8,0.87
CpG: 41,chr18,56975101,56975424,323,41,220,25.4,68.1,1.14
CpG: 29,chr18,57132796,57133110,314,29,212,18.5,67.5,0.83
CpG: 75,chr18,57354637,57355224,587,75,414,25.6,70.5,1.03
CpG: 24,chr18,57363093,57363398,305,24,196,15.7,64.3,0.84
CpG: 164,chr18,57877983,57879658,1675,164,1003,19.6,59.9,1.09
CpG: 102,chr18,58209372,58210485,1113,102,742,18.3,66.7,0.83
CpG: 73,chr18,58659229,58659930,701,73,428,20.8,61.1,1.12
CpG: 131,chr18,58836179,58837975,1796,131,1153,14.6,64.2,0.71
CpG: 155,chr18,59175008,59176469,1461,155,1012,21.2,69.3,0.88
CpG: 43,chr18,60526084,60526466,382,43,249,22.5,65.2,1.07
CpG: 61,chr18,60560588,60561141,553,61,370,22.1,66.9,0.99
CpG: 63,chr18,60595911,60596485,574,63,386,22,67.2,1
CpG: 41,chr18,60624100,60624449,349,41,272,23.5,77.9,0.8
CpG: 36,chr18,60748614,60748978,364,36,238,19.8,65.4,0.94
CpG: 69,chr18,60774322,60775034,712,69,465,19.4,65.3,0.91
CpG: 26,chr18,60848743,60848979,236,26,159,22,67.4,1.01
CpG: 32,chr18,60912059,60912483,424,32,283,15.1,66.7,0.68
CpG: 45,chr18,61013927,61014346,419,45,294,21.5,70.2,0.87
CpG: 77,chr18,61035675,61036479,804,77,514,19.2,63.9,0.95
CpG: 81,chr18,61176540,61177227,687,81,467,23.6,68,1.04
CpG: 64,chr18,61211256,61211846,590,64,412,21.7,69.8,0.89
CpG: 178,chr18,61398498,61400742,2244,178,1371,15.9,61.1,0.86
CpG: 32,chr18,61536383,61536677,294,32,206,21.8,70.1,0.91
CpG: 103,chr18,61554980,61555907,927,103,622,22.2,67.1,0.99
CpG: 21,chr18,61692185,61692411,226,21,152,18.6,67.3,0.84
CpG: 33,chr18,61707401,61707673,272,33,200,24.3,73.5,0.91
CpG: 47,chr18,61726054,61726589,535,47,319,17.6,59.6,0.99
CpG: 37,chr18,61786474,61786885,411,37,293,18,71.3,0.78
CpG: 41,chr18,61911512,61911894,382,41,281,21.5,73.6,0.8
CpG: 66,chr18,62179553,62180449,896,66,580,14.7,64.7,0.7
CpG: 55,chr18,62548279,62548924,645,55,402,17.1,62.3,0.88
CpG: 77,chr18,62922194,62922886,692,77,485,22.3,70.1,0.92
CpG: 47,chr18,62977755,62978264,509,47,330,18.5,64.8,0.88
CpG: 104,chr18,63386247,63387293,1046,104,723,19.9,69.1,0.83
CpG: 87,chr18,63691785,63692728,943,87,626,18.5,66.4,0.84
CpG: 27,chr18,63708532,63708867,335,27,213,16.1,63.6,0.8
CpG: 23,chr18,64265093,64265318,225,23,164,20.4,72.9,0.78
CpG: 26,chr18,64265912,64266277,365,26,239,14.2,65.5,0.67
CpG: 19,chr18,64339369,64339594,225,19,126,16.9,56,1.09
CpG: 116,chr18,64339970,64341500,1530,116,842,15.2,55,1.02
CpG: 26,chr18,64342725,64343015,290,26,185,17.9,63.8,0.9
CpG: 28,chr18,64428366,64428695,329,28,210,17,63.8,0.84
CpG: 50,chr18,64488819,64489322,503,50,325,19.9,64.6,0.95
CpG: 46,chr18,64516165,64516721,556,46,349,16.5,62.8,0.84
CpG: 20,chr18,64612236,64612503,267,20,139,15,52.1,1.11
CpG: 22,chr18,64659928,64660185,257,22,163,17.1,63.4,0.87
CpG: 88,chr18,64660491,64661510,1019,88,706,17.3,69.3,0.72
CpG: 79,chr18,64887841,64888561,720,79,507,21.9,70.4,0.89
CpG: 26,chr18,65083646,65084030,384,26,250,13.5,65.1,0.64
CpG: 99,chr18,65430475,65431478,1003,99,705,19.7,70.3,0.81
CpG: 83,chr18,65580590,65581418,828,83,520,20,62.8,1.02
CpG: 32,chr18,65873376,65873733,357,32,235,17.9,65.8,0.83
CpG: 55,chr18,65934810,65935393,583,55,408,18.9,70,0.78
CpG: 76,chr18,65938026,65939035,1009,76,632,15.1,62.6,0.77
CpG: 42,chr18,66002319,66002746,427,42,296,19.7,69.3,0.82
CpG: 63,chr18,66291244,66292008,764,63,503,16.5,65.8,0.76
CpG: 70,chr18,66458383,66458954,571,70,383,24.5,67.1,1.09
CpG: 73,chr18,67088229,67088859,630,73,430,23.2,68.3,1
CpG: 91,chr18,67133065,67134169,1104,91,724,16.5,65.6,0.77
CpG: 72,chr18,67205269,67206132,863,72,503,16.7,58.3,0.98
CpG: 59,chr18,67245174,67245725,551,59,389,21.4,70.6,0.86
CpG: 47,chr18,67289191,67289598,407,47,296,23.1,72.7,0.93
CpG: 26,chr18,67343627,67343870,243,26,164,21.4,67.5,0.95
CpG: 16,chr18,67343955,67344182,227,16,152,14.1,67,0.63
CpG: 97,chr18,67390539,67391610,1071,97,746,18.1,69.7,0.75
CpG: 29,chr18,67401351,67401784,433,29,262,13.4,60.5,0.74
CpG: 100,chr18,67448659,67449575,916,100,643,21.8,70.2,0.92
CpG: 72,chr18,67464726,67465471,745,72,472,19.3,63.4,0.97
CpG: 83,chr18,67610538,67611300,762,83,480,21.8,63,1.1
CpG: 109,chr18,67640842,67641784,942,109,604,23.1,64.1,1.14
CpG: 105,chr18,67723905,67724737,832,105,579,25.2,69.6,1.04
CpG: 102,chr18,67774596,67775396,800,102,540,25.5,67.5,1.12
CpG: 52,chr18,67799907,67800381,474,52,333,21.9,70.3,0.89
CpG: 114,chr18,67933011,67934268,1257,114,882,18.1,70.2,0.74
CpG: 61,chr18,68299897,68300444,547,61,373,22.3,68.2,0.96
CpG: 43,chr18,69198193,69198759,566,43,351,15.2,62,0.8
CpG: 34,chr18,69344225,69344539,314,34,214,21.7,68.2,0.94
CpG: 47,chr18,69346027,69346505,478,47,273,19.7,57.1,1.21
CpG: 24,chr18,70053062,70053299,237,24,167,20.3,70.5,0.82
CpG: 29,chr18,70471687,70472128,441,29,267,13.2,60.5,0.72
CpG: 43,chr18,70472237,70472607,370,43,245,23.2,66.2,1.06
CpG: 39,chr18,70530022,70530403,381,39,269,20.5,70.6,0.87
CpG: 58,chr18,70568069,70568580,511,58,351,22.7,68.7,0.99
CpG: 180,chr18,73572012,73573972,1960,180,1105,18.4,56.4,1.16
CpG: 31,chr18,73623088,73623343,255,31,172,24.3,67.5,1.08
CpG: 103,chr18,73703101,73704325,1224,103,625,16.8,51.1,1.29
CpG: 65,chr18,73754146,73754652,506,65,367,25.7,72.5,0.98
CpG: 98,chr18,73815121,73815953,832,98,589,23.6,70.8,0.94
CpG: 22,chr18,73970126,73970413,287,22,170,15.3,59.2,0.88
CpG: 128,chr18,74063832,74065542,1710,128,1079,15,63.1,0.75
CpG: 34,chr18,74207528,74207809,281,34,189,24.2,67.3,1.07
CpG: 70,chr18,74215985,74216596,611,70,382,22.9,62.5,1.2
CpG: 53,chr18,74267931,74268512,581,53,383,18.2,65.9,0.87
CpG: 65,chr18,74442474,74443028,554,65,380,23.5,68.6,1
CpG: 58,chr18,74778625,74779426,801,58,530,14.5,66.2,0.66
CpG: 37,chr18,74961155,74961619,464,37,267,15.9,57.5,0.98
CpG: 63,chr18,75000427,75000996,569,63,404,22.1,71,0.91
CpG: 34,chr18,75005719,75006114,395,34,253,17.2,64.1,0.84
CpG: 78,chr18,75018650,75019296,646,78,462,24.1,71.5,0.94
CpG: 102,chr18,75342383,75343490,1107,102,735,18.4,66.4,0.84
CpG: 199,chr18,75366489,75369009,2520,199,1459,15.8,57.9,0.94
CpG: 78,chr18,75696578,75697554,976,78,613,16,62.8,0.81
CpG: 16,chr18,75697675,75697888,213,16,137,15,64.3,0.73
CpG: 107,chr18,75819546,75820748,1202,107,704,17.8,58.6,1.05
CpG: 30,chr18,75821013,75821385,372,30,218,16.1,58.6,0.94
CpG: 37,chr18,76059471,76059802,331,37,247,22.4,74.6,0.81
CpG: 51,chr18,76145705,76146260,555,51,379,18.4,68.3,0.79
CpG: 28,chr18,76160976,76161283,307,28,170,18.2,55.4,1.19
CpG: 122,chr18,76241162,76242167,1005,122,610,24.3,60.7,1.32
CpG: 28,chr18,76844266,76844599,333,28,220,16.8,66.1,0.77
CpG: 34,chr18,76856085,76856469,384,34,250,17.7,65.1,0.85
CpG: 180,chr18,76858630,76860510,1880,180,1299,19.1,69.1,0.81
CpG: 42,chr18,76929902,76930293,391,42,275,21.5,70.3,0.9
CpG: 47,chr18,76944077,76944446,369,47,267,25.5,72.4,0.98
CpG: 15,chr18,77047264,77047473,209,15,117,14.4,56,0.93
CpG: 94,chr18,77064940,77065874,934,94,508,20.1,54.4,1.38
CpG: 93,chr18,77185359,77186116,757,93,542,24.6,71.6,0.98
CpG: 36,chr18,77254387,77254805,418,36,257,17.2,61.5,0.93
CpG: 18,chr18,77441514,77441726,212,18,120,17,56.6,1.08
CpG: 66,chr18,77565273,77565720,447,66,339,29.5,75.8,1.05
CpG: 163,chr18,77713202,77714572,1370,163,937,23.8,68.4,1.03
CpG: 30,chr18,77767588,77767846,258,30,179,23.3,69.4,0.98
CpG: 42,chr18,77773913,77774264,351,42,253,23.9,72.1,0.95
CpG: 53,chr18,77794615,77795114,499,53,331,21.2,66.3,0.97
CpG: 25,chr18,77938358,77938672,314,25,191,15.9,60.8,0.86
CpG: 55,chr18,78047215,78047654,439,55,321,25.1,73.1,0.96
CpG: 65,chr18,78048425,78048877,452,65,335,28.8,74.1,1.05
CpG: 118,chr18,79108934,79110423,1489,118,758,15.8,50.9,1.23
CpG: 91,chr18,80046780,80048073,1293,91,793,14.1,61.3,0.75
CpG: 23,chr18,80150693,80150942,249,23,159,18.5,63.9,0.92
CpG: 63,chr18,80151141,80151533,392,63,296,32.1,75.5,1.13
CpG: 16,chr18,80192607,80192810,203,16,124,15.8,61.1,0.86
CpG: 42,chr18,80200324,80200744,420,42,288,20,68.6,0.85
CpG: 88,chr18,80206549,80207411,862,88,575,20.4,66.7,0.94
CpG: 23,chr18,80236566,80236855,289,23,182,15.9,63,0.81
CpG: 79,chr18,80256045,80256924,879,79,593,18,67.5,0.79
CpG: 83,chr18,80295641,80296454,813,83,552,20.4,67.9,0.89
CpG: 105,chr18,80322438,80323222,784,105,554,26.8,70.7,1.07
CpG: 104,chr18,80362689,80363789,1100,104,751,18.9,68.3,0.82
CpG: 134,chr18,80469258,80470372,1114,134,721,24.1,64.7,1.15
CpG: 16,chr18,80697980,80698187,207,16,144,15.5,69.6,0.67
CpG: 112,chr18,80707591,80708663,1072,112,694,20.9,64.7,1.01
CpG: 134,chr18,80712422,80713971,1549,134,977,17.3,63.1,0.89
CpG: 47,chr18,80933577,80934142,565,47,324,16.6,57.3,1.01
CpG: 42,chr18,80971972,80972533,561,42,337,15,60.1,0.84
CpG: 38,chr18,80974099,80974628,529,38,347,14.4,65.6,0.67
CpG: 234,chr18,80985533,80987963,2430,234,1451,19.3,59.7,1.09
CpG: 17,chr18,80992297,80992499,202,17,113,16.8,55.9,1.08
CpG: 17,chr18,81510365,81510596,231,17,137,14.7,59.3,0.84
CpG: 24,chr18,81916242,81916539,297,24,186,16.2,62.6,0.83
CpG: 65,chr18,82405614,82406552,938,65,583,13.9,62.2,0.72
CpG: 44,chr18,82475041,82475476,435,44,315,20.2,72.4,0.77
CpG: 16,chr18,82476063,82476275,212,16,135,15.1,63.7,0.75
CpG: 28,chr18,82692090,82692423,333,28,236,16.8,70.9,0.68
CpG: 31,chr18,82692850,82693170,320,31,192,19.4,60,1.08
CpG: 20,chr18,82729907,82730126,219,20,126,18.3,57.5,1.11
CpG: 138,chr18,82909533,82911550,2017,138,1152,13.7,57.1,0.85
CpG: 44,chr18,82914121,82914732,611,44,314,14.4,51.4,1.09
CpG: 19,chr18,82957130,82957337,207,19,139,18.4,67.1,0.82
CpG: 16,chr18,84015466,84015676,210,16,128,15.2,61,0.82
CpG: 75,chr18,84085367,84086150,783,75,408,19.2,52.1,1.42
CpG: 122,chr18,84087394,84088726,1332,122,763,18.3,57.3,1.12
CpG: 20,chr18,84092107,84092337,230,20,147,17.4,63.9,0.85
CpG: 38,chr18,84588824,84589134,310,38,217,24.5,70,1
CpG: 58,chr18,84589445,84590182,737,58,446,15.7,60.5,0.86
CpG: 52,chr18,84685270,84685855,585,52,413,17.8,70.6,0.74
CpG: 43,chr18,84720052,84720470,418,43,254,20.6,60.8,1.13
CpG: 37,chr18,84951926,84952277,351,37,233,21.1,66.4,0.99
CpG: 43,chr18,86395212,86395673,461,43,283,18.7,61.4,0.99
CpG: 35,chr18,86711429,86711761,332,35,225,21.1,67.8,0.94
CpG: 36,chr18,86712993,86713451,458,36,312,15.7,68.1,0.68
CpG: 30,chr18,88869999,88870453,454,30,289,13.2,63.7,0.65
CpG: 75,chr18,88893811,88894429,618,75,458,24.3,74.1,0.9
CpG: 20,chr18,88971959,88972173,214,20,129,18.7,60.3,1.08
CpG: 63,chr18,89769144,89769598,454,63,341,27.8,75.1,1
CpG: 48,chr18,90509935,90510537,602,48,350,15.9,58.1,0.94
CpG: 259,chr19,26604478,26607883,3405,259,2142,15.2,62.9,0.77
CpG: 42,chr19,30539445,30539799,354,42,255,23.7,72,0.92
CpG: 41,chr19,3282687,3283232,545,41,348,15,63.9,0.74
CpG: 66,chr19,3323338,3324182,844,66,548,15.6,64.9,0.75
CpG: 44,chr19,3325130,3325570,440,44,283,20,64.3,0.97
CpG: 77,chr19,3388813,3389374,561,77,406,27.5,72.4,1.05
CpG: 32,chr19,3414320,3414596,276,32,191,23.2,69.2,0.98
CpG: 99,chr19,3575227,3576246,1019,99,665,19.4,65.3,0.92
CpG: 93,chr19,3685805,3686592,787,93,557,23.6,70.8,0.94
CpG: 54,chr19,3708133,3708709,576,54,377,18.8,65.5,0.91
CpG: 188,chr19,3767370,3769102,1732,188,1129,21.7,65.2,1.03
CpG: 104,chr19,3851599,3852560,961,104,599,21.6,62.3,1.12
CpG: 19,chr19,3907032,3907265,233,19,129,16.3,55.4,1.08
CpG: 53,chr19,4000365,4000883,518,53,357,20.5,68.9,0.87
CpG: 38,chr19,4012492,4012835,343,38,225,22.2,65.6,1.04
CpG: 26,chr19,4037775,4038074,299,26,198,17.4,66.2,0.8
CpG: 67,chr19,4096842,4097602,760,67,486,17.6,63.9,0.86
CpG: 102,chr19,4099936,4101176,1240,102,831,16.5,67,0.76
CpG: 24,chr19,4121243,4121518,275,24,167,17.5,60.7,1
CpG: 56,chr19,4125745,4126310,565,56,395,19.8,69.9,0.82
CpG: 33,chr19,4148474,4148828,354,33,234,18.6,66.1,0.87
CpG: 30,chr19,4163126,4163430,304,30,195,19.7,64.1,0.98
CpG: 71,chr19,4169407,4170119,712,71,489,19.9,68.7,0.88
CpG: 64,chr19,4191902,4192796,894,64,523,14.3,58.5,0.85
CpG: 21,chr19,4201535,4201770,235,21,138,17.9,58.7,1.04
CpG: 110,chr19,4214334,4215570,1236,110,755,17.8,61.1,0.97
CpG: 31,chr19,4269014,4269348,334,31,228,18.6,68.3,0.8
CpG: 54,chr19,4282779,4283399,620,54,432,17.4,69.7,0.72
CpG: 39,chr19,4305612,4306052,440,39,316,17.7,71.8,0.7
CpG: 184,chr19,4396497,4398547,2050,184,1259,18,61.4,0.97
CpG: 58,chr19,4476634,4477151,517,58,375,22.4,72.5,0.87
CpG: 88,chr19,4509974,4511000,1026,88,658,17.2,64.1,0.84
CpG: 87,chr19,4614859,4615687,828,87,570,21,68.8,0.9
CpG: 89,chr19,4625268,4626124,856,89,585,20.8,68.3,0.89
CpG: 37,chr19,4698274,4698576,302,37,223,24.5,73.8,0.9
CpG: 83,chr19,4711753,4712638,885,83,527,18.8,59.5,1.07
CpG: 56,chr19,4756353,4756833,480,56,350,23.3,72.9,0.9
CpG: 23,chr19,4787768,4788037,269,23,154,17.1,57.2,1.05
CpG: 23,chr19,4793671,4794001,330,23,185,13.9,56.1,0.89
CpG: 90,chr19,4811135,4812016,881,90,557,20.4,63.2,1.02
CpG: 39,chr19,4839196,4839726,530,39,328,14.7,61.9,0.78
CpG: 46,chr19,4855087,4855512,425,46,285,21.6,67.1,0.96
CpG: 17,chr19,4867803,4868028,225,17,140,15.1,62.2,0.78
CpG: 37,chr19,4878627,4879056,429,37,296,17.2,69,0.73
CpG: 22,chr19,4928234,4928545,311,22,192,14.1,61.7,0.76
CpG: 55,chr19,4942565,4943186,621,55,436,17.7,70.2,0.76
CpG: 20,chr19,4962333,4962567,234,20,147,17.1,62.8,0.87
CpG: 33,chr19,4989709,4990055,346,33,228,19.1,65.9,0.88
CpG: 27,chr19,5001703,5002043,340,27,222,15.9,65.3,0.75
CpG: 52,chr19,5023875,5024483,608,52,393,17.1,64.6,0.82
CpG: 83,chr19,5038536,5039488,952,83,599,17.4,62.9,0.88
CpG: 38,chr19,5041272,5041632,360,38,235,21.1,65.3,0.99
CpG: 46,chr19,5068088,5068579,491,46,354,18.7,72.1,0.72
CpG: 21,chr19,5081794,5082054,260,21,176,16.2,67.7,0.71
CpG: 27,chr19,5082454,5082810,356,27,227,15.2,63.8,0.75
CpG: 50,chr19,5085285,5085687,402,50,285,24.9,70.9,1
CpG: 47,chr19,5088199,5088803,604,47,347,15.6,57.5,0.95
CpG: 25,chr19,5098312,5098610,298,25,153,16.8,51.3,1.28
CpG: 47,chr19,5106729,5107183,454,47,308,20.7,67.8,0.9
CpG: 103,chr19,5117398,5118509,1111,103,772,18.5,69.5,0.78
CpG: 107,chr19,5272605,5273458,853,107,595,25.1,69.8,1.03
CpG: 37,chr19,5295171,5295633,462,37,289,16,62.6,0.83
CpG: 120,chr19,5306752,5307815,1063,120,688,22.6,64.7,1.09
CpG: 25,chr19,5349180,5349413,233,25,159,21.5,68.2,0.92
CpG: 122,chr19,5366235,5367518,1283,122,770,19,60,1.06
CpG: 73,chr19,5388177,5388899,722,73,400,20.2,55.4,1.33
CpG: 90,chr19,5424402,5425638,1236,90,721,14.6,58.3,0.86
CpG: 103,chr19,5447472,5448842,1370,103,855,15,62.4,0.77
CpG: 48,chr19,5457066,5457505,439,48,312,21.9,71.1,0.89
CpG: 26,chr19,5460504,5460755,251,26,151,20.7,60.2,1.15
CpG: 36,chr19,5474521,5474859,338,36,201,21.3,59.5,1.25
CpG: 103,chr19,5490325,5491415,1090,103,704,18.9,64.6,0.91
CpG: 24,chr19,5503575,5503862,287,24,192,16.7,66.9,0.77
CpG: 32,chr19,5510653,5511028,375,32,244,17.1,65.1,0.84
CpG: 145,chr19,5559932,5561254,1322,145,875,21.9,66.2,1.01
CpG: 104,chr19,5567312,5568412,1100,104,710,18.9,64.5,0.91
CpG: 52,chr19,5601918,5602375,457,52,311,22.8,68.1,0.99
CpG: 53,chr19,5609691,5610302,611,53,401,17.3,65.6,0.83
CpG: 108,chr19,5637165,5638125,960,108,671,22.5,69.9,0.92
CpG: 102,chr19,5653986,5655204,1218,102,793,16.7,65.1,0.79
CpG: 73,chr19,5688157,5689048,891,73,579,16.4,65,0.78
CpG: 32,chr19,5696018,5696271,253,32,179,25.3,70.8,1.03
CpG: 19,chr19,5716244,5716461,217,19,140,17.5,64.5,0.84
CpG: 40,chr19,5726129,5726453,324,40,226,24.7,69.8,1.02
CpG: 60,chr19,5729216,5729746,530,60,367,22.6,69.2,0.95
CpG: 37,chr19,5731400,5731816,416,37,266,17.8,63.9,0.89
CpG: 61,chr19,5741653,5742295,642,61,454,19,70.7,0.79
CpG: 41,chr19,5745505,5746004,499,41,343,16.4,68.7,0.7
CpG: 30,chr19,5756849,5757201,352,30,245,17,69.6,0.7
CpG: 28,chr19,5757745,5758088,343,28,218,16.3,63.6,0.82
CpG: 48,chr19,5771021,5771380,359,48,257,26.7,71.6,1.05
CpG: 72,chr19,5803209,5804091,882,72,530,16.3,60.1,0.91
CpG: 26,chr19,5845806,5846028,222,26,150,23.4,67.6,1.08
CpG: 36,chr19,5875034,5875449,415,36,274,17.3,66,0.83
CpG: 40,chr19,5893826,5894172,346,40,256,23.1,74,0.86
CpG: 54,chr19,5912253,5912967,714,54,452,15.1,63.3,0.77
CpG: 48,chr19,5963801,5964307,506,48,318,19,62.8,0.98
CpG: 25,chr19,6015453,6015722,269,25,186,18.6,69.1,0.78
CpG: 74,chr19,6046736,6047482,746,74,484,19.8,64.9,0.95
CpG: 64,chr19,6057665,6058189,524,64,360,24.4,68.7,1.04
CpG: 95,chr19,6061018,6061919,901,95,571,21.1,63.4,1.05
CpG: 59,chr19,6084754,6085356,602,59,365,19.6,60.6,1.07
CpG: 95,chr19,6117858,6118613,755,95,526,25.2,69.7,1.04
CpG: 70,chr19,6140554,6141406,852,70,526,16.4,61.7,0.86
CpG: 31,chr19,6184250,6184665,415,31,243,14.9,58.6,0.88
CpG: 35,chr19,6235534,6235910,376,35,272,18.6,72.3,0.71
CpG: 44,chr19,6241416,6241848,432,44,278,20.4,64.4,0.99
CpG: 97,chr19,6276509,6277525,1016,97,616,19.1,60.6,1.04
CpG: 66,chr19,6306139,6306859,720,66,491,18.3,68.2,0.79
CpG: 40,chr19,6320208,6320809,601,40,399,13.3,66.4,0.6
CpG: 60,chr19,6334996,6335806,810,60,528,14.8,65.2,0.7
CpG: 37,chr19,6341253,6341571,318,37,228,23.3,71.7,0.91
CpG: 132,chr19,6363336,6364616,1280,132,783,20.6,61.2,1.11
CpG: 28,chr19,6375517,6375855,338,28,240,16.6,71,0.71
CpG: 24,chr19,6398554,6398855,301,24,206,15.9,68.4,0.68
CpG: 65,chr19,6399414,6400169,755,65,451,17.2,59.7,0.98
CpG: 21,chr19,6401468,6401689,221,21,148,19,67,0.9
CpG: 19,chr19,6413127,6413349,222,19,149,17.1,67.1,0.8
CpG: 30,chr19,6418583,6418934,351,30,218,17.1,62.1,0.9
CpG: 138,chr19,6427827,6428991,1164,138,771,23.7,66.2,1.09
CpG: 18,chr19,6481299,6481505,206,18,137,17.5,66.5,0.83
CpG: 98,chr19,6497392,6498652,1260,98,708,15.6,56.2,1
CpG: 78,chr19,6531059,6532002,943,78,593,16.5,62.9,0.87
CpG: 44,chr19,6829958,6830465,507,44,336,17.4,66.3,0.79
CpG: 38,chr19,6831101,6831499,398,38,262,19.1,65.8,0.88
CpG: 62,chr19,6840107,6840737,630,62,450,19.7,71.4,0.77
CpG: 25,chr19,6855396,6855669,273,25,180,18.3,65.9,0.87
CpG: 105,chr19,6909376,6910635,1259,105,789,16.7,62.7,0.85
CpG: 30,chr19,6921725,6922047,322,30,218,18.6,67.7,0.82
CpG: 18,chr19,6922322,6922532,210,18,120,17.1,57.1,1.06
CpG: 32,chr19,6925941,6926340,399,32,270,16,67.7,0.71
CpG: 64,chr19,6933720,6934328,608,64,422,21.1,69.4,0.92
CpG: 96,chr19,6941192,6942181,989,96,659,19.4,66.6,0.88
CpG: 23,chr19,6942381,6942662,281,23,189,16.4,67.3,0.76
CpG: 26,chr19,6951848,6952181,333,26,190,15.6,57.1,0.97
CpG: 43,chr19,6969572,6969908,336,43,220,25.6,65.5,1.21
CpG: 36,chr19,6974262,6974691,429,36,282,16.8,65.7,0.8
CpG: 28,chr19,6975355,6975691,336,28,208,16.7,61.9,0.87
CpG: 69,chr19,6979756,6980595,839,69,575,16.4,68.5,0.76
CpG: 63,chr19,6987252,6987914,662,63,424,19,64,0.95
CpG: 56,chr19,7039515,7039951,436,56,303,25.7,69.5,1.12
CpG: 19,chr19,7040435,7040678,243,19,144,15.6,59.3,0.89
CpG: 69,chr19,7056514,7057249,735,69,467,18.8,63.5,0.94
CpG: 16,chr19,7070339,7070576,237,16,144,13.5,60.8,0.73
CpG: 26,chr19,7164959,7165328,369,26,229,14.1,62.1,0.74
CpG: 66,chr19,7165570,7166230,660,66,363,20,55,1.35
CpG: 24,chr19,7206073,7206292,219,24,148,21.9,67.6,0.98
CpG: 41,chr19,7217346,7217699,353,41,240,23.2,68,1.01
CpG: 63,chr19,7240973,7241374,401,63,291,31.4,72.6,1.2
CpG: 83,chr19,7268378,7269070,692,83,509,24,73.6,0.89
CpG: 91,chr19,7341173,7342052,879,91,590,20.7,67.1,0.93
CpG: 98,chr19,7382223,7383222,999,98,700,19.6,70.1,0.8
CpG: 169,chr19,7416805,7418524,1719,169,1129,19.7,65.7,0.91
CpG: 23,chr19,7421280,7421530,250,23,181,18.4,72.4,0.72
CpG: 122,chr19,7422096,7423728,1632,122,1074,15,65.8,0.7
CpG: 63,chr19,7482834,7483388,554,63,385,22.7,69.5,0.94
CpG: 100,chr19,7493993,7494992,999,100,671,20,67.2,0.89
CpG: 44,chr19,7612344,7612763,419,44,292,21,69.7,0.9
CpG: 52,chr19,8713354,8713997,643,52,409,16.2,63.6,0.82
CpG: 41,chr19,8722989,8723409,420,41,251,19.5,59.8,1.09
CpG: 24,chr19,8735780,8736044,264,24,162,18.2,61.4,0.98
CpG: 30,chr19,8741314,8741705,391,30,237,15.3,60.6,0.89
CpG: 71,chr19,8756705,8757374,669,71,454,21.2,67.9,0.93
CpG: 30,chr19,8770964,8771322,358,30,227,16.8,63.4,0.83
CpG: 82,chr19,8774317,8774992,675,82,475,24.3,70.4,0.98
CpG: 26,chr19,8786113,8786439,326,26,214,16,65.6,0.74
CpG: 99,chr19,8819796,8820888,1092,99,636,18.1,58.2,1.09
CpG: 35,chr19,8837377,8837730,353,35,228,19.8,64.6,0.97
CpG: 46,chr19,8871472,8871954,482,46,341,19.1,70.7,0.76
CpG: 62,chr19,8888448,8889270,822,62,462,15.1,56.2,0.96
CpG: 38,chr19,8892903,8893284,381,38,249,19.9,65.4,0.95
CpG: 52,chr19,8897936,8898511,575,52,370,18.1,64.3,0.88
CpG: 44,chr19,8920297,8920831,534,44,321,16.5,60.1,0.91
CpG: 69,chr19,8929380,8930066,686,69,464,20.1,67.6,0.88
CpG: 112,chr19,8941736,8942716,980,112,661,22.9,67.4,1.02
CpG: 30,chr19,8953723,8954028,305,30,168,19.7,55.1,1.31
CpG: 42,chr19,8966869,8967358,489,42,310,17.2,63.4,0.87
CpG: 64,chr19,8989235,8989930,695,64,446,18.4,64.2,0.89
CpG: 56,chr19,9899272,9899823,551,56,328,20.3,59.5,1.15
CpG: 67,chr19,9982451,9983071,620,67,426,21.6,68.7,0.94
CpG: 31,chr19,10018130,10018402,272,31,205,22.8,75.4,0.83
CpG: 81,chr19,10041235,10042048,813,81,583,19.9,71.7,0.79
CpG: 84,chr19,10101222,10102220,998,84,649,16.8,65,0.82
CpG: 77,chr19,10182746,10183385,639,77,449,24.1,70.3,0.98
CpG: 27,chr19,10203698,10203953,255,27,162,21.2,63.5,1.06
CpG: 35,chr19,10240531,10240879,348,35,200,20.1,57.5,1.27
CpG: 76,chr19,10304533,10305238,705,76,479,21.6,67.9,0.94
CpG: 24,chr19,10388671,10388915,244,24,160,19.7,65.6,0.92
CpG: 40,chr19,10389412,10389768,356,40,259,22.5,72.8,0.86
CpG: 23,chr19,10426352,10426643,291,23,211,15.8,72.5,0.6
CpG: 142,chr19,10456554,10457813,1259,142,823,22.6,65.4,1.05
CpG: 82,chr19,10525035,10525859,824,82,517,19.9,62.7,1.04
CpG: 31,chr19,10555714,10556041,327,31,212,19,64.8,0.9
CpG: 26,chr19,10577078,10577461,383,26,219,13.6,57.2,0.84
CpG: 50,chr19,10605403,10605952,549,50,364,18.2,66.3,0.83
CpG: 68,chr19,10688656,10689219,563,68,410,24.2,72.8,0.93
CpG: 35,chr19,10869478,10869885,407,35,287,17.2,70.5,0.7
CpG: 36,chr19,10881658,10882067,409,36,236,17.6,57.7,1.09
CpG: 47,chr19,10895156,10895627,471,47,314,20,66.7,0.91
CpG: 56,chr19,10940543,10941238,695,56,434,16.1,62.4,0.84
CpG: 56,chr19,10948779,10949403,624,56,399,17.9,63.9,0.91
CpG: 49,chr19,11092237,11092502,265,49,207,37,78.1,1.22
CpG: 61,chr19,11818526,11819169,643,61,413,19,64.2,0.92
CpG: 36,chr19,11868738,11869108,370,36,225,19.5,60.8,1.06
CpG: 26,chr19,11878337,11878649,312,26,197,16.7,63.1,0.84
CpG: 90,chr19,11912128,11912986,858,90,529,21,61.7,1.1
CpG: 41,chr19,11965448,11965926,478,41,267,17.2,55.9,1.11
CpG: 24,chr19,11966142,11966407,265,24,180,18.1,67.9,0.79
CpG: 103,chr19,12501007,12501800,793,103,592,26,74.7,0.95
CpG: 45,chr19,12595855,12596343,488,45,338,18.4,69.3,0.79
CpG: 143,chr19,12794747,12796354,1607,143,985,17.8,61.3,0.95
CpG: 211,chr19,14596913,14599106,2193,211,1305,19.2,59.5,1.09
CpG: 62,chr19,15924513,15925286,773,62,486,16,62.9,0.82
CpG: 85,chr19,15984492,15985120,628,85,446,27.1,71,1.08
CpG: 160,chr19,16132349,16133737,1388,160,859,23.1,61.9,1.23
CpG: 51,chr19,16436343,16436900,557,51,347,18.3,62.3,0.95
CpG: 112,chr19,16780258,16781242,984,112,653,22.8,66.4,1.04
CpG: 153,chr19,16872320,16874653,2333,153,1325,13.1,56.8,0.81
CpG: 33,chr19,16955885,16956227,342,33,246,19.3,71.9,0.75
CpG: 35,chr19,17356352,17356764,412,35,279,17,67.7,0.77
CpG: 80,chr19,17393920,17394515,595,80,444,26.9,74.6,0.97
CpG: 90,chr19,17836803,17837681,878,90,581,20.5,66.2,0.94
CpG: 86,chr19,18631292,18632186,894,86,598,19.2,66.9,0.86
CpG: 99,chr19,18670717,18671512,795,99,486,24.9,61.1,1.34
CpG: 100,chr19,18712854,18713731,877,100,610,22.8,69.6,0.94
CpG: 31,chr19,18749696,18750012,316,31,192,19.6,60.8,1.08
CpG: 43,chr19,19110175,19110732,557,43,344,15.4,61.8,0.83
CpG: 169,chr19,21271794,21273103,1309,169,946,25.8,72.3,0.99
CpG: 42,chr19,21472273,21472643,370,42,264,22.7,71.4,0.89
CpG: 103,chr19,21652828,21653873,1045,103,621,19.7,59.4,1.12
CpG: 85,chr19,21778133,21779000,867,85,603,19.6,69.6,0.81
CpG: 21,chr19,21792702,21792943,241,21,147,17.4,61,0.97
CpG: 37,chr19,22138847,22139301,454,37,305,16.3,67.2,0.73
CpG: 17,chr19,22727071,22727291,220,17,135,15.5,61.4,0.89
CpG: 103,chr19,23134891,23136424,1533,103,931,13.4,60.7,0.73
CpG: 164,chr19,23140879,23142677,1798,164,1126,18.2,62.6,0.93
CpG: 59,chr19,23273561,23274010,449,59,327,26.3,72.8,1.01
CpG: 18,chr19,23619698,23619905,207,18,120,17.4,58,1.04
CpG: 91,chr19,23687135,23687892,757,91,526,24,69.5,1
CpG: 41,chr19,23758223,23758664,441,41,293,18.6,66.4,0.84
CpG: 30,chr19,23759008,23759313,305,30,208,19.7,68.2,0.89
CpG: 150,chr19,23892738,23893830,1092,150,788,27.5,72.2,1.06
CpG: 22,chr19,24031103,24031392,289,22,183,15.2,63.3,0.76
CpG: 35,chr19,24130928,24131281,353,35,231,19.8,65.4,0.93
CpG: 83,chr19,24173876,24174518,642,83,431,25.9,67.1,1.16
CpG: 55,chr19,24224387,24225004,617,55,408,17.8,66.1,0.82
CpG: 71,chr19,24280224,24280692,468,71,323,30.3,69,1.28
CpG: 75,chr19,24476916,24477661,745,75,455,20.1,61.1,1.09
CpG: 89,chr19,24555538,24556407,869,89,551,20.5,63.4,1.02
CpG: 44,chr19,24861500,24861944,444,44,313,19.8,70.5,0.81
CpG: 36,chr19,24897236,24897571,335,36,214,21.5,63.9,1.06
CpG: 104,chr19,24899507,24900675,1168,104,778,17.8,66.6,0.83
CpG: 24,chr19,24961573,24961828,255,24,166,18.8,65.1,0.9
CpG: 110,chr19,24999191,24999943,752,110,537,29.3,71.4,1.15
CpG: 110,chr19,25236538,25237775,1237,110,807,17.8,65.2,0.84
CpG: 31,chr19,25409979,25410362,383,31,231,16.2,60.3,0.93
CpG: 118,chr19,25505603,25506970,1367,118,868,17.3,63.5,0.86
CpG: 46,chr19,25605712,25606420,708,46,438,13,61.9,0.68
CpG: 90,chr19,25610007,25611039,1032,90,686,17.4,66.5,0.79
CpG: 24,chr19,25622384,25622708,324,24,208,14.8,64.2,0.72
CpG: 37,chr19,25671983,25672491,508,37,295,14.6,58.1,0.87
CpG: 57,chr19,25673381,25673957,576,57,370,19.8,64.2,0.96
CpG: 128,chr19,27216955,27218327,1372,128,886,18.7,64.6,0.89
CpG: 17,chr19,27218890,27219125,235,17,141,14.5,60,0.83
CpG: 29,chr19,27323135,27323508,373,29,228,15.5,61.1,0.83
CpG: 51,chr19,27429646,27430195,549,51,343,18.6,62.5,0.95
CpG: 89,chr19,28011247,28012039,792,89,536,22.5,67.7,0.98
CpG: 31,chr19,28678103,28678514,411,31,267,15.1,65,0.72
CpG: 78,chr19,28679626,28680390,764,78,528,20.4,69.1,0.87
CpG: 19,chr19,28763321,28763534,213,19,129,17.8,60.6,0.97
CpG: 58,chr19,28835000,28835428,428,58,312,27.1,72.9,1.02
CpG: 85,chr19,28963841,28964659,818,85,580,20.8,70.9,0.83
CpG: 25,chr19,28975069,28975404,335,25,199,14.9,59.4,0.85
CpG: 61,chr19,28990229,28990818,589,61,401,20.7,68.1,0.89
CpG: 59,chr19,29047520,29048047,527,59,390,22.4,74,0.82
CpG: 86,chr19,29100954,29101853,899,86,611,19.1,68,0.83
CpG: 133,chr19,29251112,29252179,1067,133,740,24.9,69.4,1.04
CpG: 27,chr19,29361736,29362043,307,27,205,17.6,66.8,0.79
CpG: 153,chr19,29521968,29523214,1246,153,871,24.6,69.9,1.03
CpG: 21,chr19,29626152,29626463,311,21,184,13.5,59.2,0.77
CpG: 85,chr19,29647797,29648439,642,85,473,26.5,73.7,1
CpG: 138,chr19,29805086,29806698,1612,138,1016,17.1,63,0.87
CpG: 29,chr19,29812908,29813157,249,29,173,23.3,69.5,1
CpG: 143,chr19,30029914,30031343,1429,143,917,20,64.2,0.97
CpG: 47,chr19,30174874,30175472,598,47,387,15.7,64.7,0.75
CpG: 46,chr19,31082638,31083149,511,46,292,18,57.1,1.11
CpG: 64,chr19,31663915,31664750,835,64,539,15.3,64.6,0.74
CpG: 54,chr19,31764058,31764689,631,54,422,17.1,66.9,0.78
CpG: 212,chr19,32387473,32389832,2359,212,1566,18,66.4,0.82
CpG: 106,chr19,32485651,32486656,1005,106,674,21.1,67.1,0.95
CpG: 59,chr19,32595558,32596215,657,59,457,18,69.6,0.74
CpG: 57,chr19,32711913,32712444,531,57,383,21.5,72.1,0.83
CpG: 185,chr19,32755981,32758346,2365,185,1478,15.6,62.5,0.8
CpG: 39,chr19,33391775,33392230,455,39,301,17.1,66.2,0.79
CpG: 36,chr19,34192452,34192788,336,36,239,21.4,71.1,0.85
CpG: 52,chr19,34474264,34475032,768,52,457,13.5,59.5,0.79
CpG: 53,chr19,34746975,34747423,448,53,329,23.7,73.4,0.88
CpG: 113,chr19,34878280,34879247,967,113,664,23.4,68.7,0.99
CpG: 48,chr19,34922033,34922556,523,48,338,18.4,64.6,0.89
CpG: 121,chr19,36056601,36057781,1180,121,782,20.5,66.3,0.93
CpG: 128,chr19,36348496,36349541,1045,128,715,24.5,68.4,1.05
CpG: 90,chr19,36409532,36410360,828,90,501,21.7,60.5,1.22
CpG: 83,chr19,36553947,36555055,1108,83,579,15,52.3,1.11
CpG: 37,chr19,36736571,36736971,400,37,265,18.5,66.2,0.84
CpG: 95,chr19,36834155,36834907,752,95,510,25.3,67.8,1.1
CpG: 38,chr19,36904168,36904609,441,38,283,17.2,64.2,0.84
CpG: 79,chr19,36918570,36919208,638,79,473,24.8,74.1,0.9
CpG: 90,chr19,36925963,36926627,664,90,465,27.1,70,1.11
CpG: 20,chr19,37018415,37018686,271,20,179,14.8,66.1,0.68
CpG: 80,chr19,37173995,37174879,884,80,552,18.1,62.4,0.96
CpG: 98,chr19,37207046,37208023,977,98,643,20.1,65.8,0.93
CpG: 50,chr19,37233755,37234362,607,50,381,16.5,62.8,0.84
CpG: 68,chr19,37375917,37376608,691,68,427,19.7,61.8,1.03
CpG: 158,chr19,37434266,37435575,1309,158,949,24.1,72.5,0.92
CpG: 58,chr19,37550468,37551056,588,58,411,19.7,69.9,0.81
CpG: 21,chr19,37686442,37686657,215,21,137,19.5,63.7,0.96
CpG: 60,chr19,37687046,37687836,790,60,505,15.2,63.9,0.74
CpG: 26,chr19,37690830,37691070,240,26,163,21.7,67.9,0.94
CpG: 54,chr19,37692843,37693403,560,54,360,19.3,64.3,0.93
CpG: 155,chr19,37697199,37699255,2056,155,1285,15.1,62.5,0.78
CpG: 58,chr19,38054624,38055351,727,58,476,16,65.5,0.77
CpG: 70,chr19,38096952,38097733,781,70,497,17.9,63.6,0.89
CpG: 67,chr19,38124485,38125035,550,67,373,24.4,67.8,1.07
CpG: 33,chr19,38224022,38224268,246,33,172,26.8,69.9,1.1
CpG: 74,chr19,38395900,38396354,454,74,364,32.6,80.2,1.05
CpG: 58,chr19,38480873,38481570,697,58,424,16.6,60.8,0.9
CpG: 36,chr19,38819064,38819500,436,36,272,16.5,62.4,0.85
CpG: 141,chr19,38836498,38837523,1025,141,745,27.5,72.7,1.04
CpG: 94,chr19,38930542,38931546,1004,94,638,18.7,63.5,0.94
CpG: 78,chr19,40271086,40271733,647,78,454,24.1,70.2,0.98
CpG: 21,chr19,40326081,40326336,255,21,161,16.5,63.1,0.84
CpG: 70,chr19,40513425,40514035,610,70,438,23,71.8,0.89
CpG: 46,chr19,40588200,40588578,378,46,269,24.3,71.2,1.01
CpG: 44,chr19,40611906,40612453,547,44,353,16.1,64.5,0.78
CpG: 136,chr19,40830965,40832120,1155,136,815,23.5,70.6,0.96
CpG: 41,chr19,40873133,40873549,416,41,271,19.7,65.1,0.93
CpG: 98,chr19,40894474,40895422,948,98,629,20.7,66.4,0.94
CpG: 16,chr19,41088568,41088790,222,16,140,14.4,63.1,0.73
CpG: 70,chr19,41206045,41207150,1105,70,692,12.7,62.6,0.65
CpG: 95,chr19,41263189,41264304,1115,95,611,17,54.8,1.14
CpG: 19,chr19,41375950,41376186,236,19,155,16.1,65.7,0.76
CpG: 43,chr19,41384907,41385281,374,43,273,23,73,0.86
CpG: 35,chr19,41482227,41482556,329,35,206,21.3,62.6,1.18
CpG: 50,chr19,41483109,41483556,447,50,295,22.4,66,1.08
CpG: 72,chr19,41743086,41743875,789,72,500,18.3,63.4,0.91
CpG: 47,chr19,41801587,41802068,481,47,324,19.5,67.4,0.86
CpG: 124,chr19,41829931,41830950,1019,124,687,24.3,67.4,1.08
CpG: 169,chr19,41847091,41848492,1401,169,955,24.1,68.2,1.04
CpG: 27,chr19,41895893,41896185,292,27,188,18.5,64.4,0.89
CpG: 94,chr19,41911691,41912573,882,94,592,21.3,67.1,0.95
CpG: 57,chr19,41932878,41933532,654,57,423,17.4,64.7,0.83
CpG: 147,chr19,41980924,41982472,1548,147,1070,19,69.1,0.8
CpG: 85,chr19,42090216,42091038,822,85,523,20.7,63.6,1.03
CpG: 52,chr19,42128800,42129394,594,52,397,17.5,66.8,0.79
CpG: 78,chr19,42147565,42148488,923,78,579,16.9,62.7,0.87
CpG: 46,chr19,42170471,42170912,441,46,293,20.9,66.4,0.95
CpG: 85,chr19,42201463,42202340,877,85,615,19.4,70.1,0.79
CpG: 45,chr19,42255730,42256114,384,45,284,23.4,74,0.87
CpG: 126,chr19,42431391,42432581,1190,126,823,21.2,69.2,0.89
CpG: 69,chr19,42518522,42519316,794,69,512,17.4,64.5,0.84
CpG: 15,chr19,42599906,42600107,201,15,119,14.9,59.2,0.86
CpG: 38,chr19,42612717,42613080,363,38,268,20.9,73.8,0.78
CpG: 39,chr19,42779653,42780095,442,39,294,17.6,66.5,0.81
CpG: 43,chr19,43386227,43386805,578,43,335,14.9,58,0.89
CpG: 25,chr19,43427410,43427707,297,25,197,16.8,66.3,0.78
CpG: 149,chr19,43440306,43441669,1363,149,949,21.9,69.6,0.9
CpG: 51,chr19,43524343,43524983,640,51,397,15.9,62,0.85
CpG: 23,chr19,43599731,43600069,338,23,205,13.6,60.7,0.75
CpG: 17,chr19,43600902,43601106,204,17,120,16.7,58.8,0.99
CpG: 34,chr19,43601327,43601767,440,34,253,15.5,57.5,0.95
CpG: 77,chr19,43614335,43615108,773,77,444,19.9,57.4,1.21
CpG: 42,chr19,43616398,43616905,507,42,337,16.6,66.5,0.78
CpG: 125,chr19,43674431,43675964,1533,125,941,16.3,61.4,0.86
CpG: 54,chr19,43689547,43690129,582,54,398,18.6,68.4,0.82
CpG: 74,chr19,43752729,43753397,668,74,458,22.2,68.6,0.94
CpG: 35,chr19,43879533,43879874,341,35,240,20.5,70.4,0.86
CpG: 79,chr19,43939867,43940479,612,79,442,25.8,72.2,1.04
CpG: 60,chr19,44069463,44069874,411,60,309,29.2,75.2,1.06
CpG: 50,chr19,44107089,44107623,534,50,348,18.7,65.2,0.91
CpG: 31,chr19,44146121,44146458,337,31,225,18.4,66.8,0.91
CpG: 27,chr19,44248171,44248428,257,27,178,21,69.3,0.89
CpG: 27,chr19,44266919,44267204,285,27,202,18.9,70.9,0.78
CpG: 31,chr19,44284132,44284488,356,31,252,17.4,70.8,0.7
CpG: 58,chr19,44511505,44512067,562,58,385,20.6,68.5,0.88
CpG: 38,chr19,44545470,44545881,411,38,293,18.5,71.3,0.74
CpG: 49,chr19,44554852,44555516,664,49,416,14.8,62.7,0.78
CpG: 26,chr19,44562728,44563046,318,26,196,16.4,61.6,0.86
CpG: 20,chr19,44671991,44672192,201,20,134,19.9,66.7,0.9
CpG: 29,chr19,44674651,44674874,223,29,141,26,63.2,1.31
CpG: 46,chr19,44684082,44684455,373,46,263,24.7,70.5,1.02
CpG: 16,chr19,44717372,44717588,216,16,115,14.8,53.2,1.05
CpG: 33,chr19,44720157,44720526,369,33,255,17.9,69.1,0.76
CpG: 25,chr19,44724028,44724314,286,25,173,17.5,60.5,0.98
CpG: 43,chr19,44726108,44726472,364,43,257,23.6,70.6,0.97
CpG: 60,chr19,44734343,44735056,713,60,441,16.8,61.9,0.9
CpG: 47,chr19,44741179,44741761,582,47,353,16.2,60.7,0.88
CpG: 37,chr19,44746668,44746941,273,37,200,27.1,73.3,1.03
CpG: 22,chr19,44750433,44750664,231,22,155,19,67.1,0.85
CpG: 159,chr19,44755576,44757507,1931,159,1193,16.5,61.8,0.86
CpG: 39,chr19,44758828,44759320,492,39,307,15.9,62.4,0.81
CpG: 81,chr19,44835972,44837015,1043,81,700,15.5,67.1,0.71
CpG: 66,chr19,44930853,44931601,748,66,504,17.6,67.4,0.79
CpG: 17,chr19,44988950,44989189,239,17,154,14.2,64.4,0.71
CpG: 41,chr19,44989264,44989662,398,41,278,20.6,69.8,0.85
CpG: 100,chr19,45005806,45006823,1017,100,657,19.7,64.6,0.96
CpG: 49,chr19,45015150,45015822,672,49,387,14.6,57.6,0.89
CpG: 29,chr19,45025892,45026253,361,29,258,16.1,71.5,0.64
CpG: 23,chr19,45065418,45065678,260,23,172,17.7,66.2,0.82
CpG: 28,chr19,45074901,45075200,299,28,180,18.7,60.2,1.04
CpG: 52,chr19,45076782,45077218,436,52,307,23.9,70.4,0.97
CpG: 69,chr19,45079797,45080751,954,69,589,14.5,61.7,0.76
CpG: 35,chr19,45143459,45143865,406,35,272,17.2,67,0.77
CpG: 84,chr19,45150575,45151614,1039,84,655,16.2,63,0.82
CpG: 59,chr19,45153394,45154219,825,59,502,14.3,60.8,0.77
CpG: 25,chr19,45155826,45156161,335,25,213,14.9,63.6,0.74
CpG: 25,chr19,45159075,45159368,293,25,183,17.1,62.5,0.88
CpG: 47,chr19,45223536,45224244,708,47,413,13.3,58.3,0.78
CpG: 69,chr19,45230943,45231579,636,69,407,21.7,64,1.06
CpG: 171,chr19,45233499,45235664,2165,171,1329,15.8,61.4,0.84
CpG: 25,chr19,45235943,45236264,321,25,207,15.6,64.5,0.75
CpG: 39,chr19,45301751,45302213,462,39,278,16.9,60.2,0.95
CpG: 45,chr19,45363448,45363972,524,45,335,17.2,63.9,0.85
CpG: 49,chr19,45541548,45541929,381,49,261,25.7,68.5,1.1
CpG: 25,chr19,45545050,45545271,221,25,155,22.6,70.1,0.93
CpG: 107,chr19,45659672,45660589,917,107,650,23.3,70.9,0.96
CpG: 33,chr19,45736932,45737257,325,33,220,20.3,67.7,0.9
CpG: 60,chr19,45742423,45742922,499,60,367,24,73.5,0.91
CpG: 76,chr19,45748965,45749670,705,76,488,21.6,69.2,0.91
CpG: 116,chr19,45782739,45783865,1126,116,765,20.6,67.9,0.89
CpG: 29,chr19,45815751,45816125,374,29,267,15.5,71.4,0.61
CpG: 70,chr19,45998014,45998666,652,70,458,21.5,70.2,0.9
CpG: 67,chr19,46003367,46004063,696,67,480,19.3,69,0.81
CpG: 70,chr19,46044862,46045548,686,70,381,20.4,55.5,1.37
CpG: 81,chr19,46056534,46057317,783,81,546,20.7,69.7,0.9
CpG: 52,chr19,46075712,46076195,483,52,302,21.5,62.5,1.1
CpG: 106,chr19,46135817,46137182,1365,106,909,15.5,66.6,0.72
CpG: 33,chr19,46147388,46147852,464,33,289,14.2,62.3,0.74
CpG: 51,chr19,46148204,46148869,665,51,455,15.3,68.4,0.66
CpG: 22,chr19,46152679,46152897,218,22,146,20.2,67,0.91
CpG: 104,chr19,46304454,46305820,1366,104,885,15.2,64.8,0.73
CpG: 40,chr19,46308960,46309322,362,40,251,22.1,69.3,0.92
CpG: 77,chr19,46317590,46318210,620,77,378,24.8,61,1.34
CpG: 131,chr19,46328195,46329586,1391,131,928,18.8,66.7,0.85
CpG: 28,chr19,46338374,46338785,411,28,248,13.6,60.3,0.75
CpG: 75,chr19,46348752,46349301,549,75,402,27.3,73.2,1.02
CpG: 28,chr19,46356804,46357126,322,28,220,17.4,68.3,0.76
CpG: 51,chr19,46395102,46395869,767,51,454,13.3,59.2,0.76
CpG: 46,chr19,46396875,46397344,469,46,302,19.6,64.4,0.96
CpG: 232,chr19,46499986,46503035,3049,232,1811,15.2,59.4,0.86
CpG: 46,chr19,46573115,46573592,477,46,328,19.3,68.8,0.82
CpG: 23,chr19,46654118,46654424,306,23,202,15,66,0.69
CpG: 32,chr19,46689848,46690150,302,32,199,21.2,65.9,0.98
CpG: 172,chr19,46760880,46762882,2002,172,1289,17.2,64.4,0.83
CpG: 24,chr19,46961711,46962003,292,24,188,16.4,64.4,0.79
CpG: 160,chr19,47014510,47015745,1235,160,878,25.9,71.1,1.03
CpG: 70,chr19,47050305,47051048,743,70,439,18.8,59.1,1.08
CpG: 75,chr19,47067602,47068485,883,75,505,17,57.2,1.04
CpG: 19,chr19,47074915,47075133,218,19,121,17.4,55.5,1.13
CpG: 65,chr19,47090344,47090915,571,65,365,22.8,63.9,1.13
CpG: 26,chr19,47151658,47151964,306,26,199,17,65,0.8
CpG: 119,chr19,47178603,47179636,1033,119,715,23,69.2,0.96
CpG: 110,chr19,47253054,47253818,764,110,554,28.8,72.5,1.1
CpG: 22,chr19,47267284,47267537,253,22,166,17.4,65.6,0.81
CpG: 32,chr19,47314025,47314367,342,32,229,18.7,67,0.84
CpG: 37,chr19,47343537,47343772,235,37,184,31.5,78.3,1.09
CpG: 73,chr19,47464007,47464725,718,73,465,20.3,64.8,0.97
CpG: 26,chr19,47537011,47537247,236,26,160,22,67.8,1.05
CpG: 82,chr19,47579310,47579871,561,82,384,29.2,68.4,1.25
CpG: 21,chr19,47580315,47580629,314,21,176,13.4,56.1,0.87
CpG: 63,chr19,47731239,47731916,677,63,429,18.6,63.4,0.93
CpG: 34,chr19,47837197,47837514,317,34,184,21.5,58,1.27
CpG: 51,chr19,47854866,47855383,517,51,351,19.7,67.9,0.86
CpG: 49,chr19,47865357,47865909,552,49,356,17.8,64.5,0.85
CpG: 43,chr19,47918962,47919418,456,43,294,18.9,64.5,0.91
CpG: 122,chr19,48205180,48206752,1572,122,1020,15.5,64.9,0.74
CpG: 89,chr19,50678007,50678959,952,89,634,18.7,66.6,0.85
CpG: 56,chr19,53038236,53038709,473,56,351,23.7,74.2,0.87
CpG: 135,chr19,53142135,53143577,1442,135,960,18.7,66.6,0.86
CpG: 77,chr19,53310331,53311348,1017,77,589,15.1,57.9,0.9
CpG: 98,chr19,53312772,53313868,1096,98,693,17.9,63.2,0.92
CpG: 20,chr19,53314298,53314541,243,20,146,16.5,60.1,0.91
CpG: 88,chr19,53329281,53330034,753,88,465,23.4,61.8,1.31
CpG: 114,chr19,53389807,53390871,1064,114,738,21.4,69.4,0.89
CpG: 120,chr19,53528701,53529709,1008,120,692,23.8,68.7,1.01
CpG: 21,chr19,53529819,53530112,293,21,188,14.3,64.2,0.7
CpG: 92,chr19,53600006,53601051,1045,92,566,17.6,54.2,1.2
CpG: 111,chr19,53676333,53677554,1221,111,825,18.2,67.6,0.8
CpG: 127,chr19,53903059,53904012,953,127,725,26.7,76.1,0.92
CpG: 126,chr19,53943886,53945632,1746,126,985,14.4,56.4,0.91
CpG: 220,chr19,54045055,54047684,2629,220,1609,16.7,61.2,0.89
CpG: 67,chr19,55099045,55099569,524,67,399,25.6,76.1,0.88
CpG: 113,chr19,55315362,55316672,1310,113,794,17.3,60.6,0.95
CpG: 35,chr19,55741557,55741968,411,35,232,17,56.4,1.15
CpG: 82,chr19,55742345,55743241,896,82,530,18.3,59.2,1.06
CpG: 23,chr19,55895423,55895626,203,23,147,22.7,72.4,0.88
CpG: 71,chr19,56396850,56397543,693,71,469,20.5,67.7,0.91
CpG: 62,chr19,56548399,56548993,594,62,417,20.9,70.2,0.85
CpG: 227,chr19,56721877,56723997,2120,227,1446,21.4,68.2,0.92
CpG: 81,chr19,56821776,56822350,574,81,417,28.2,72.6,1.07
CpG: 41,chr19,56826156,56826522,366,41,255,22.4,69.7,0.96
CpG: 71,chr19,56874066,56874653,587,71,426,24.2,72.6,0.92
CpG: 50,chr19,57007999,57008535,536,50,337,18.7,62.9,0.97
CpG: 54,chr19,57314444,57315020,576,54,420,18.8,72.9,0.71
CpG: 99,chr19,57360622,57361710,1088,99,629,18.2,57.8,1.09
CpG: 158,chr19,57610205,57611845,1640,158,1115,19.3,68,0.83
CpG: 17,chr19,57701968,57702185,217,17,131,15.7,60.4,0.86
CpG: 17,chr19,58453676,58453905,229,17,155,14.8,67.7,0.65
CpG: 104,chr19,58454353,58455912,1559,104,940,13.3,60.3,0.74
CpG: 31,chr19,58799413,58799838,425,31,258,14.6,60.7,0.79
CpG: 26,chr19,58860810,58861140,330,26,230,15.8,69.7,0.67
CpG: 57,chr19,58943152,58943782,630,57,393,18.1,62.4,0.93
CpG: 82,chr19,59075142,59075949,807,82,576,20.3,71.4,0.8
CpG: 55,chr19,59166195,59166781,586,55,371,18.8,63.3,0.94
CpG: 118,chr19,59169115,59170481,1366,118,840,17.3,61.5,0.91
CpG: 23,chr19,59171597,59171841,244,23,175,18.9,71.7,0.75
CpG: 40,chr19,59193933,59194419,486,40,309,16.5,63.6,0.83
CpG: 54,chr19,59260851,59261467,616,54,406,17.5,65.9,0.81
CpG: 164,chr19,59344805,59346356,1551,164,965,21.1,62.2,1.09
CpG: 27,chr19,59451480,59451824,344,27,209,15.7,60.8,0.85
CpG: 162,chr19,59457915,59459984,2069,162,1231,15.7,59.5,0.89
CpG: 29,chr19,59467141,59467557,416,29,219,13.9,52.6,1.01
CpG: 22,chr19,59469037,59469305,268,22,165,16.4,61.6,0.87
CpG: 79,chr19,59943171,59943897,726,79,490,21.8,67.5,0.96
CpG: 63,chr19,60226276,60226755,479,63,333,26.3,69.5,1.11
CpG: 56,chr19,60467186,60467872,686,56,430,16.3,62.7,0.83
CpG: 73,chr19,60580385,60581305,920,73,562,15.9,61.1,0.86
CpG: 164,chr19,60755750,60757340,1590,164,1011,20.6,63.6,1.02
CpG: 119,chr19,60789973,60791006,1033,119,703,23,68.1,1
CpG: 24,chr19,60811594,60811925,331,24,204,14.5,61.6,0.77
CpG: 22,chr19,60874354,60874605,251,22,167,17.5,66.5,0.79
CpG: 87,chr19,60889656,60890708,1052,87,591,16.5,56.2,1.05
CpG: 255,chr19,61225093,61227914,2821,255,1884,18.1,66.8,0.81
CpG: 21,chr19,61228499,61228712,213,21,139,19.7,65.3,0.93
CpG: 35,chr19,61266505,61266971,466,35,242,15,51.9,1.16
CpG: 32,chrUn_GL456370,1485,1737,252,32,146,25.4,57.9,1.62
CpG: 101,chrUn_GL456378,27402,28190,788,101,562,25.6,71.3,1.01
CpG: 174,chr4_GL456216_random,15727,17216,1489,174,941,23.4,63.2,1.17
CpG: 116,chr4_GL456216_random,33879,35465,1586,116,1039,14.6,65.5,0.68
CpG: 35,chr4_GL456350_random,61313,61760,447,35,304,15.7,68,0.68
CpG: 44,chr4_GL456350_random,173329,173879,550,44,375,16,68.2,0.72
CpG: 106,chr4_JH584293_random,2179,3122,943,106,558,22.5,59.2,1.33
CpG: 42,chr4_JH584293_random,21269,21839,570,42,337,14.7,59.1,0.86
CpG: 35,chr4_JH584293_random,121064,121511,447,35,304,15.7,68,0.68
CpG: 106,chr4_JH584294_random,17527,18470,943,106,558,22.5,59.2,1.33
CpG: 35,chr4_JH584294_random,29663,29929,266,35,180,26.3,67.7,1.15
CpG: 41,chr4_JH584294_random,82377,82948,571,41,383,14.4,67.1,0.67
CpG: 21,chr4_JH584295_random,7,272,265,21,174,15.8,65.7,0.78
CpG: 30,chr4_JH584295_random,1299,1700,401,30,238,15,59.4,0.88
